fid,fua_code,fua_name,year,null_pixels,count,total_pixels,null_percentage
1.0,AL001L1,Tirana,2000,1711,165410,167121,1.023809096403205
2.0,AL003L1,Elbasan,2000,637,125367,126004,0.5055395066823275
3.0,AL004L1,ShkodÃ«r,2000,11153,174176,185329,6.017946462777007
4.0,AL005L0,VlorÃ«,2000,2380,61353,63733,3.734329154441184
5.0,AT001L3,Wien,2000,9879,908611,918490,1.0755696850265108
6.0,AT002L3,Graz,2000,4602,286530,291132,1.5807262684967645
7.0,AT003L3,Linz,2000,3224,356006,359230,0.8974751551930518
8.0,AT004L3,Salzburg,2000,1865,135611,137476,1.3566004248014198
9.0,AT005L3,Innsbruck,2000,38840,173982,212822,18.24999295185648
10.0,AT006L2,Klagenfurt,2000,1051,182209,183260,0.5735021281239768
11.0,BA001L1,Sarajevo,2000,9,263765,263774,0.0034120117979785725
12.0,BA002L1,Banja Luka,2000,1,275301,275302,0.00036323746285896945
13.0,BA003L1,Mostar,2000,4229,178118,182347,2.31920459343998
14.0,BA004L1,Tuzla,2000,785,111476,112261,0.6992633238613588
15.0,BA005L1,Zenica,2000,12,86704,86716,0.013838276673278289
16.0,BE001L2,Bruxelles / Brussel,2000,94,326557,326651,0.02877689032025005
17.0,BE002L2,Antwerpen,2000,3968,115244,119212,3.328523974096567
18.0,BE003L2,Gent,2000,413,101428,101841,0.4055341169077287
19.0,BE004L2,Charleroi,2000,575,109190,109765,0.5238463991254043
20.0,BE005L2,LiÃ¨ge,2000,206,141192,141398,0.14568805782260003
21.0,BE006L2,Brugge,2000,1018,55521,56539,1.8005270698102194
22.0,BE007L2,Namur,2000,23,84084,84107,0.027346118634596406
23.0,BE008L1,Leuven,2000,7,45069,45076,0.015529328245629604
24.0,BE009L1,Mons,2000,84,39116,39200,0.2142857142857143
25.0,BE010L1,Kortrijk,2000,29,22310,22339,0.1298178074219974
26.0,BE011L1,Oostende,2000,320,20612,20932,1.528759793617428
27.0,BG001L2,Sofia,2000,1674,570100,571774,0.2927730187101897
28.0,BG002L2,Plovdiv,2000,278,276808,277086,0.10032986148704734
29.0,BG003L2,Varna,2000,3609,201189,204798,1.7622242404710984
30.0,BG004L2,Burgas,2000,7258,288642,295900,2.452855694491382
31.0,BG005L1,Pleven,2000,1185,177891,179076,0.6617302151042016
32.0,BG006L2,Ruse,2000,2522,131495,134017,1.8818508099718694
33.0,BG007L2,Vidin,2000,1752,59212,60964,2.8738271766944425
34.0,BG008L2,Stara Zagora,2000,0,132068,132068,0.0
35.0,BG009L1,Sliven,2000,7,136767,136774,0.005117931770658166
36.0,BG010L1,Dobrich,2000,6,140332,140338,0.004275392267240519
37.0,BG011L1,Shumen,2000,59,94448,94507,0.06242923804585904
38.0,BG013L1,Yambol,2000,178,130628,130806,0.13607938473770317
39.0,BG014L1,Haskovo,2000,374,73594,73968,0.5056240536448194
40.0,BG015L1,Pazardzhik,2000,9,63813,63822,0.014101720409890005
41.0,BG016L1,Blagoevgrad,2000,79,135400,135479,0.05831162025110903
42.0,BG017L1,Veliko Tarnovo,2000,3,88536,88539,0.0033883373428658554
43.0,BG018L1,Vratsa,2000,205,70352,70557,0.29054523293223916
44.0,CH001L2,ZÃ¼rich,2000,24,127693,127717,0.01879154693580338
45.0,CH002L2,GenÃ¨ve,2000,218,53679,53897,0.4044752027014491
46.0,CH003L2,Basel,2000,1613,67807,69420,2.323537885335638
47.0,CH004L2,Bern,2000,174,78114,78288,0.22225628448804416
48.0,CH005L2,Lausanne,2000,48,77457,77505,0.06193148829107799
49.0,CH006L1,Winterthur,2000,0,13291,13291,0.0
50.0,CH007L2,St. Gallen,2000,185,31724,31909,0.5797737315490927
51.0,CH008L2,Luzern,2000,47,29212,29259,0.16063433473461158
52.0,CH009L2,Lugano,2000,68,30557,30625,0.22204081632653064
53.0,CH010L1,Biel/Bienne,2000,7,9088,9095,0.07696536558548653
54.0,CY001L2,Lefkosia,2000,29,162599,162628,0.017832107632142068
55.0,CY501L2,Lemesos,2000,987,124912,125899,0.7839617471147506
56.0,CZ001L2,Praha,2000,519,570043,570562,0.0909629453065574
57.0,CZ002L2,Brno,2000,482,267433,267915,0.1799078065804453
58.0,CZ003L2,Ostrava,2000,1602,141064,142666,1.122902443469362
59.0,CZ004L2,PlzeÅ,2000,447,195510,195957,0.22811126930908313
60.0,CZ005L2,ÃstÃ­ nad Labem,2000,1280,34631,35911,3.5643674640082423
61.0,CZ006L2,Olomouc,2000,0,93564,93564,0.0
62.0,CZ007L2,Liberec,2000,1,61315,61316,0.0016308956879118011
63.0,CZ008L2,ÄeskÃ© BudÄjovice,2000,516,128888,129404,0.39875119779914064
64.0,CZ009L2,Hradec KrÃ¡lovÃ©,2000,3,79502,79505,0.003773347588202
65.0,CZ010L2,Pardubice,2000,6,86351,86357,0.006947902312493486
66.0,CZ011L2,ZlÃ­n,2000,22,57930,57952,0.0379624516841524
67.0,CZ013L2,Karlovy Vary,2000,89,46895,46984,0.18942618763834496
68.0,CZ014L2,Jihlava,2000,33,95994,96027,0.03436533474960168
69.0,CZ016L2,Most,2000,263,27515,27778,0.9467924256605947
70.0,CZ018L2,Chomutov-Jirkov,2000,806,44880,45686,1.7642166090268352
71.0,DE001L1,Berlin,2000,115281,1632984,1748265,6.594023217304013
72.0,DE002L1,Hamburg,2000,15674,718500,734174,2.1349162460125255
73.0,DE003L1,MÃ¼nchen,2000,11816,538125,549941,2.1485941219148965
74.0,DE004L1,KÃ¶ln,2000,1508,161122,162630,0.9272581934452437
75.0,DE005L1,Frankfurt am Main,2000,113891,316440,430331,26.4659064766424
76.0,DE007L1,Stuttgart,2000,1200,363970,365170,0.328614070159104
77.0,DE008L2,Leipzig,2000,13171,384518,397689,3.311884412191436
78.0,DE009L2,Dresden,2000,24407,558789,583196,4.185042421415785
79.0,DE011L1,DÃ¼sseldorf,2000,1992,118325,120317,1.655626386961111
80.0,DE012L1,Bremen,2000,83468,506071,589539,14.158181222955562
81.0,DE013L1,Hannover,2000,16078,281234,297312,5.4077871058013125
82.0,DE014L1,NÃ¼rnberg,2000,247,293254,293501,0.08415644239712983
83.0,DE017L0,Bielefeld,2000,2165,23718,25883,8.364563613182398
84.0,DE018L1,Halle an der Saale,2000,1192,156394,157586,0.7564123716573807
85.0,DE019L2,Magdeburg,2000,923,416111,417034,0.2213248799858045
86.0,DE020L1,Wiesbaden,2000,13672,87766,101438,13.478183718133243
87.0,DE021L1,GÃ¶ttingen,2000,9541,229416,238957,3.992768573425344
88.0,DE025L1,Darmstadt,2000,41364,36823,78187,52.90393543683732
89.0,DE026L1,Trier,2000,254,120873,121127,0.20969725990076532
90.0,DE027L1,Freiburg im Breisgau,2000,14878,206318,221196,6.726161413407114
91.0,DE028L1,Regensburg,2000,1004,252658,253662,0.39580228808414347
92.0,DE029L0,Frankfurt (Oder),2000,3453,11391,14844,23.26192400970089
93.0,DE030L1,Weimar,2000,33,88995,89028,0.03706699016039898
94.0,DE031L1,Schwerin,2000,6828,483175,490003,1.393460856362104
95.0,DE032L1,Erfurt,2000,7986,277526,285512,2.797080332875676
96.0,DE033L1,Augsburg,2000,249,199685,199934,0.12454109856252563
97.0,DE034L1,Bonn,2000,2092,127245,129337,1.6174799168064822
98.0,DE035L1,Karlsruhe,2000,2226,123586,125812,1.7693065844275584
99.0,DE036L0,MÃ¶nchengladbach,2000,41,16982,17023,0.24085061387534515
100.0,DE037L1,Mainz,2000,11402,58903,70305,16.217907687931156
101.0,DE038L1,Ruhrgebiet,2000,4817,438935,443752,1.0855162342930285
102.0,DE039L1,Kiel,2000,6940,332822,339762,2.042606294994732
103.0,DE040L1,SaarbrÃ¼cken,2000,620,153062,153682,0.4034304603011413
104.0,DE042L1,Koblenz,2000,20776,71400,92176,22.539489671931957
105.0,DE043L2,Rostock,2000,3935,357869,361804,1.0876054438314666
106.0,DE044L1,Kaiserslautern,2000,1763,133764,135527,1.3008478015450795
107.0,DE045L1,Iserlohn,2000,768,105339,106107,0.7237976759308999
108.0,DE048L1,Wilhelmshaven,2000,796,73251,74047,1.0749929099085715
109.0,DE050L1,TÃ¼bingen,2000,13,52012,52025,0.02498798654493032
110.0,DE051L1,Villingen-Schwenningen,2000,4558,98002,102560,4.444227769110764
111.0,DE052L1,Flensburg,2000,1074,204401,205475,0.5226913249787078
112.0,DE053L1,Marburg,2000,31040,95202,126242,24.58769664612411
113.0,DE054L1,Konstanz,2000,161,81739,81900,0.1965811965811966
114.0,DE055L0,NeumÃ¼nster,2000,44,7132,7176,0.6131549609810479
115.0,DE056L0,Brandenburg an der Havel,2000,1899,20931,22830,8.318002628120894
116.0,DE057L1,GieÃen,2000,13066,72462,85528,15.276868393976242
117.0,DE058L1,LÃ¼neburg,2000,311,132191,132502,0.23471343828772398
118.0,DE059L1,Bayreuth,2000,17,199903,199920,0.008503401360544217
119.0,DE060L1,Celle,2000,10258,144789,155047,6.616058356498352
120.0,DE061L1,Aschaffenburg,2000,26980,120636,147616,18.277151528289618
121.0,DE062L1,Bamberg,2000,80,122075,122155,0.06549056526544145
122.0,DE063L1,Plauen,2000,558,140730,141288,0.39493799898080517
123.0,DE064L1,Neubrandenburg,2000,17928,566063,583991,3.069910323960472
124.0,DE065L1,Fulda,2000,1554,136671,138225,1.124253933803581
125.0,DE066L1,Kempten (AllgÃ¤u),2000,2968,156199,159167,1.8647081367368863
126.0,DE067L1,Landshut,2000,307,141146,141453,0.21703321951460908
127.0,DE069L1,Rosenheim,2000,1158,146605,147763,0.7836873912955206
128.0,DE071L1,Stralsund,2000,18708,319540,338248,5.530853101866087
129.0,DE072L1,Friedrichshafen,2000,120,66499,66619,0.18012879208634175
130.0,DE073L1,Offenburg,2000,1299,184585,185884,0.6988229218222117
131.0,DE074L1,GÃ¶rlitz,2000,954,210153,211107,0.45190353706887976
132.0,DE077L1,Schweinfurt,2000,259,201081,201340,0.12863812456541174
133.0,DE078L1,Greifswald,2000,2837,346957,349794,0.811048788715644
134.0,DE079L1,Wetzlar,2000,28848,77642,106490,27.089867593201237
135.0,DE081L1,Passau,2000,728,159338,160066,0.4548123898891707
136.0,DE082L0,Dessau-RoÃlau,2000,64,24584,24648,0.2596559558584875
137.0,DE083L1,Braunschweig-Salzgitter-Wolfsburg,2000,1899,410945,412844,0.45998004088711475
138.0,DE084L1,Mannheim-Ludwigshafen,2000,8408,196020,204428,4.112939519048271
139.0,DE504L1,MÃ¼nster,2000,6,141757,141763,0.0042324160747162515
140.0,DE505L0,Chemnitz,2000,6,22187,22193,0.02703555175055198
141.0,DE507L1,Aachen,2000,126,70394,70520,0.17867271695972772
142.0,DE508L0,Krefeld,2000,192,13488,13680,1.4035087719298245
143.0,DE510L1,LÃ¼beck,2000,4729,157420,162149,2.9164533854664536
144.0,DE513L1,Kassel,2000,2515,137346,139861,1.798213940984263
145.0,DE516L0,Solingen,2000,1,8953,8954,0.011168192986374805
146.0,DE517L1,OsnabrÃ¼ck,2000,16733,207397,224130,7.465756480613929
147.0,DE520L1,Oldenburg (Oldenburg),2000,2045,187924,189969,1.0764914275487054
148.0,DE522L1,Heidelberg,2000,2361,114744,117105,2.016139362110926
149.0,DE523L1,Paderborn,2000,2272,122411,124683,1.8222211528436112
150.0,DE524L2,WÃ¼rzburg,2000,267,305662,305929,0.08727515207776967
151.0,DE527L1,Bremerhaven,2000,9479,205000,214479,4.4195469020277045
152.0,DE529L1,Heilbronn,2000,141,119843,119984,0.11751566875583411
153.0,DE530L0,Remscheid,2000,21,7348,7369,0.28497760890215773
154.0,DE532L1,Ulm,2000,5935,193373,199308,2.9778031990687777
155.0,DE533L1,Pforzheim,2000,1113,66035,67148,1.6575326145231428
156.0,DE534L1,Ingolstadt,2000,945,283890,284835,0.33177102533045444
157.0,DE535L1,Gera,2000,247,99539,99786,0.24752971358707634
158.0,DE537L1,Reutlingen,2000,635,108647,109282,0.5810655002653685
159.0,DE539L1,Cottbus,2000,26572,155708,182280,14.577572964669738
160.0,DE540L2,Siegen,2000,67478,110086,177564,38.002072492171834
161.0,DE542L1,Hildesheim,2000,8740,112070,120810,7.234500455260326
162.0,DE544L1,Zwickau,2000,68,94736,94804,0.07172693135310747
163.0,DE546L0,Wuppertal,2000,22,16811,16833,0.1306956573397493
164.0,DE547L2,Jena,2000,2,93066,93068,0.002148966347187003
165.0,DE548L1,DÃ¼ren,2000,355,93683,94038,0.37750696526935923
166.0,DE549L1,Bocholt,2000,52,142213,142265,0.03655150599233824
167.0,DK001L2,KÃ¸benhavn,2000,11607,279616,291223,3.9856055325300543
168.0,DK002L3,Ãrhus,2000,19042,443482,462524,4.116975551538947
169.0,DK003L2,Odense,2000,7784,352055,359839,2.163189648704004
170.0,DK004L3,Aalborg,2000,15400,605059,620459,2.4820334623238605
171.0,EE001L1,Tallinn,2000,24701,414360,439061,5.625869753861081
172.0,EE002L1,Tartu,2000,9558,290084,299642,3.189806502426228
173.0,EE003L0,Narva,2000,749,6140,6889,10.872405283785746
174.0,EL001L1,Athina,2000,5296,304091,309387,1.7117719878340072
175.0,EL002L1,Thessaloniki,2000,1567,140552,142119,1.1025971193155033
176.0,EL003L1,Patra,2000,711,50879,51590,1.3781740647412288
177.0,EL004L1,Irakleio,2000,1093,60291,61384,1.780594291672097
178.0,EL005L1,Larisa,2000,91,155428,155519,0.058513750731421885
179.0,EL006L1,Volos,2000,275,30541,30816,0.8923935617860852
180.0,EL007L1,Ioannina,2000,2030,130611,132641,1.530446845243929
181.0,EL008L1,Kavala,2000,305,35263,35568,0.8575123706702653
182.0,EL009L1,Kalamata,2000,271,44181,44452,0.6096463601187798
183.0,ES001L3,Madrid,2000,2656,784947,787603,0.3372257342849126
184.0,ES002L2,Barcelona,2000,1431,263176,264607,0.5408020195988769
185.0,ES003L3,Valencia,2000,3329,171791,175120,1.9009821836455003
186.0,ES004L3,Sevilla,2000,4378,464048,468426,0.9346193422226777
187.0,ES005L2,Zaragoza,2000,153,275985,276138,0.05540707906916108
188.0,ES006L2,MÃ¡laga,2000,937,151805,152742,0.6134527503895457
189.0,ES007L2,Murcia,2000,140,119996,120136,0.11653459412665645
190.0,ES008L2,Las Palmas,2000,76596,0,76596,100.0
191.0,ES009L2,Valladolid,2000,188,115341,115529,0.16272970423010674
192.0,ES010L2,Palma de Mallorca,2000,2359,201875,204234,1.1550476414309077
193.0,ES011L2,Santiago de Compostela,2000,3,126253,126256,0.0023761246990242047
194.0,ES012L2,Vitoria/Gasteiz,2000,7025,152296,159321,4.409337124421764
195.0,ES013L2,Oviedo,2000,22,93465,93487,0.023532683688641202
196.0,ES014L3,Pamplona/IruÃ±a,2000,89,169425,169514,0.05250303809714832
197.0,ES015L2,Santander,2000,435,69048,69483,0.6260524156988041
198.0,ES016L2,Toledo,2000,482,92916,93398,0.5160710079444956
199.0,ES017L2,Badajoz,2000,709,218040,218749,0.3241157673863652
200.0,ES018L2,LogroÃ±o,2000,51,46087,46138,0.1105379513633014
201.0,ES019L3,Bilbao,2000,9257,144064,153321,6.037659550876919
202.0,ES020L2,CÃ³rdoba,2000,1202,185700,186902,0.6431177836513253
203.0,ES021L2,Alicante/Alacant,2000,482,35576,36058,1.3367352598591158
204.0,ES022L2,Vigo,2000,1093,135378,136471,0.8009027558968571
205.0,ES023L2,GijÃ³n,2000,933,52469,53402,1.7471255758211304
206.0,ES025L3,Santa Cruz de Tenerife,2000,66983,0,66983,100.0
207.0,ES026L2,CoruÃ±a (A),2000,666,75309,75975,0.876604146100691
208.0,ES028L1,Reus,2000,0,11534,11534,0.0
209.0,ES031L1,Lugo,2000,10,134001,134011,0.00746207400885002
210.0,ES033L1,Girona,2000,3,39618,39621,0.007571742257893541
211.0,ES034L1,CÃ¡ceres,2000,1946,236327,238273,0.8167102441317313
212.0,ES035L1,Torrevieja,2000,1735,7103,8838,19.631138266576148
213.0,ES039L1,AvilÃ©s,2000,364,18778,19142,1.9015776825828021
214.0,ES040L1,Talavera de la Reina,2000,551,82715,83266,0.6617346816227512
215.0,ES041L1,Palencia,2000,11,28370,28381,0.03875832423099961
216.0,ES043L1,Ferrol,2000,873,46097,46970,1.8586331701085799
217.0,ES044L1,Pontevedra,2000,169,51447,51616,0.3274178549287043
218.0,ES046L1,Gandia,2000,252,17085,17337,1.4535386745111611
219.0,ES048L1,Guadalajara,2000,14,45369,45383,0.0308485556265562
220.0,ES050L1,Manresa,2000,3,29600,29603,0.010134108029591596
221.0,ES053L1,Ciudad Real,2000,577,95768,96345,0.5988894078571799
222.0,ES054L1,Benidorm,2000,326,20347,20673,1.5769361002273496
223.0,ES057L1,Ponferrada,2000,254,62089,62343,0.40742344770062394
224.0,ES059L1,Zamora,2000,320,33860,34180,0.9362200117027502
225.0,ES070L1,Irun,2000,64,7178,7242,0.8837337752002209
226.0,ES072L1,Arrecife,2000,58934,0,58934,100.0
227.0,ES501L3,Granada,2000,352,162272,162624,0.21645021645021645
228.0,ES505L1,Elche/Elx,2000,819,37999,38818,2.1098459477561957
229.0,ES506L1,Cartagena,2000,1606,59342,60948,2.6350331430071536
230.0,ES508L1,Jerez de la Frontera,2000,157,125949,126106,0.12449843782214962
231.0,ES510L1,Donostia-San SebastiÃ¡n,2000,225,33095,33320,0.6752701080432173
232.0,ES514L1,AlmerÃ­a,2000,744,39986,40730,1.8266633930763565
233.0,ES515L1,Burgos,2000,2,149389,149391,0.001338768734394977
234.0,ES516L1,Salamanca,2000,20,45624,45644,0.043817369205152924
235.0,ES519L1,Albacete,2000,1,245324,245325,0.0004076225415265464
236.0,ES520L1,CastellÃ³n/CastellÃ³,2000,536,32258,32794,1.6344453253643958
237.0,ES521L1,Huelva,2000,4032,93388,97420,4.138780537877232
238.0,ES522L1,CÃ¡diz,2000,925,23908,24833,3.72488221318407
239.0,ES523L1,LeÃ³n,2000,3,118884,118887,0.0025234045774559033
240.0,ES525L1,Tarragona,2000,500,21240,21740,2.2999080036798527
241.0,ES527L1,JaÃ©n,2000,32,99899,99931,0.03202209524571955
242.0,ES528L1,Lleida,2000,110,70565,70675,0.1556420233463035
243.0,ES529L1,Ourense,2000,142,65026,65168,0.21789835502086913
244.0,ES532L1,Algeciras,2000,469,41825,42294,1.1089043363124793
245.0,ES533L1,Marbella,2000,591,68614,69205,0.853984538689401
246.0,ES537L1,Alcoy,2000,0,20529,20529,0.0
247.0,ES538L1,Ãvila,2000,581,53065,53646,1.0830257614733625
248.0,ES542L1,Cuenca,2000,73,164509,164582,0.044354789709688786
249.0,ES543L1,Eivissa,2000,2175,57227,59402,3.6614928790276418
250.0,ES544L1,Linares,2000,13,25763,25776,0.05043451272501552
251.0,ES545L1,Lorca,2000,108,182099,182207,0.059273244167348124
252.0,ES546L1,MÃ©rida,2000,888,127411,128299,0.6921332200562749
253.0,ES547L1,Sagunto,2000,344,15184,15528,2.215352910870685
254.0,ES550L1,Puerto de la Cruz,2000,27472,0,27472,100.0
255.0,ES552L1,Igualada,2000,0,25426,25426,0.0
256.0,FI001L3,Helsinki,2000,60855,430663,491518,12.38103182385996
257.0,FI002L3,Tampere,2000,411631,277012,688643,59.77422263785444
258.0,FI003L4,Turku,2000,35123,431321,466444,7.529950004716536
259.0,FI004L4,Oulu,2000,723821,0,723821,100.0
260.0,FI007L2,Lahti,2000,212380,123023,335403,63.32084089885899
261.0,FI008L2,Kuopio,2000,900181,20225,920406,97.80260015688728
262.0,FI009L2,JyvÃ¤skylÃ¤,2000,476942,0,476942,100.0
263.0,FR001L1,Paris,2000,4785,1205167,1209952,0.3954702335299252
264.0,FR003L2,Lyon,2000,1698,365533,367231,0.4623792653670305
265.0,FR004L2,Toulouse,2000,403,524269,524672,0.07680989265674555
266.0,FR006L2,Strasbourg,2000,1433,202450,203883,0.7028540878837373
267.0,FR007L2,Bordeaux,2000,5927,549827,555754,1.0664790536820248
268.0,FR008L2,Nantes,2000,7060,309559,316619,2.229809329193763
269.0,FR009L2,Lille,2000,549,143904,144453,0.3800544121617412
270.0,FR010L2,Montpellier,2000,7329,216589,223918,3.2730731785743
271.0,FR011L2,Saint-Etienne,2000,419,180636,181055,0.23142139128993952
272.0,FR012L2,Le Havre,2000,2448,73990,76438,3.2025955676495985
273.0,FR013L2,Rennes,2000,101,382036,382137,0.026430311642159747
274.0,FR014L2,Amiens,2000,10650,234145,244795,4.35057905594477
275.0,FR016L2,Nancy,2000,515,282994,283509,0.18165208159176605
276.0,FR017L2,Metz,2000,574,176356,176930,0.32442208783134574
277.0,FR018L2,Reims,2000,19,243132,243151,0.007814074381762773
278.0,FR019L2,OrlÃ©ans,2000,1044,290923,291967,0.35757465740991273
279.0,FR020L2,Dijon,2000,162,385599,385761,0.04199491394931058
280.0,FR021L2,Poitiers,2000,29,250413,250442,0.011579527395564641
281.0,FR022L2,Clermont-Ferrand,2000,57,266069,266126,0.021418425858427962
282.0,FR023L2,Caen,2000,57056,169217,226273,25.215558197398718
283.0,FR024L2,Limoges,2000,420,317414,317834,0.13214445276465073
284.0,FR025L2,BesanÃ§on,2000,11,239025,239036,0.004601817299486269
285.0,FR026L2,Grenoble,2000,1193,264655,265848,0.44875267069904606
286.0,FR027L2,Ajaccio,2000,1483,145526,147009,1.00878177526546
289.0,FR032L2,Toulon,2000,2254,104802,107056,2.1054401434763115
290.0,FR034L2,Valenciennes,2000,256,78190,78446,0.32633913775080947
291.0,FR035L2,Tours,2000,377,284471,284848,0.1323512891085772
292.0,FR036L2,Angers,2000,206,231045,231251,0.08908069586726113
293.0,FR037L2,Brest,2000,473,134521,134994,0.35038594307895166
294.0,FR038L2,Le Mans,2000,335,223776,224111,0.14947949899826427
295.0,FR039L1,Avignon,2000,1516,85709,87225,1.7380338205789623
296.0,FR040L2,Mulhouse,2000,63,129703,129766,0.048548926529291186
297.0,FR042L2,Dunkerque,2000,921,90204,91125,1.0106995884773662
298.0,FR043L2,Perpignan,2000,1683,181347,183030,0.919521389936076
299.0,FR044L2,NÃ®mes,2000,1363,149128,150491,0.9057020021130833
300.0,FR045L2,Pau,2000,35,201724,201759,0.017347429358789447
301.0,FR046L2,Bayonne,2000,1038,101592,102630,1.0114001753873136
302.0,FR047L0,Annemasse,2000,3,7797,7800,0.038461538461538464
303.0,FR048L2,Annecy,2000,2318,116725,119043,1.9471955511873862
304.0,FR049L2,Lorient,2000,498,112684,113182,0.43999929317382624
305.0,FR050L2,MontbÃ©liard,2000,42,123015,123057,0.03413052487871474
306.0,FR051L2,Troyes,2000,588,260362,260950,0.22533052308871432
307.0,FR052L2,Saint-Nazaire,2000,470,106665,107135,0.43869883791478037
308.0,FR053L2,La Rochelle,2000,557,110783,111340,0.5002694449434165
309.0,FR056L2,AngoulÃªme,2000,34,214258,214292,0.01586620125809643
310.0,FR057L2,Boulogne-sur-Mer,2000,518,68020,68538,0.7557851119087222
311.0,FR058L2,ChambÃ©ry,2000,2350,99339,101689,2.3109677546243943
312.0,FR059L2,Chalon-sur-SaÃ´ne,2000,233,156125,156358,0.14901699944998018
313.0,FR060L2,Chartres,2000,65,161295,161360,0.04028259791769956
314.0,FR061L2,Niort,2000,50,178869,178919,0.027945606671175224
315.0,FR062L2,Calais,2000,102,50128,50230,0.20306589687437787
316.0,FR063L2,BÃ©ziers,2000,577,84566,85143,0.6776834267056598
317.0,FR064L2,Arras,2000,66,107497,107563,0.06135938938110688
318.0,FR065L2,Bourges,2000,59,250260,250319,0.02356992477598584
319.0,FR066L2,Saint-Brieuc,2000,116,115065,115181,0.10071105477465901
320.0,FR067L2,Quimper,2000,476,121446,121922,0.39041354308492315
321.0,FR068L2,Vannes,2000,731,120303,121034,0.6039625229274419
322.0,FR069L2,Cherbourg,2000,547,90171,90718,0.6029674375537379
323.0,FR073L2,Tarbes,2000,112,104217,104329,0.10735270154990464
324.0,FR074L2,CompiÃ¨gne,2000,174,98563,98737,0.17622573098230654
325.0,FR076L2,Belfort,2000,19,65600,65619,0.028955028269251285
326.0,FR077L2,Roanne,2000,150,123050,123200,0.12175324675324675
327.0,FR079L2,Saint-Quentin,2000,68,99306,99374,0.06842836154326082
328.0,FR082L2,Beauvais,2000,32,131110,131142,0.024401030943557365
329.0,FR084L2,Creil,2000,38,29605,29643,0.1281921532908275
330.0,FR086L2,Evreux,2000,77,126493,126570,0.06083590108240499
331.0,FR090L2,ChÃ¢teauroux,2000,664,260513,261177,0.25423371889561486
332.0,FR093L2,Brive-la-Gaillarde,2000,42,132540,132582,0.031678508394804725
333.0,FR096L2,Albi,2000,92,134146,134238,0.06853499009222426
334.0,FR099L2,FrÃ©jus,2000,442,43971,44413,0.9952041069056358
335.0,FR104L2,ChÃ¢lons-en-Champagne,2000,74,152735,152809,0.04842646702746566
336.0,FR203L2,Marseille,2000,2849,422927,425776,0.6691311863515088
337.0,FR205L2,Nice,2000,968,306372,307340,0.31496062992125984
338.0,FR207L2,Lens - LiÃ©vin,2000,48,25260,25308,0.1896633475580844
339.0,FR208L1,HÃ©nin - Carvin,2000,35,11563,11598,0.30177616830488013
340.0,FR209L2,Douai,2000,203,44881,45084,0.4502706059799485
341.0,FR214L1,Valence,2000,590,90371,90961,0.6486296324798541
342.0,FR215L2,Rouen,2000,9080,278046,287126,3.1623747065748136
343.0,FR304L1,Melun,2000,104,44732,44836,0.231956463556071
344.0,FR324L1,Martigues,2000,1766,18690,20456,8.633163863903011
345.0,FR505L1,Charleville-MÃ©ziÃ¨res,2000,77,135292,135369,0.05688156077092983
346.0,FR506L1,Colmar,2000,231,101754,101985,0.2265038976320047
347.0,FR519L1,Cannes,2000,511,19625,20136,2.5377433452522844
348.0,HR001L2,Grad Zagreb,2000,110,505758,505868,0.02174480299208489
349.0,HR002L2,Rijeka,2000,571,106663,107234,0.5324803700318929
350.0,HR003L2,Slavonski Brod,2000,27,97803,97830,0.027598896044158234
351.0,HR004L2,Osijek,2000,1611,171323,172934,0.9315692692009668
352.0,HR005L2,Split,2000,3967,335103,339070,1.1699649040021234
353.0,HR006L1,Pula - Pola,2000,1258,57639,58897,2.1359322206564
354.0,HR007L1,Zadar,2000,2491,154009,156500,1.5916932907348242
355.0,HU001L2,Budapest,2000,7246,631888,639134,1.1337215669953407
356.0,HU002L2,Miskolc,2000,2698,161971,164669,1.6384383217241862
357.0,HU003L2,NyÃ­regyhÃ¡za,2000,121,168104,168225,0.07192747807995244
358.0,HU004L2,PÃ©cs,2000,42,185446,185488,0.02264297420857414
359.0,HU005L2,Debrecen,2000,552,201026,201578,0.27383940707815335
360.0,HU006L2,Szeged,2000,823,160110,160933,0.5113929399190967
361.0,HU007L2,GyÃµr,2000,662,203978,204640,0.323494917904613
362.0,HU008L2,KecskemÃ©t,2000,115,182024,182139,0.0631385919544963
363.0,HU009L2,SzÃ©kesfehÃ©rvÃ¡r,2000,1342,299781,301123,0.4456650604570226
364.0,HU010L1,Szombathely,2000,51,134226,134277,0.03798118814093255
365.0,HU011L1,Szolnok,2000,919,143056,143975,0.638305261330092
366.0,HU012L1,TatabÃ¡nya,2000,294,69536,69830,0.4210224831734211
367.0,HU013L1,VeszprÃ©m,2000,7157,124163,131320,5.450045689917758
368.0,HU014L1,BÃ©kÃ©scsaba,2000,130,106033,106163,0.122453208745043
369.0,HU015L1,KaposvÃ¡r,2000,95,145465,145560,0.06526518274251168
370.0,HU016L1,Eger,2000,3011,97567,100578,2.993696434607966
371.0,HU017L1,DunaÃºjvÃ¡ros,2000,804,60866,61670,1.3037133127939031
372.0,HU018L1,Zalaegerszeg,2000,183,139796,139979,0.13073389579865552
373.0,HU019L1,Sopron,2000,943,79727,80670,1.1689599603322176
374.0,IE001L1,Dublin,2000,21048,682554,703602,2.9914639242071512
375.0,IE002L1,Cork,2000,5465,324198,329663,1.6577535240533514
376.0,IE003L1,Limerick,2000,10564,145894,156458,6.75197177517289
377.0,IE004L1,Galway,2000,12898,213385,226283,5.699942107891446
378.0,IE005L1,Waterford,2000,9036,86821,95857,9.426541619287063
379.0,IS001L1,ReykjavÃ­k,2000,1297230,0,1297230,100.0
380.0,IT001L3,Roma,2000,8878,608338,617216,1.4383943384487765
381.0,IT002L3,Milano,2000,1208,382837,384045,0.3145464724185968
382.0,IT003L3,Napoli,2000,3133,149809,152942,2.0484889696747786
383.0,IT004L2,Torino,2000,154,170025,170179,0.0904929515392616
384.0,IT005L3,Palermo,2000,1518,148555,150073,1.0115077329033204
385.0,IT006L3,Genova,2000,3373,117391,120764,2.7930509092113547
386.0,IT007L3,Firenze,2000,116,163655,163771,0.07083061103614194
387.0,IT008L3,Bari,2000,801,112628,113429,0.7061686164913735
388.0,IT009L1,Bologna,2000,567,184690,185257,0.3060613094242053
389.0,IT010L2,Catania,2000,434,60991,61425,0.7065527065527066
390.0,IT011L2,Venezia,2000,1845,65192,67037,2.752211465310202
391.0,IT012L3,Verona,2000,67,73094,73161,0.09157884665327155
392.0,IT013L3,Cremona,2000,232,60165,60397,0.3841250393231452
393.0,IT014L3,Trento,2000,645,97542,98187,0.6569097742063613
394.0,IT015L1,Trieste,2000,356,21281,21637,1.6453297592087628
395.0,IT016L3,Perugia,2000,5765,125263,131028,4.3998229386085415
396.0,IT017L3,Ancona,2000,531,43712,44243,1.2001898605429107
397.0,IT019L2,Pescara,2000,272,16171,16443,1.6541993553487806
398.0,IT020L3,Campobasso,2000,286,102549,102835,0.27811542762678076
399.0,IT021L2,Caserta,2000,1,9341,9342,0.010704345964461572
400.0,IT022L2,Taranto,2000,3467,103461,106928,3.2423686966931022
401.0,IT023L2,Potenza,2000,78,138377,138455,0.05633599364414431
402.0,IT024L3,Catanzaro,2000,280,89803,90083,0.31082446188515034
403.0,IT025L3,Reggio di Calabria,2000,612,47636,48248,1.2684463604709004
404.0,IT026L3,Sassari,2000,2440,150785,153225,1.5924294338391254
405.0,IT027L2,Cagliari,2000,4906,190386,195292,2.5121356737603175
406.0,IT028L3,Padova,2000,14,61431,61445,0.02278460411750346
407.0,IT029L3,Brescia,2000,97,60172,60269,0.16094509615225072
408.0,IT030L3,Modena,2000,131,69137,69268,0.18912051741063696
409.0,IT031L3,Foggia,2000,6,89705,89711,0.006688143037085753
410.0,IT032L3,Salerno,2000,364,37475,37839,0.9619704537646344
411.0,IT033L2,Piacenza,2000,213,93914,94127,0.2262900124300148
412.0,IT034L1,Bolzano,2000,742,106014,106756,0.6950429015699352
413.0,IT035L2,Udine,2000,1,71829,71830,0.0013921759710427398
414.0,IT036L2,La Spezia,2000,730,42189,42919,1.7008783988443348
415.0,IT037L1,Lecce,2000,335,61175,61510,0.5446268899365957
416.0,IT038L1,Barletta,2000,233,14864,15097,1.5433529840365636
417.0,IT039L2,Pesaro,2000,152,25539,25691,0.5916468802304309
418.0,IT040L2,Como,2000,161,19580,19741,0.8155615217060939
419.0,IT041L2,Pisa,2000,512,47541,48053,1.0654901879175078
420.0,IT042L1,Treviso,2000,63,23982,24045,0.26200873362445415
421.0,IT043L2,Varese,2000,515,23149,23664,2.1763015551048004
422.0,IT045L2,Asti,2000,8,54828,54836,0.014588956160186739
423.0,IT046L2,Pavia,2000,142,36062,36204,0.3922218539387913
424.0,IT047L1,Massa,2000,334,10909,11243,2.970737347683003
425.0,IT048L2,Cosenza,2000,127,92352,92479,0.13732847457260566
426.0,IT052L1,Savona,2000,5005,23700,28705,17.435986761888174
427.0,IT054L1,Matera,2000,584,77205,77789,0.750748820527324
428.0,IT056L1,Acireale,2000,52,5936,5988,0.8684034736138945
429.0,IT057L2,Avellino,2000,33,39726,39759,0.08300007545461405
430.0,IT058L2,Pordenone,2000,45,37005,37050,0.12145748987854252
431.0,IT060L1,Lecco,2000,1245,28967,30212,4.1208791208791204
432.0,IT061L0,Altamura,2000,0,42800,42800,0.0
433.0,IT064L1,Battipaglia,2000,53,6433,6486,0.8171446191797719
434.0,IT065L0,Bisceglie,2000,93,6851,6944,1.3392857142857142
435.0,IT066L1,Carpi,2000,10,20612,20622,0.048491901852390655
436.0,IT067L0,Cerignola,2000,127,58770,58897,0.21563067728407218
437.0,IT068L1,Gallarate,2000,0,5319,5319,0.0
438.0,IT069L1,Gela,2000,439,57456,57895,0.7582692805941791
439.0,IT073L1,Sassuolo,2000,7,24055,24062,0.02909151358989278
440.0,IT501L2,Messina,2000,748,33695,34443,2.171703974682809
441.0,IT502L2,Prato,2000,627,40332,40959,1.5307990917747016
442.0,IT503L3,Parma,2000,182,113325,113507,0.16034253394063802
443.0,IT504L3,Livorno,2000,407,25407,25814,1.5766638258309442
444.0,IT505L3,Reggio nell'Emilia,2000,41,68993,69034,0.05939102471246053
445.0,IT506L2,Ravenna,2000,3385,77804,81189,4.1692840163076275
446.0,IT507L2,Ferrara,2000,258,91225,91483,0.2820196102008023
447.0,IT508L3,Rimini,2000,338,32241,32579,1.0374781300837963
448.0,IT509L3,Siracusa,2000,550,33592,34142,1.6109191025716125
449.0,IT511L2,Bergamo,2000,0,18556,18556,0.0
450.0,IT512L3,ForlÃ¬,2000,6,72745,72751,0.008247309315335872
451.0,IT513L3,Latina,2000,536,65957,66493,0.8060998902140074
452.0,IT514L2,Vicenza,2000,4,34978,34982,0.011434452003887714
453.0,IT515L2,Terni,2000,128,102204,102332,0.1250830629715045
454.0,IT516L2,Novara,2000,0,54165,54165,0.0
455.0,IT518L1,Alessandria,2000,779,76135,76914,1.0128195127024988
456.0,IT519L1,Arezzo,2000,64,88563,88627,0.0722127568348246
457.0,IT520L1,Grosseto,2000,381,119218,119599,0.31856453649278
458.0,IT521L1,Brindisi,2000,900,63087,63987,1.4065357025645835
459.0,IT522L1,Trapani,2000,1055,49735,50790,2.077180547351841
460.0,IT523L1,Ragusa,2000,273,52577,52850,0.5165562913907286
461.0,IT524L0,Andria,2000,0,39880,39880,0.0
462.0,IT525L0,Trani,2000,112,10267,10379,1.0791020329511514
463.0,IT526L1,L'Aquila,2000,903,139366,140269,0.6437630552723695
464.0,LT001L1,Vilnius,2000,4439,420130,424569,1.0455308795507914
465.0,LT002L1,Kaunas,2000,3644,158407,162051,2.2486747999086707
466.0,LT003L1,PanevÄÅ¾ys,2000,3668,219140,222808,1.6462604574342035
467.0,LT004L0,Alytus,2000,9,3950,3959,0.22733013387218998
468.0,LT501L0,KlaipÄda,2000,238,8685,8923,2.667264372968732
469.0,LT502L0,Å iauliai,2000,5710,2335,8045,70.97576134244873
470.0,LU001L1,Luxembourg,2000,5392,254323,259715,2.0761219028550526
471.0,LV001L1,RÄ«ga,2000,24439,591810,616249,3.9657670844090616
472.0,LV002L2,LiepÄja,2000,3582,268475,272057,1.3166358520457109
473.0,LV003L1,Jelgava,2000,4494,161965,166459,2.69976390582666
474.0,LV501L1,Daugavpils,2000,12295,247380,259675,4.734764609608164
475.0,ME001L1,Podgorica,2000,1172,183309,184481,0.6352957757167405
476.0,MK001L1,Skopje,2000,0,224353,224353,0.0
477.0,MK003L1,Bitola,2000,26,119636,119662,0.021727866824890106
478.0,MK004L1,Tetovo,2000,24,105597,105621,0.022722753997784534
479.0,MK005L1,Prilep,2000,53,86778,86831,0.061038108509633655
480.0,MT001L1,Valletta,2000,1051,24905,25956,4.049160117121282
481.0,NL001L3,s' Gravenhage,2000,5541,37166,42707,12.974453836607584
482.0,NL002L3,Amsterdam,2000,102403,230554,332957,30.75562309847818
483.0,NL003L3,Rotterdam,2000,31242,185929,217171,14.385898669711885
484.0,NL004L3,Utrecht,2000,24548,72739,97287,25.23255933475182
485.0,NL005L3,Eindhoven,2000,175,144231,144406,0.12118610030054153
486.0,NL006L3,Tilburg,2000,2526,40708,43234,5.8426238608502565
487.0,NL007L3,Groningen,2000,4523,203637,208160,2.172847809377402
488.0,NL008L3,Enschede,2000,9,84947,84956,0.01059371910165262
489.0,NL009L3,Arnhem,2000,1000,54898,55898,1.7889727718344128
490.0,NL010L3,Heerlen,2000,31,33312,33343,0.09297303781903248
491.0,NL012L3,Breda,2000,2585,70785,73370,3.523238380809595
492.0,NL013L3,Nijmegen,2000,1208,38628,39836,3.032432975198313
493.0,NL014L3,Apeldoorn,2000,10,71114,71124,0.01405995163376638
494.0,NL015L3,Leeuwarden,2000,27078,83845,110923,24.411528718119776
495.0,NL016L3,Sittard-Geleen,2000,50,22862,22912,0.21822625698324022
496.0,NL020L3,Roosendaal,2000,9,24565,24574,0.03662407422479043
497.0,NL026L0,Alphen aan den Rijn,2000,146,13064,13210,1.1052233156699471
498.0,NL028L3,Bergen op Zoom,2000,1329,33452,34781,3.821051723642219
499.0,NL030L0,Gouda,2000,5,1783,1788,0.2796420581655481
500.0,NL032L3,MiddelburgÂ Â Â Â Â Â ,2000,1304,22084,23388,5.575508807935694
501.0,NL503L3,s-Hertogenbosch,2000,5126,31733,36859,13.907051195094821
502.0,NL504L3,Amersfoort,2000,6205,6039,12244,50.67788304475661
503.0,NL505L3,Maastricht,2000,55,20330,20385,0.2698062300711307
504.0,NL507L3,Leiden,2000,256,19525,19781,1.2941711743592337
505.0,NL511L3,Zwolle,2000,628,122392,123020,0.5104860998211673
506.0,NL512L3,Ede,2000,83,35182,35265,0.23536083935913796
507.0,NL513L3,Deventer,2000,15,25230,25245,0.05941770647653001
508.0,NL514L3,Alkmaar,2000,1165,46627,47792,2.4376464680281216
509.0,NL515L3,Venlo,2000,861,50375,51236,1.6804590522289016
510.0,NL519L3,Almelo,2000,0,42025,42025,0.0
511.0,NL520L3,Lelystad,2000,73308,45534,118842,61.68526278588378
512.0,NL521L3,Oss,2000,251,32895,33146,0.7572557774693779
513.0,NL522L3,Assen,2000,275,70587,70862,0.388078236572493
514.0,NL524L3,Veenendaal,2000,22,8163,8185,0.2687843616371411
515.0,NL529L3,Soest,2000,6477,1465,7942,81.55376479476203
516.0,NO001L1,Oslo,2000,64227,682416,746643,8.602103013086577
517.0,NO002L1,Bergen,2000,165027,192716,357743,46.13004307561573
518.0,NO003L1,Trondheim,2000,382165,291091,673256,56.76369761279513
519.0,NO004L1,Stavanger,2000,31790,257287,289077,10.997069984813734
520.0,NO005L1,Kristiansand,2000,13118,302344,315462,4.158345537655882
521.0,NO006L1,TromsÃ¸,2000,374613,0,374613,100.0
522.0,PL001L2,Warszawa,2000,43304,817939,861243,5.028081505452003
523.0,PL002L2,ÅÃ³dÅº,2000,32,169468,169500,0.01887905604719764
524.0,PL003L2,KrakÃ³w,2000,842,374906,375748,0.22408635574906588
525.0,PL004L2,WrocÅaw,2000,120,264580,264700,0.04533434076312807
526.0,PL005L2,PoznaÅ,2000,447,308881,309328,0.14450680184141107
527.0,PL006L2,GdaÅsk,2000,2163,261353,263516,0.8208230240289015
528.0,PL007L2,Szczecin,2000,3305,109755,113060,2.923226605342296
529.0,PL008L2,Bydgoszcz,2000,1414,208722,210136,0.6728975520615221
530.0,PL009L2,Lublin,2000,1381,321403,322784,0.42784028948151087
531.0,PL010L2,Katowice,2000,3798,390797,394595,0.9625058604391844
532.0,PL011L2,BiaÅystok,2000,32,223290,223322,0.014329085356570332
533.0,PL012L2,Kielce,2000,64,224165,224229,0.02854224921843294
534.0,PL013L2,ToruÅ,2000,544,158389,158933,0.3422825970692053
535.0,PL014L2,Olsztyn,2000,59875,142669,202544,29.561477999842012
536.0,PL015L2,RzeszÃ³w,2000,205,229144,229349,0.08938342874832679
537.0,PL016L2,Opole,2000,923,175693,176616,0.5226027087013635
538.0,PL017L2,GorzÃ³w Wielkopolski,2000,1047,96373,97420,1.0747279819338944
539.0,PL018L2,Zielona GÃ³ra,2000,153,169131,169284,0.090380662082654
540.0,PL019L2,Jelenia GÃ³ra,2000,744,82597,83341,0.892717869955964
541.0,PL020L2,Nowy SÄcz,2000,2182,128236,130418,1.6730819365425018
542.0,PL021L2,SuwaÅki,2000,1159,70974,72133,1.6067541901764797
543.0,PL022L2,Konin,2000,975,117188,118163,0.8251313863053578
544.0,PL024L2,CzÄstochowa,2000,38,193860,193898,0.019597932933810562
545.0,PL025L2,Radom,2000,24,67998,68022,0.035282702655023375
546.0,PL026L2,PÅock,2000,5588,165487,171075,3.2664036241414585
547.0,PL027L2,Kalisz,2000,150,148873,149023,0.10065560349744669
548.0,PL028L2,Koszalin,2000,224,129447,129671,0.1727448697087244
549.0,PL029L1,SÅupsk,2000,7723,227281,235004,3.286327041241851
550.0,PL030L1,JastrzÄbie-ZdrÃ³j,2000,42,29529,29571,0.14203104392817287
551.0,PL031L1,Siedlce,2000,186,125983,126169,0.14742131585413215
552.0,PL032L1,PiotrkÃ³w Trybunalski,2000,184,116738,116922,0.15736987051196524
553.0,PL033L1,Lubin,2000,319,92987,93306,0.34188583799541294
554.0,PL034L1,PiÅa,2000,94,52098,52192,0.1801042305334151
555.0,PL035L1,InowrocÅaw,2000,7,20121,20128,0.03477742448330683
556.0,PL036L1,Ostrowiec ÅwiÄtokrzyski,2000,20,61440,61460,0.03254149040026033
557.0,PL037L1,Gniezno,2000,65,66506,66571,0.09764011356296286
558.0,PL038L1,Stargard SzczeciÅski,2000,1432,35232,36664,3.9057385991708484
559.0,PL039L1,OstrÃ³w Wielkopolski,2000,83,84678,84761,0.09792239355363905
560.0,PL040L1,PrzemyÅl,2000,14366,70723,85089,16.883498454559344
561.0,PL041L1,ZamoÅÄ,2000,5393,107314,112707,4.7849734266727
562.0,PL042L1,CheÅm,2000,710,45860,46570,1.5245866437620785
563.0,PL043L1,Pabianice,2000,1,32958,32959,0.0030340726356988985
564.0,PL044L1,GÅogÃ³w,2000,5,64076,64081,0.007802624802983724
565.0,PL045L1,Stalowa Wola,2000,616,189697,190313,0.3236773105358015
566.0,PL046L1,TomaszÃ³w Mazowiecki,2000,506,18657,19163,2.6405051401137607
567.0,PL047L1,ÅomÅ¼a,2000,52,55950,56002,0.09285382664904825
568.0,PL048L1,Leszno,2000,83,77489,77572,0.10699737018511835
569.0,PL049L1,Åwidnica,2000,2,47988,47990,0.004167534903104814
570.0,PL051L1,Tczew,2000,209,26915,27124,0.7705353192744433
571.0,PL052L1,EÅk,2000,663,39389,40052,1.6553480475382003
572.0,PL506L2,Bielsko-BiaÅa,2000,626,72809,73435,0.8524545516443114
573.0,PL508L1,Rybnik,2000,413,14468,14881,2.7753511188764195
574.0,PL511L2,WaÅbrzych,2000,1,51509,51510,0.0019413706076490003
575.0,PL512L2,ElblÄg,2000,128,96347,96475,0.1326768592899715
576.0,PL513L2,WÅocÅawek,2000,2620,119859,122479,2.13914222029899
577.0,PL514L2,TarnÃ³w,2000,504,124823,125327,0.4021479808820127
578.0,PL516L2,Legnica,2000,43,56457,56500,0.07610619469026549
579.0,PL517L2,GrudziÄdz,2000,954,54089,55043,1.733190414766637
580.0,PT001L3,Lisboa,2000,7625,431656,439281,1.7357909857243996
581.0,PT002L2,Porto,2000,1078,94662,95740,1.1259661583455192
582.0,PT003L1,Braga,2000,44,49305,49349,0.08916087458712435
583.0,PT004L2,Funchal,2000,35962,0,35962,100.0
584.0,PT005L2,Coimbra,2000,434,162353,162787,0.26660605576612384
585.0,PT007L1,Ponta Delgada,2000,55294,0,55294,100.0
586.0,PT008L2,Aveiro,2000,1824,41506,43330,4.209554581121624
587.0,PT009L1,Faro,2000,2636,46514,49150,5.363173957273652
588.0,PT014L1,Viseu,2000,5,70869,70874,0.007054773259587437
589.0,PT016L0,Viana do Castelo,2000,377,31875,32252,1.1689197569143
590.0,PT019L0,PÃ³voa de Varzim,2000,28,8378,8406,0.3330954080418749
591.0,PT505L1,GuimarÃ£es,2000,0,26541,26541,0.0
592.0,RO001L1,BucureÅti,2000,653,107189,107842,0.6055154763450232
593.0,RO002L1,Cluj-Napoca,2000,21,59281,59302,0.03541195912448147
594.0,RO003L1,TimiÅoara,2000,15,23639,23654,0.06341422169611906
595.0,RO004L1,Craiova,2000,80,34316,34396,0.2325851843237586
596.0,RO005L1,BrÄila,2000,1268,22261,23529,5.38909430915041
597.0,RO006L1,Oradea,2000,64,20275,20339,0.31466640444466293
598.0,RO007L1,BacÄu,2000,228,21865,22093,1.032001086316933
599.0,RO008L1,Arad,2000,49,51559,51608,0.09494651991939235
600.0,RO009L1,Sibiu,2000,67,56273,56340,0.11892083777067804
601.0,RO010L1,TÃ¢rgu MureÅ,2000,85,13655,13740,0.61863173216885
602.0,RO011L1,Piatra NeamÅ£,2000,88,14911,14999,0.586705780385359
603.0,RO012L1,CÇlÇraÅi,2000,564,23980,24544,2.2979139504563233
604.0,RO013L1,Giurgiu,2000,567,10383,10950,5.178082191780821
605.0,RO014L1,Alba Iulia,2000,11,25991,26002,0.0423044381201446
606.0,RO015L1,FocÅani,2000,0,27102,27102,0.0
607.0,RO016L1,TÃ¢rgu Jiu,2000,0,24522,24522,0.0
608.0,RO017L1,Tulcea,2000,1448,39499,40947,3.5362786040491367
609.0,RO018L1,TÃ¢rgoviÅte,2000,0,20257,20257,0.0
610.0,RO019L1,Slatina,2000,226,6897,7123,3.1728204408254945
611.0,RO020L1,BÃ¢rlad,2000,95,26224,26319,0.36095596337246855
612.0,RO021L1,Roman,2000,6,14384,14390,0.04169562195969423
613.0,RO022L1,BistriÅ£a,2000,0,42631,42631,0.0
614.0,RO501L1,Constanta,2000,6390,52961,59351,10.766457178480564
615.0,RO502L1,Iasi,2000,209,79727,79936,0.2614591673338671
616.0,RO503L1,Galati,2000,1006,40226,41232,2.439852541715173
617.0,RO504L1,Brasov,2000,94,98409,98503,0.09542856562744281
618.0,RO505L1,Ploiesti,2000,2,34335,34337,0.005824620671578763
619.0,RO506L1,Pitesti,2000,31,24853,24884,0.12457804211541554
620.0,RO507L1,Baia Mare,2000,11,52530,52541,0.020936030909194724
621.0,RO508L1,Buzau,2000,2,38538,38540,0.005189413596263622
622.0,RO509L1,Satu Mare,2000,1,70843,70844,0.0014115521427361527
623.0,RO510L1,Botosani,2000,122,37218,37340,0.32672737011247993
624.0,RO511L1,Ramnicu Valcea,2000,422,28751,29173,1.4465430363692455
625.0,RO512L1,Suceava,2000,89,39589,39678,0.22430566056756895
626.0,RO513L1,Drobeta-Turnu Severin,2000,2232,30702,32934,6.777190745126617
627.0,RS001L1,Beograd,2000,6724,306300,313024,2.1480781026374975
628.0,RS002L1,Novi Sad,2000,2472,186971,189443,1.3048779844069194
629.0,RS003L1,NiÅ¡,2000,3,341561,341564,0.0008783127027438488
630.0,RS004L1,Kragujevac,2000,661,143414,144075,0.4587888252646191
631.0,RS005L1,Subotica,2000,237,160055,160292,0.14785516432510667
632.0,RS006L1,Novi Pazar,2000,40,140751,140791,0.028410906947177017
633.0,RS008L1,Zrenjanin,2000,1392,183739,185131,0.7519000059417386
634.0,RS009L1,Kraljevo,2000,1,176511,176512,0.0005665337200870196
635.0,RS011L0,ÄaÄak,2000,38,63649,63687,0.05966680798279084
636.0,RS012L1,KruÅ¡evac,2000,3,122646,122649,0.0024460044517281023
637.0,RS013L1,Leskovac,2000,0,166282,166282,0.0
638.0,RS014L1,Valjevo,2000,8,141654,141662,0.005647244850418602
639.0,RS015L1,Vranje,2000,2,195354,195356,0.0010237719855033887
640.0,RS016L1,Smederevo,2000,3048,157176,160224,1.902336728579988
641.0,SE001L1,Stockholm,2000,69080,686646,755726,9.140879101685002
642.0,SE002L1,GÃ¶teborg,2000,18301,416958,435259,4.204622994584834
643.0,SE003L1,MalmÃ¶,2000,3538,184478,188016,1.8817547442770828
644.0,SE004L1,JÃ¶nkÃ¶ping,2000,45602,301589,347191,13.13455705937078
645.0,SE005L1,UmeÃ¥,2000,988249,0,988249,100.0
646.0,SE006L1,Uppsala,2000,20073,677454,697527,2.877738066053357
647.0,SE007L1,LinkÃ¶ping,2000,15023,408173,423196,3.5498917759147064
648.0,SE008L1,Ãrebro,2000,33096,335501,368597,8.97891192820343
649.0,SE501L1,VÃ¤sterÃ¥s,2000,20441,269974,290415,7.0385482843517035
650.0,SE502L1,NorrkÃ¶ping,2000,15767,295971,311738,5.057772873374436
651.0,SE503L1,Helsingborg,2000,1543,112879,114422,1.3485168936043768
652.0,SE505L1,BorÃ¥s,2000,2265,95097,97362,2.3263696308621435
653.0,SI001L2,Ljubljana,2000,396,232891,233287,0.16974799281571626
654.0,SI002L1,Maribor,2000,618,216367,216985,0.28481231421526837
655.0,SK001L1,Bratislava,2000,1972,202969,204941,0.9622281534685593
656.0,SK002L1,KoÅ¡ice,2000,5031,172603,177634,2.8322280644471216
657.0,SK003L1,BanskÃ¡ Bystrica,2000,4793,76087,80880,5.926063303659743
658.0,SK004L1,Nitra,2000,20,87107,87127,0.022954996728912967
659.0,SK005L1,PreÅ¡ov,2000,2515,90784,93299,2.6956344655355364
660.0,SK006L1,Å½ilina,2000,244,81204,81448,0.29957764463215797
661.0,SK007L1,Trnava,2000,138,74082,74220,0.1859337105901374
662.0,SK008L1,TrenÄÃ­n,2000,45,67378,67423,0.06674280290108717
739.0,UK001L3,London,2000,55856,642314,698170,8.000343755818784
740.0,UK002L3,West Midlands urban area,2000,22528,192781,215309,10.4631018675485
741.0,UK003L2,Leeds,2000,46857,465570,512427,9.144131749497978
742.0,UK004L1,Glasgow,2000,5869,331815,337684,1.7380154227028821
743.0,UK006L3,Liverpool,2000,621,99882,100503,0.6178920032237843
744.0,UK007L1,Edinburgh,2000,14597,160821,175418,8.321266916736025
745.0,UK008L3,Greater Manchester,2000,21235,291011,312246,6.800727631418817
746.0,UK009L1,Cardiff,2000,722,83769,84491,0.8545288847332851
747.0,UK010L3,Sheffield,2000,955,125132,126087,0.7574135319263683
748.0,UK011L2,Bristol,2000,9175,89210,98385,9.325608578543477
749.0,UK012L2,Belfast,2000,44715,150430,195145,22.913730815547414
750.0,UK013L2,Newcastle upon Tyne,2000,44000,502708,546708,8.048171967485384
751.0,UK014L1,Leicester,2000,8,139773,139781,0.005723238494502114
752.0,UK016L1,Aberdeen,2000,53193,600755,653948,8.134132989167336
753.0,UK017L2,Cambridge,2000,297,159322,159619,0.18606807460264757
754.0,UK018L3,Exeter,2000,14684,233042,247726,5.927516691828876
755.0,UK019L3,Lincoln,2000,27,211516,211543,0.012763362531494779
756.0,UK023L1,Portsmouth,2000,654,20199,20853,3.1362393900158247
757.0,UK024L1,Worcester,2000,1828,59374,61202,2.9868304957354335
758.0,UK025L3,Coventry,2000,39,81408,81447,0.047883899959482855
759.0,UK026L1,Kingston upon Hull,2000,1383,250315,251698,0.549468013253979
760.0,UK027L1,Stoke-on-Trent,2000,4293,83883,88176,4.868671747414263
761.0,UK029L1,Nottingham,2000,5,90284,90289,0.005537773150660657
762.0,UK033L1,Guildford,2000,21,61670,61691,0.034040621808691704
763.0,UK050L1,Burnley,2000,2878,25096,27974,10.288124687209551
764.0,UK056L1,Hastings,2000,41077,13673,54750,75.02648401826484
765.0,UK515L1,Brighton and Hove,2000,9690,32717,42407,22.85000117905063
766.0,UK516L1,Plymouth,2000,1819,213956,215775,0.8430077627157919
767.0,UK517L1,Swansea,2000,600,83442,84042,0.7139287499107588
768.0,UK518L1,Derby,2000,23,68079,68102,0.0337728701066048
769.0,UK520L2,Southampton,2000,1447,151905,153352,0.943580781470082
770.0,UK528L1,Northampton,2000,50,154495,154545,0.0323530363324598
771.0,UK539L1,Bournemouth,2000,1138,92655,93793,1.2133101617391489
772.0,UK546L1,Colchester,2000,11452,58043,69495,16.478883372904527
773.0,UK550L0,Dundee City,2000,30573,195843,226416,13.503020987916049
774.0,UK551L1,Falkirk,2000,149,29640,29789,0.5001846319111081
775.0,UK552L0,Reading,2000,17,21904,21921,0.07755120660553808
776.0,UK553L1,Blackpool,2000,77,48878,48955,0.15728730466755184
777.0,UK557L1,Blackburn with Darwen,2000,196,79358,79554,0.24637353244337182
778.0,UK558L1,Newport,2000,2091,29609,31700,6.59621451104101
779.0,UK559L2,Middlesbrough,2000,3522,58247,61769,5.701889297220288
780.0,UK560L1,Oxford,2000,115,192808,192923,0.05960927416637726
781.0,UK562L2,Preston,2000,8,25754,25762,0.031053489635897838
782.0,UK566L1,Norwich,2000,65671,84569,150240,43.71072949946752
783.0,UK568L1,Cheshire West and Chester,2000,1408,134737,136145,1.0341914870175182
784.0,UK569L2,Ipswich,2000,28304,127342,155646,18.18485537694512
785.0,UK571L1,Cheltenham,2000,31,46152,46183,0.06712426650499102
786.0,XK001L1,Pristina,2000,20,255787,255807,0.007818394336355143
787.0,XK002L1,Prizren,2000,4,127629,127633,0.0031339857246950238
788.0,XK003L1,MitrovicÃ«,2000,1,117913,117914,0.0008480757161999422
1.0,AL001L1,Tirana,2001,1602,165519,167121,0.9585868921320481
2.0,AL003L1,Elbasan,2001,867,125137,126004,0.6880733944954129
3.0,AL004L1,ShkodÃ«r,2001,9379,175950,185329,5.060729837208424
4.0,AL005L0,VlorÃ«,2001,2142,61591,63733,3.360896238997066
5.0,AT001L3,Wien,2001,2811,915679,918490,0.3060457925508171
6.0,AT002L3,Graz,2001,218,290914,291132,0.07488012310567028
7.0,AT003L3,Linz,2001,2119,357111,359230,0.5898727834534978
8.0,AT004L3,Salzburg,2001,977,136499,137476,0.7106694986761326
9.0,AT005L3,Innsbruck,2001,19297,193525,212822,9.067201699072465
10.0,AT006L2,Klagenfurt,2001,1035,182225,183260,0.5647713630906908
11.0,BA001L1,Sarajevo,2001,17,263757,263774,0.006444911173959526
12.0,BA002L1,Banja Luka,2001,0,275302,275302,0.0
13.0,BA003L1,Mostar,2001,2427,179920,182347,1.3309788480205322
14.0,BA004L1,Tuzla,2001,246,112015,112261,0.2191322008533685
15.0,BA005L1,Zenica,2001,10022,76694,86716,11.557267401632917
16.0,BE001L2,Bruxelles / Brussel,2001,150,326501,326651,0.04592056965997349
17.0,BE002L2,Antwerpen,2001,6899,112313,119212,5.7871690769385635
18.0,BE003L2,Gent,2001,852,100989,101841,0.836598226647421
19.0,BE004L2,Charleroi,2001,209,109556,109765,0.19040677811688606
20.0,BE005L2,LiÃ¨ge,2001,317,141081,141398,0.2241898753872049
21.0,BE006L2,Brugge,2001,5748,50791,56539,10.166433789065954
22.0,BE007L2,Namur,2001,7,84100,84107,0.008322731758355429
23.0,BE008L1,Leuven,2001,21,45055,45076,0.04658798473688881
24.0,BE009L1,Mons,2001,45,39155,39200,0.11479591836734696
25.0,BE010L1,Kortrijk,2001,2834,19505,22339,12.686333318411746
26.0,BE011L1,Oostende,2001,176,20756,20932,0.8408178864895853
27.0,BG001L2,Sofia,2001,1142,570632,571774,0.19972926366011745
28.0,BG002L2,Plovdiv,2001,254,276832,277086,0.09166829071118715
29.0,BG003L2,Varna,2001,3788,201010,204798,1.8496274377679471
30.0,BG004L2,Burgas,2001,7104,288796,295900,2.4008110848259547
31.0,BG005L1,Pleven,2001,1050,178026,179076,0.5863432285733432
32.0,BG006L2,Ruse,2001,2531,131486,134017,1.8885663759075342
33.0,BG007L2,Vidin,2001,1779,59185,60964,2.918115609211994
34.0,BG008L2,Stara Zagora,2001,29,132039,132068,0.021958385074355637
35.0,BG009L1,Sliven,2001,31,136743,136774,0.022665126412914734
36.0,BG010L1,Dobrich,2001,37,140301,140338,0.026364918981316536
37.0,BG011L1,Shumen,2001,57,94450,94507,0.060312992688372286
38.0,BG013L1,Yambol,2001,256,130550,130806,0.1957096769261349
39.0,BG014L1,Haskovo,2001,394,73574,73968,0.5326627730910664
40.0,BG015L1,Pazardzhik,2001,10,63812,63822,0.01566857823321112
41.0,BG016L1,Blagoevgrad,2001,1353,134126,135479,0.9986787620221584
42.0,BG017L1,Veliko Tarnovo,2001,3,88536,88539,0.0033883373428658554
43.0,BG018L1,Vratsa,2001,81,70476,70557,0.11480079935371401
44.0,CH001L2,ZÃ¼rich,2001,10,127707,127717,0.007829811223251408
45.0,CH002L2,GenÃ¨ve,2001,126,53771,53897,0.23377924559808524
46.0,CH003L2,Basel,2001,263,69157,69420,0.3788533563814463
47.0,CH004L2,Bern,2001,12,78276,78288,0.015328019619865112
48.0,CH005L2,Lausanne,2001,1,77504,77505,0.0012902393393974584
49.0,CH006L1,Winterthur,2001,0,13291,13291,0.0
50.0,CH007L2,St. Gallen,2001,118,31791,31909,0.36980162336644834
51.0,CH008L2,Luzern,2001,17,29242,29259,0.058101780648689295
52.0,CH009L2,Lugano,2001,40,30585,30625,0.1306122448979592
53.0,CH010L1,Biel/Bienne,2001,3,9092,9095,0.032985156679494226
54.0,CY001L2,Lefkosia,2001,29,162599,162628,0.017832107632142068
55.0,CY501L2,Lemesos,2001,982,124917,125899,0.7799903096926902
56.0,CZ001L2,Praha,2001,704,569858,570562,0.12338711656226667
57.0,CZ002L2,Brno,2001,147,267768,267915,0.05486814847992834
58.0,CZ003L2,Ostrava,2001,1089,141577,142666,0.7633213239314203
59.0,CZ004L2,PlzeÅ,2001,603,195354,195957,0.307720571349837
60.0,CZ005L2,ÃstÃ­ nad Labem,2001,4279,31632,35911,11.915569045696305
61.0,CZ006L2,Olomouc,2001,67,93497,93564,0.07160873840365953
62.0,CZ007L2,Liberec,2001,2,61314,61316,0.0032617913758236023
63.0,CZ008L2,ÄeskÃ© BudÄjovice,2001,1024,128380,129404,0.7913202064851164
64.0,CZ009L2,Hradec KrÃ¡lovÃ©,2001,52,79453,79505,0.06540469152883467
65.0,CZ010L2,Pardubice,2001,136,86221,86357,0.15748578574985236
66.0,CZ011L2,ZlÃ­n,2001,31,57921,57952,0.053492545554942025
67.0,CZ013L2,Karlovy Vary,2001,67,46917,46984,0.14260173676145071
68.0,CZ014L2,Jihlava,2001,6,96021,96027,0.006248242681745759
69.0,CZ016L2,Most,2001,1706,26072,27778,6.141550867593059
70.0,CZ018L2,Chomutov-Jirkov,2001,773,44913,45686,1.691984415357002
71.0,DE001L1,Berlin,2001,7153,1741112,1748265,0.4091484986543802
72.0,DE002L1,Hamburg,2001,14146,720028,734174,1.9267911966373095
73.0,DE003L1,MÃ¼nchen,2001,10681,539260,549941,1.9422083459862058
74.0,DE004L1,KÃ¶ln,2001,944,161686,162630,0.5804587099551128
75.0,DE005L1,Frankfurt am Main,2001,10730,419601,430331,2.49342947637981
76.0,DE007L1,Stuttgart,2001,167,365003,365170,0.04573212476380864
77.0,DE008L2,Leipzig,2001,2241,395448,397689,0.5635056539154968
78.0,DE009L2,Dresden,2001,22052,561144,583196,3.7812330674421633
79.0,DE011L1,DÃ¼sseldorf,2001,2375,117942,120317,1.9739521430886742
80.0,DE012L1,Bremen,2001,10011,579528,589539,1.698106486593762
81.0,DE013L1,Hannover,2001,2891,294421,297312,0.9723791841567109
82.0,DE014L1,NÃ¼rnberg,2001,332,293169,293501,0.11311716144067653
83.0,DE017L0,Bielefeld,2001,0,25883,25883,0.0
84.0,DE018L1,Halle an der Saale,2001,383,157203,157586,0.24304189458454428
85.0,DE019L2,Magdeburg,2001,444,416590,417034,0.10646613945145958
86.0,DE020L1,Wiesbaden,2001,2100,99338,101438,2.070230091287289
87.0,DE021L1,GÃ¶ttingen,2001,646,238311,238957,0.2703415258812255
88.0,DE025L1,Darmstadt,2001,46,78141,78187,0.05883330988527504
89.0,DE026L1,Trier,2001,927,120200,121127,0.7653124406614544
90.0,DE027L1,Freiburg im Breisgau,2001,573,220623,221196,0.25904627570118804
91.0,DE028L1,Regensburg,2001,141,253521,253662,0.0555857795018568
92.0,DE029L0,Frankfurt (Oder),2001,33,14811,14844,0.22231204527081652
93.0,DE030L1,Weimar,2001,86,88942,89028,0.09659882284225187
94.0,DE031L1,Schwerin,2001,8470,481533,490003,1.7285608455458437
95.0,DE032L1,Erfurt,2001,7302,278210,285512,2.5575107175880527
96.0,DE033L1,Augsburg,2001,175,199759,199934,0.08752888453189553
97.0,DE034L1,Bonn,2001,4508,124829,129337,3.485468195489303
98.0,DE035L1,Karlsruhe,2001,457,125355,125812,0.36324039042380696
99.0,DE036L0,MÃ¶nchengladbach,2001,2722,14301,17023,15.990130999236326
100.0,DE037L1,Mainz,2001,994,69311,70305,1.4138396984567243
101.0,DE038L1,Ruhrgebiet,2001,5542,438210,443752,1.2488957796246551
102.0,DE039L1,Kiel,2001,25133,314629,339762,7.397236889351958
103.0,DE040L1,SaarbrÃ¼cken,2001,52785,100897,153682,34.346898140315716
104.0,DE042L1,Koblenz,2001,35983,56193,92176,39.03727651449401
105.0,DE043L2,Rostock,2001,4636,357168,361804,1.2813567566969961
106.0,DE044L1,Kaiserslautern,2001,7903,127624,135527,5.831310366200093
107.0,DE045L1,Iserlohn,2001,4206,101901,106107,3.963923209590319
108.0,DE048L1,Wilhelmshaven,2001,1837,72210,74047,2.4808567531432737
109.0,DE050L1,TÃ¼bingen,2001,19,52006,52025,0.03652090341182124
110.0,DE051L1,Villingen-Schwenningen,2001,1,102559,102560,0.0009750390015600624
111.0,DE052L1,Flensburg,2001,8823,196652,205475,4.293953035649105
112.0,DE053L1,Marburg,2001,35,126207,126242,0.027724529079070356
113.0,DE054L1,Konstanz,2001,133,81767,81900,0.1623931623931624
114.0,DE055L0,NeumÃ¼nster,2001,262,6914,7176,3.6510590858416943
115.0,DE056L0,Brandenburg an der Havel,2001,1536,21294,22830,6.7279894875164254
116.0,DE057L1,GieÃen,2001,1764,83764,85528,2.0624824618838278
117.0,DE058L1,LÃ¼neburg,2001,127,132375,132502,0.09584760984739853
118.0,DE059L1,Bayreuth,2001,1704,198216,199920,0.8523409363745498
119.0,DE060L1,Celle,2001,1204,153843,155047,0.7765387269666617
120.0,DE061L1,Aschaffenburg,2001,339,147277,147616,0.22964990244959896
121.0,DE062L1,Bamberg,2001,107,122048,122155,0.08759363104252793
122.0,DE063L1,Plauen,2001,2442,138846,141288,1.728384576184814
123.0,DE064L1,Neubrandenburg,2001,27404,556587,583991,4.69253806993601
124.0,DE065L1,Fulda,2001,17,138208,138225,0.012298788207632484
125.0,DE066L1,Kempten (AllgÃ¤u),2001,1130,158037,159167,0.7099461571808227
126.0,DE067L1,Landshut,2001,63,141390,141453,0.04453776165934975
127.0,DE069L1,Rosenheim,2001,126,147637,147763,0.08527168506324317
128.0,DE071L1,Stralsund,2001,17351,320897,338248,5.129668172465173
129.0,DE072L1,Friedrichshafen,2001,84,66535,66619,0.12609015446043922
130.0,DE073L1,Offenburg,2001,537,185347,185884,0.28888984527985195
131.0,DE074L1,GÃ¶rlitz,2001,962,210145,211107,0.4556930845495412
132.0,DE077L1,Schweinfurt,2001,179,201161,201340,0.08890434091586372
133.0,DE078L1,Greifswald,2001,4187,345607,349794,1.1969902285345089
134.0,DE079L1,Wetzlar,2001,156,106334,106490,0.1464926284158137
135.0,DE081L1,Passau,2001,712,159354,160066,0.44481651318830984
136.0,DE082L0,Dessau-RoÃlau,2001,0,24648,24648,0.0
137.0,DE083L1,Braunschweig-Salzgitter-Wolfsburg,2001,229,412615,412844,0.05546889381945723
138.0,DE084L1,Mannheim-Ludwigshafen,2001,889,203539,204428,0.4348719353513217
139.0,DE504L1,MÃ¼nster,2001,102,141661,141763,0.07195107327017627
140.0,DE505L0,Chemnitz,2001,6,22187,22193,0.02703555175055198
141.0,DE507L1,Aachen,2001,19830,50690,70520,28.119682359614295
142.0,DE508L0,Krefeld,2001,958,12722,13680,7.002923976608187
143.0,DE510L1,LÃ¼beck,2001,17819,144330,162149,10.989275296178207
144.0,DE513L1,Kassel,2001,273,139588,139861,0.1951937995581327
145.0,DE516L0,Solingen,2001,4,8950,8954,0.04467277194549922
146.0,DE517L1,OsnabrÃ¼ck,2001,78,224052,224130,0.034801231428189
147.0,DE520L1,Oldenburg (Oldenburg),2001,1062,188907,189969,0.5590385799788387
148.0,DE522L1,Heidelberg,2001,252,116853,117105,0.2151914948123479
149.0,DE523L1,Paderborn,2001,95,124588,124683,0.07619322602118973
150.0,DE524L2,WÃ¼rzburg,2001,372,305557,305929,0.12159684109711731
151.0,DE527L1,Bremerhaven,2001,5891,208588,214479,2.7466558497568525
152.0,DE529L1,Heilbronn,2001,70,119914,119984,0.05834111214828644
153.0,DE530L0,Remscheid,2001,60,7309,7369,0.8142217397204505
154.0,DE532L1,Ulm,2001,461,198847,199308,0.23130029903465993
155.0,DE533L1,Pforzheim,2001,1,67147,67148,0.001489247632096265
156.0,DE534L1,Ingolstadt,2001,730,284105,284835,0.25628872856215
157.0,DE535L1,Gera,2001,172,99614,99786,0.17236886938047422
158.0,DE537L1,Reutlingen,2001,6,109276,109282,0.005490382679672773
159.0,DE539L1,Cottbus,2001,858,181422,182280,0.4707044107965767
160.0,DE540L2,Siegen,2001,29158,148406,177564,16.421121398481674
161.0,DE542L1,Hildesheim,2001,72,120738,120810,0.059597715420908866
162.0,DE544L1,Zwickau,2001,65,94739,94804,0.06856250791105861
163.0,DE546L0,Wuppertal,2001,443,16390,16833,2.6317352818867703
164.0,DE547L2,Jena,2001,1,93067,93068,0.0010744831735935015
165.0,DE548L1,DÃ¼ren,2001,2768,91270,94038,2.9434909291988345
166.0,DE549L1,Bocholt,2001,7122,135143,142265,5.006150493796787
167.0,DK001L2,KÃ¸benhavn,2001,16524,274699,291223,5.674002396788715
168.0,DK002L3,Ãrhus,2001,4458,458066,462524,0.9638418763134454
169.0,DK003L2,Odense,2001,8509,351330,359839,2.364668643476666
170.0,DK004L3,Aalborg,2001,7818,612641,620459,1.2600349096394765
171.0,EE001L1,Tallinn,2001,6315,432746,439061,1.4382967287005677
172.0,EE002L1,Tartu,2001,786,298856,299642,0.262313026878742
173.0,EE003L0,Narva,2001,497,6392,6889,7.2143997677456815
174.0,EL001L1,Athina,2001,5225,304162,309387,1.6888233830122144
175.0,EL002L1,Thessaloniki,2001,1510,140609,142119,1.0624898852370197
176.0,EL003L1,Patra,2001,696,50894,51590,1.3490986625314985
177.0,EL004L1,Irakleio,2001,1102,60282,61384,1.79525609279291
178.0,EL005L1,Larisa,2001,61,155458,155519,0.03922350323754654
179.0,EL006L1,Volos,2001,263,30553,30816,0.8534527518172378
180.0,EL007L1,Ioannina,2001,2007,130634,132641,1.513106807095845
181.0,EL008L1,Kavala,2001,336,35232,35568,0.9446693657219973
182.0,EL009L1,Kalamata,2001,269,44183,44452,0.6051471249887519
183.0,ES001L3,Madrid,2001,2498,785105,787603,0.31716486605561434
184.0,ES002L2,Barcelona,2001,1716,262891,264607,0.6485089207768502
185.0,ES003L3,Valencia,2001,3309,171811,175120,1.889561443581544
186.0,ES004L3,Sevilla,2001,4340,464086,468426,0.9265070683523119
187.0,ES005L2,Zaragoza,2001,178,275960,276138,0.06446052336150765
188.0,ES006L2,MÃ¡laga,2001,962,151780,152742,0.6298202197169083
189.0,ES007L2,Murcia,2001,134,120002,120136,0.11154025437837117
190.0,ES008L2,Las Palmas,2001,76596,0,76596,100.0
191.0,ES009L2,Valladolid,2001,183,115346,115529,0.1584017865644124
192.0,ES010L2,Palma de Mallorca,2001,2326,201908,204234,1.1388897049462872
193.0,ES011L2,Santiago de Compostela,2001,13,126243,126256,0.010296540362438222
194.0,ES012L2,Vitoria/Gasteiz,2001,445,158876,159321,0.27931032318401217
195.0,ES013L2,Oviedo,2001,0,93487,93487,0.0
196.0,ES014L3,Pamplona/IruÃ±a,2001,103,169411,169514,0.06076194296636266
197.0,ES015L2,Santander,2001,131,69352,69483,0.18853532518745592
198.0,ES016L2,Toledo,2001,472,92926,93398,0.5053641405597551
199.0,ES017L2,Badajoz,2001,694,218055,218749,0.3172585931821402
200.0,ES018L2,LogroÃ±o,2001,109,46029,46138,0.2362477784039187
201.0,ES019L3,Bilbao,2001,1242,152079,153321,0.8100651574148356
202.0,ES020L2,CÃ³rdoba,2001,1432,185470,186902,0.7661769269456721
203.0,ES021L2,Alicante/Alacant,2001,436,35622,36058,1.2091630151422708
204.0,ES022L2,Vigo,2001,1013,135458,136471,0.7422822431139217
205.0,ES023L2,GijÃ³n,2001,479,52923,53402,0.8969701509306767
206.0,ES025L3,Santa Cruz de Tenerife,2001,66983,0,66983,100.0
207.0,ES026L2,CoruÃ±a (A),2001,522,75453,75975,0.6870681145113524
208.0,ES028L1,Reus,2001,0,11534,11534,0.0
209.0,ES031L1,Lugo,2001,4,134007,134011,0.002984829603540008
210.0,ES033L1,Girona,2001,2,39619,39621,0.005047828171929028
211.0,ES034L1,CÃ¡ceres,2001,1968,236305,238273,0.8259433506943716
212.0,ES035L1,Torrevieja,2001,1740,7098,8838,19.687712152070606
213.0,ES039L1,AvilÃ©s,2001,240,18902,19142,1.2537874830216278
214.0,ES040L1,Talavera de la Reina,2001,558,82708,83266,0.6701414743112435
215.0,ES041L1,Palencia,2001,4,28377,28381,0.014093936083999859
216.0,ES043L1,Ferrol,2001,669,46301,46970,1.4243133915265063
217.0,ES044L1,Pontevedra,2001,145,51471,51616,0.2809206447613143
218.0,ES046L1,Gandia,2001,240,17097,17337,1.3843225471534868
219.0,ES048L1,Guadalajara,2001,27,45356,45383,0.05949364299407267
220.0,ES050L1,Manresa,2001,4,29599,29603,0.01351214403945546
221.0,ES053L1,Ciudad Real,2001,650,95695,96345,0.6746587783486429
222.0,ES054L1,Benidorm,2001,325,20348,20673,1.5720988729260386
223.0,ES057L1,Ponferrada,2001,252,62091,62343,0.4042153890573119
224.0,ES059L1,Zamora,2001,338,33842,34180,0.9888823873610298
225.0,ES070L1,Irun,2001,45,7197,7242,0.6213753106876554
226.0,ES072L1,Arrecife,2001,58934,0,58934,100.0
227.0,ES501L3,Granada,2001,554,162070,162624,0.3406631247540338
228.0,ES505L1,Elche/Elx,2001,721,38097,38818,1.857385748879386
229.0,ES506L1,Cartagena,2001,1591,59357,60948,2.610421999081184
230.0,ES508L1,Jerez de la Frontera,2001,150,125956,126106,0.11894755205937861
231.0,ES510L1,Donostia-San SebastiÃ¡n,2001,125,33195,33320,0.3751500600240096
232.0,ES514L1,AlmerÃ­a,2001,770,39960,40730,1.8904984041247237
233.0,ES515L1,Burgos,2001,0,149391,149391,0.0
234.0,ES516L1,Salamanca,2001,23,45621,45644,0.05038997458592586
235.0,ES519L1,Albacete,2001,6,245319,245325,0.0024457352491592784
236.0,ES520L1,CastellÃ³n/CastellÃ³,2001,339,32455,32794,1.0337256815271085
237.0,ES521L1,Huelva,2001,3990,93430,97420,4.095668240607678
238.0,ES522L1,CÃ¡diz,2001,1085,23748,24833,4.369186163572666
239.0,ES523L1,LeÃ³n,2001,1,118886,118887,0.0008411348591519679
240.0,ES525L1,Tarragona,2001,508,21232,21740,2.3367065317387303
241.0,ES527L1,JaÃ©n,2001,32,99899,99931,0.03202209524571955
242.0,ES528L1,Lleida,2001,120,70555,70675,0.16979129819596747
243.0,ES529L1,Ourense,2001,198,64970,65168,0.30383010066290206
244.0,ES532L1,Algeciras,2001,558,41736,42294,1.3193360760391544
245.0,ES533L1,Marbella,2001,608,68597,69205,0.8785492377718372
246.0,ES537L1,Alcoy,2001,0,20529,20529,0.0
247.0,ES538L1,Ãvila,2001,574,53072,53646,1.0699772583230809
248.0,ES542L1,Cuenca,2001,79,164503,164582,0.04800038886390979
249.0,ES543L1,Eivissa,2001,2143,57259,59402,3.607622638968385
250.0,ES544L1,Linares,2001,13,25763,25776,0.05043451272501552
251.0,ES545L1,Lorca,2001,114,182093,182207,0.06256620217664526
252.0,ES546L1,MÃ©rida,2001,948,127351,128299,0.7388989781681853
253.0,ES547L1,Sagunto,2001,274,15254,15528,1.764554353426069
254.0,ES550L1,Puerto de la Cruz,2001,27472,0,27472,100.0
255.0,ES552L1,Igualada,2001,2,25424,25426,0.007865963973884999
256.0,FI001L3,Helsinki,2001,21001,470517,491518,4.272681773607477
257.0,FI002L3,Tampere,2001,98336,590307,688643,14.279677568783825
258.0,FI003L4,Turku,2001,19565,446879,466444,4.1945013763710115
259.0,FI004L4,Oulu,2001,418701,305120,723821,57.84593152174363
260.0,FI007L2,Lahti,2001,35716,299687,335403,10.648682331404311
261.0,FI008L2,Kuopio,2001,153504,766902,920406,16.677857380329986
262.0,FI009L2,JyvÃ¤skylÃ¤,2001,84356,392586,476942,17.686846618666422
263.0,FR001L1,Paris,2001,43889,1166063,1209952,3.6273339768850335
264.0,FR003L2,Lyon,2001,1697,365534,367231,0.46210695720132555
265.0,FR004L2,Toulouse,2001,514,524158,524672,0.09796596730909977
266.0,FR006L2,Strasbourg,2001,1309,202574,203883,0.6420348925609295
267.0,FR007L2,Bordeaux,2001,4778,550976,555754,0.8597329034069031
268.0,FR008L2,Nantes,2001,2709,313910,316619,0.8556024748988531
269.0,FR009L2,Lille,2001,13714,130739,144453,9.493745370466518
270.0,FR010L2,Montpellier,2001,7286,216632,223918,3.253869720165418
271.0,FR011L2,Saint-Etienne,2001,4725,176330,181055,2.6097042335202008
272.0,FR012L2,Le Havre,2001,1085,75353,76438,1.4194510583741071
273.0,FR013L2,Rennes,2001,294,381843,382137,0.07693575864153432
274.0,FR014L2,Amiens,2001,6823,237972,244795,2.7872301313343817
275.0,FR016L2,Nancy,2001,39231,244278,283509,13.83765594743024
276.0,FR017L2,Metz,2001,36197,140733,176930,20.458373367998643
277.0,FR018L2,Reims,2001,23,243128,243151,0.009459142672660199
278.0,FR019L2,OrlÃ©ans,2001,6328,285639,291967,2.167368229971195
279.0,FR020L2,Dijon,2001,78640,307121,385761,20.385679215887556
280.0,FR021L2,Poitiers,2001,59,250383,250442,0.023558348839252202
281.0,FR022L2,Clermont-Ferrand,2001,33,266093,266126,0.012400141286458293
282.0,FR023L2,Caen,2001,386,225887,226273,0.17059039302082
283.0,FR024L2,Limoges,2001,20275,297559,317834,6.379116142388794
284.0,FR025L2,BesanÃ§on,2001,1411,237625,239036,0.5902876554159207
285.0,FR026L2,Grenoble,2001,7771,258077,265848,2.9230989136649512
286.0,FR027L2,Ajaccio,2001,5159,141850,147009,3.5093089538735724
289.0,FR032L2,Toulon,2001,2211,104845,107056,2.065274248991182
290.0,FR034L2,Valenciennes,2001,80,78366,78446,0.10198098054712795
291.0,FR035L2,Tours,2001,628,284220,284848,0.22046846037184742
292.0,FR036L2,Angers,2001,877,230374,231251,0.3792416032795534
293.0,FR037L2,Brest,2001,2482,132512,134994,1.8386002340844778
294.0,FR038L2,Le Mans,2001,38,224073,224111,0.016955883468459824
295.0,FR039L1,Avignon,2001,1541,85684,87225,1.766695328174262
296.0,FR040L2,Mulhouse,2001,48,129718,129766,0.03698965830803138
297.0,FR042L2,Dunkerque,2001,725,90400,91125,0.7956104252400549
298.0,FR043L2,Perpignan,2001,1567,181463,183030,0.8561438015625854
299.0,FR044L2,NÃ®mes,2001,1369,149122,150491,0.9096889514987607
300.0,FR045L2,Pau,2001,23,201736,201759,0.011399739292918779
301.0,FR046L2,Bayonne,2001,887,101743,102630,0.8642697067134365
302.0,FR047L0,Annemasse,2001,0,7800,7800,0.0
303.0,FR048L2,Annecy,2001,2210,116833,119043,1.8564720311148073
304.0,FR049L2,Lorient,2001,781,112401,113182,0.690039052146101
305.0,FR050L2,MontbÃ©liard,2001,22,123035,123057,0.017877893984088674
306.0,FR051L2,Troyes,2001,2107,258843,260950,0.8074343744012262
307.0,FR052L2,Saint-Nazaire,2001,493,106642,107135,0.4601670789191208
308.0,FR053L2,La Rochelle,2001,359,110981,111340,0.32243578228848574
309.0,FR056L2,AngoulÃªme,2001,14,214278,214292,0.006533141694510294
310.0,FR057L2,Boulogne-sur-Mer,2001,358,68180,68538,0.5223379730952172
311.0,FR058L2,ChambÃ©ry,2001,2825,98864,101689,2.7780782582186867
312.0,FR059L2,Chalon-sur-SaÃ´ne,2001,577,155781,156358,0.36902492996840586
313.0,FR060L2,Chartres,2001,11,161349,161360,0.0068170550322260775
314.0,FR061L2,Niort,2001,3,178916,178919,0.0016767364002705134
315.0,FR062L2,Calais,2001,127,50103,50230,0.2528369500298626
316.0,FR063L2,BÃ©ziers,2001,461,84682,85143,0.541442044560328
317.0,FR064L2,Arras,2001,9281,98282,107563,8.628431709788682
318.0,FR065L2,Bourges,2001,200,250119,250319,0.07989805008808759
319.0,FR066L2,Saint-Brieuc,2001,5566,109615,115181,4.832394231687518
320.0,FR067L2,Quimper,2001,6763,115159,121922,5.546989058578435
321.0,FR068L2,Vannes,2001,647,120387,121034,0.5345605367086934
322.0,FR069L2,Cherbourg,2001,499,90219,90718,0.5500562181705946
323.0,FR073L2,Tarbes,2001,104,104225,104329,0.09968465143919715
324.0,FR074L2,CompiÃ¨gne,2001,2096,96641,98737,2.122811104246635
325.0,FR076L2,Belfort,2001,42,65577,65619,0.0640058519636081
326.0,FR077L2,Roanne,2001,68,123132,123200,0.0551948051948052
327.0,FR079L2,Saint-Quentin,2001,21,99353,99374,0.021132288123654076
328.0,FR082L2,Beauvais,2001,202,130940,131142,0.15403150783120587
329.0,FR084L2,Creil,2001,8938,20705,29643,30.152143845089903
330.0,FR086L2,Evreux,2001,12,126558,126570,0.009480919649205973
331.0,FR090L2,ChÃ¢teauroux,2001,3353,257824,261177,1.283803704001501
332.0,FR093L2,Brive-la-Gaillarde,2001,0,132582,132582,0.0
333.0,FR096L2,Albi,2001,73,134165,134238,0.05438102474709099
334.0,FR099L2,FrÃ©jus,2001,443,43970,44413,0.9974556999076847
335.0,FR104L2,ChÃ¢lons-en-Champagne,2001,54,152755,152809,0.03533823269571818
336.0,FR203L2,Marseille,2001,3001,422775,425776,0.7048307091052572
337.0,FR205L2,Nice,2001,1612,305728,307340,0.5245005531333378
338.0,FR207L2,Lens - LiÃ©vin,2001,1829,23479,25308,7.226963805911174
339.0,FR208L1,HÃ©nin - Carvin,2001,2026,9572,11598,17.46852905673392
340.0,FR209L2,Douai,2001,4879,40205,45084,10.822021116138764
341.0,FR214L1,Valence,2001,642,90319,90961,0.7057969899187564
342.0,FR215L2,Rouen,2001,527,286599,287126,0.18354311347631352
343.0,FR304L1,Melun,2001,25,44811,44836,0.05575876527790168
344.0,FR324L1,Martigues,2001,1767,18689,20456,8.6380524051623
345.0,FR505L1,Charleville-MÃ©ziÃ¨res,2001,52,135317,135369,0.03841352155958897
346.0,FR506L1,Colmar,2001,238,101747,101985,0.23336765210570182
347.0,FR519L1,Cannes,2001,508,19628,20136,2.522844656336909
348.0,HR001L2,Grad Zagreb,2001,34,505834,505868,0.00672112092482624
349.0,HR002L2,Rijeka,2001,426,106808,107234,0.3972620624055803
350.0,HR003L2,Slavonski Brod,2001,32,97798,97830,0.032709802719002354
351.0,HR004L2,Osijek,2001,1256,171678,172934,0.7262886419096303
352.0,HR005L2,Split,2001,2887,336183,339070,0.851446603946088
353.0,HR006L1,Pula - Pola,2001,1322,57575,58897,2.244596498972783
354.0,HR007L1,Zadar,2001,2581,153919,156500,1.6492012779552714
355.0,HU001L2,Budapest,2001,6279,632855,639134,0.9824230912453413
356.0,HU002L2,Miskolc,2001,64,164605,164669,0.03886584603052184
357.0,HU003L2,NyÃ­regyhÃ¡za,2001,118,168107,168225,0.0701441521771437
358.0,HU004L2,PÃ©cs,2001,1452,184036,185488,0.7827999654964203
359.0,HU005L2,Debrecen,2001,297,201281,201578,0.14733750706922383
360.0,HU006L2,Szeged,2001,547,160386,160933,0.3398929989498735
361.0,HU007L2,GyÃµr,2001,683,203957,204640,0.33375684128225175
362.0,HU008L2,KecskemÃ©t,2001,53,182086,182139,0.02909865542250699
363.0,HU009L2,SzÃ©kesfehÃ©rvÃ¡r,2001,1231,299892,301123,0.4088030472597577
364.0,HU010L1,Szombathely,2001,21,134256,134277,0.015639312763913404
365.0,HU011L1,Szolnok,2001,606,143369,143975,0.42090640736238927
366.0,HU012L1,TatabÃ¡nya,2001,319,69511,69830,0.4568237147357869
367.0,HU013L1,VeszprÃ©m,2001,7182,124138,131320,5.46908315565032
368.0,HU014L1,BÃ©kÃ©scsaba,2001,13,106150,106163,0.0122453208745043
369.0,HU015L1,KaposvÃ¡r,2001,73,145487,145560,0.050151140423193186
370.0,HU016L1,Eger,2001,16,100562,100578,0.01590805146254648
371.0,HU017L1,DunaÃºjvÃ¡ros,2001,750,60920,61670,1.2161504783525214
372.0,HU018L1,Zalaegerszeg,2001,188,139791,139979,0.134305860164739
373.0,HU019L1,Sopron,2001,270,80400,80670,0.334696913350688
374.0,IE001L1,Dublin,2001,153162,550440,703602,21.768272404001127
375.0,IE002L1,Cork,2001,2288,327375,329663,0.6940420975359686
376.0,IE003L1,Limerick,2001,141,156317,156458,0.0901200322131179
377.0,IE004L1,Galway,2001,7541,218742,226283,3.3325526000627534
378.0,IE005L1,Waterford,2001,2388,93469,95857,2.4912108661860897
379.0,IS001L1,ReykjavÃ­k,2001,1297230,0,1297230,100.0
380.0,IT001L3,Roma,2001,8954,608262,617216,1.4507076939029449
381.0,IT002L3,Milano,2001,43,384002,384045,0.011196604564569257
382.0,IT003L3,Napoli,2001,3038,149904,152942,1.9863739195250487
383.0,IT004L2,Torino,2001,122,170057,170179,0.07168922134928517
384.0,IT005L3,Palermo,2001,1482,148591,150073,0.9875194072218186
385.0,IT006L3,Genova,2001,824,119940,120764,0.6823225464542414
386.0,IT007L3,Firenze,2001,136,163635,163771,0.08304278535271813
387.0,IT008L3,Bari,2001,780,112649,113429,0.6876548325384161
388.0,IT009L1,Bologna,2001,100,185157,185257,0.05397906691784926
389.0,IT010L2,Catania,2001,770,60655,61425,1.2535612535612535
390.0,IT011L2,Venezia,2001,1853,65184,67037,2.7641451735608693
391.0,IT012L3,Verona,2001,95,73066,73161,0.129850603463594
392.0,IT013L3,Cremona,2001,398,59999,60397,0.6589731278043611
393.0,IT014L3,Trento,2001,826,97361,98187,0.8412518968906271
394.0,IT015L1,Trieste,2001,356,21281,21637,1.6453297592087628
395.0,IT016L3,Perugia,2001,5792,125236,131028,4.420429221235156
396.0,IT017L3,Ancona,2001,627,43616,44243,1.4171733381551885
397.0,IT019L2,Pescara,2001,281,16162,16443,1.7089338928419389
398.0,IT020L3,Campobasso,2001,279,102556,102835,0.2713084066708805
399.0,IT021L2,Caserta,2001,1,9341,9342,0.010704345964461572
400.0,IT022L2,Taranto,2001,3525,103403,106928,3.2966108035313484
401.0,IT023L2,Potenza,2001,123,138332,138455,0.08883752843884295
402.0,IT024L3,Catanzaro,2001,280,89803,90083,0.31082446188515034
403.0,IT025L3,Reggio di Calabria,2001,615,47633,48248,1.2746642347869341
404.0,IT026L3,Sassari,2001,2403,150822,153225,1.568281938325991
405.0,IT027L2,Cagliari,2001,4908,190384,195292,2.51315978125064
406.0,IT028L3,Padova,2001,17,61428,61445,0.027667019285539916
407.0,IT029L3,Brescia,2001,169,60100,60269,0.2804094974199008
408.0,IT030L3,Modena,2001,125,69143,69268,0.1804585089796154
409.0,IT031L3,Foggia,2001,8,89703,89711,0.008917524049447671
410.0,IT032L3,Salerno,2001,357,37482,37839,0.9434710219614683
411.0,IT033L2,Piacenza,2001,244,93883,94127,0.2592242395911906
412.0,IT034L1,Bolzano,2001,2056,104700,106756,1.9258870695792276
413.0,IT035L2,Udine,2001,1,71829,71830,0.0013921759710427398
414.0,IT036L2,La Spezia,2001,738,42181,42919,1.719518162119341
415.0,IT037L1,Lecce,2001,322,61188,61510,0.5234921151032352
416.0,IT038L1,Barletta,2001,242,14855,15097,1.6029674769821818
417.0,IT039L2,Pesaro,2001,101,25590,25691,0.3931337822583784
418.0,IT040L2,Como,2001,105,19636,19741,0.5318879489387569
419.0,IT041L2,Pisa,2001,509,47544,48053,1.0592470813476786
420.0,IT042L1,Treviso,2001,45,24000,24045,0.18714909544603867
421.0,IT043L2,Varese,2001,469,23195,23664,1.981913455037187
422.0,IT045L2,Asti,2001,1,54835,54836,0.0018236195200233424
423.0,IT046L2,Pavia,2001,63,36141,36204,0.17401392111368907
424.0,IT047L1,Massa,2001,354,10889,11243,3.1486258116161165
425.0,IT048L2,Cosenza,2001,91,92388,92479,0.09840071800084345
426.0,IT052L1,Savona,2001,236,28469,28705,0.8221564187423794
427.0,IT054L1,Matera,2001,586,77203,77789,0.7533198781318695
428.0,IT056L1,Acireale,2001,52,5936,5988,0.8684034736138945
429.0,IT057L2,Avellino,2001,16,39743,39759,0.04024246082647954
430.0,IT058L2,Pordenone,2001,37,37013,37050,0.09986504723346828
431.0,IT060L1,Lecco,2001,1318,28894,30212,4.362504964914604
432.0,IT061L0,Altamura,2001,0,42800,42800,0.0
433.0,IT064L1,Battipaglia,2001,53,6433,6486,0.8171446191797719
434.0,IT065L0,Bisceglie,2001,92,6852,6944,1.3248847926267282
435.0,IT066L1,Carpi,2001,3,20619,20622,0.014547570555717195
436.0,IT067L0,Cerignola,2001,127,58770,58897,0.21563067728407218
437.0,IT068L1,Gallarate,2001,0,5319,5319,0.0
438.0,IT069L1,Gela,2001,413,57482,57895,0.7133603938163918
439.0,IT073L1,Sassuolo,2001,1,24061,24062,0.004155930512841825
440.0,IT501L2,Messina,2001,792,33651,34443,2.29945126731121
441.0,IT502L2,Prato,2001,9,40950,40959,0.021973192704900023
442.0,IT503L3,Parma,2001,172,113335,113507,0.15153250460324033
443.0,IT504L3,Livorno,2001,444,25370,25814,1.7199969009064848
444.0,IT505L3,Reggio nell'Emilia,2001,20,69014,69034,0.028971231567053914
445.0,IT506L2,Ravenna,2001,3265,77924,81189,4.021480742465113
446.0,IT507L2,Ferrara,2001,361,91122,91483,0.39460883442825445
447.0,IT508L3,Rimini,2001,197,32382,32579,0.6046839988949937
448.0,IT509L3,Siracusa,2001,552,33590,34142,1.6167769902173275
449.0,IT511L2,Bergamo,2001,1,18555,18556,0.0053890924768269025
450.0,IT512L3,ForlÃ¬,2001,3,72748,72751,0.004123654657667936
451.0,IT513L3,Latina,2001,528,65965,66493,0.7940685485690223
452.0,IT514L2,Vicenza,2001,4,34978,34982,0.011434452003887714
453.0,IT515L2,Terni,2001,136,102196,102332,0.13290075440722354
454.0,IT516L2,Novara,2001,0,54165,54165,0.0
455.0,IT518L1,Alessandria,2001,8,76906,76914,0.01040122734482669
456.0,IT519L1,Arezzo,2001,23,88604,88627,0.02595145948751509
457.0,IT520L1,Grosseto,2001,391,119208,119599,0.32692581041647506
458.0,IT521L1,Brindisi,2001,891,63096,63987,1.3924703455389376
459.0,IT522L1,Trapani,2001,918,49872,50790,1.8074424099232131
460.0,IT523L1,Ragusa,2001,289,52561,52850,0.5468306527909177
461.0,IT524L0,Andria,2001,0,39880,39880,0.0
462.0,IT525L0,Trani,2001,123,10256,10379,1.1850852683302822
463.0,IT526L1,L'Aquila,2001,815,139454,140269,0.5810264563089492
464.0,LT001L1,Vilnius,2001,4557,420012,424569,1.073323770694516
465.0,LT002L1,Kaunas,2001,1043,161008,162051,0.6436245379541009
466.0,LT003L1,PanevÄÅ¾ys,2001,8713,214095,222808,3.910541811784137
467.0,LT004L0,Alytus,2001,13,3946,3959,0.3283657489264966
468.0,LT501L0,KlaipÄda,2001,116,8807,8923,1.3000112069931637
469.0,LT502L0,Å iauliai,2001,7389,656,8045,91.84586699813548
470.0,LU001L1,Luxembourg,2001,15667,244048,259715,6.0323816491153766
471.0,LV001L1,RÄ«ga,2001,17427,598822,616249,2.8279153394163723
472.0,LV002L2,LiepÄja,2001,3829,268228,272057,1.4074256497719226
473.0,LV003L1,Jelgava,2001,6624,159835,166459,3.9793582804174
474.0,LV501L1,Daugavpils,2001,926,258749,259675,0.35659959564840665
475.0,ME001L1,Podgorica,2001,1104,183377,184481,0.5984356112553596
476.0,MK001L1,Skopje,2001,2,224351,224353,0.0008914523095300709
477.0,MK003L1,Bitola,2001,25,119637,119662,0.020892179639317412
478.0,MK004L1,Tetovo,2001,2,105619,105621,0.0018935628331487107
479.0,MK005L1,Prilep,2001,31,86800,86831,0.03570153516601214
480.0,MT001L1,Valletta,2001,1074,24882,25956,4.137771613499769
481.0,NL001L3,s' Gravenhage,2001,2074,40633,42707,4.856346734727328
482.0,NL002L3,Amsterdam,2001,69299,263658,332957,20.81319810065564
483.0,NL003L3,Rotterdam,2001,31664,185507,217171,14.580215590479392
484.0,NL004L3,Utrecht,2001,583,96704,97287,0.5992578659019191
485.0,NL005L3,Eindhoven,2001,83,144323,144406,0.05747683614254255
486.0,NL006L3,Tilburg,2001,30,43204,43234,0.06938983207660637
487.0,NL007L3,Groningen,2001,1407,206753,208160,0.6759223674096848
488.0,NL008L3,Enschede,2001,11793,73163,84956,13.881303262865483
489.0,NL009L3,Arnhem,2001,715,55183,55898,1.279115531861605
490.0,NL010L3,Heerlen,2001,630,32713,33343,1.889452058902918
491.0,NL012L3,Breda,2001,1312,72058,73370,1.7881968106855666
492.0,NL013L3,Nijmegen,2001,629,39207,39836,1.5789737925494527
493.0,NL014L3,Apeldoorn,2001,109,71015,71124,0.15325347280805354
494.0,NL015L3,Leeuwarden,2001,357,110566,110923,0.32184488338757516
495.0,NL016L3,Sittard-Geleen,2001,71,22841,22912,0.30988128491620115
496.0,NL020L3,Roosendaal,2001,36,24538,24574,0.14649629689916172
497.0,NL026L0,Alphen aan den Rijn,2001,10,13200,13210,0.0757002271006813
498.0,NL028L3,Bergen op Zoom,2001,2045,32736,34781,5.879646933670682
499.0,NL030L0,Gouda,2001,6,1782,1788,0.33557046979865773
500.0,NL032L3,MiddelburgÂ Â Â Â Â Â ,2001,1081,22307,23388,4.622028390627672
501.0,NL503L3,s-Hertogenbosch,2001,138,36721,36859,0.37439973954800726
502.0,NL504L3,Amersfoort,2001,1,12243,12244,0.008167265599477294
503.0,NL505L3,Maastricht,2001,45,20340,20385,0.22075055187637968
504.0,NL507L3,Leiden,2001,127,19654,19781,0.6420302310297761
505.0,NL511L3,Zwolle,2001,1660,121360,123020,1.3493740855145506
506.0,NL512L3,Ede,2001,26,35239,35265,0.0737274918474408
507.0,NL513L3,Deventer,2001,116,25129,25245,0.45949693008516534
508.0,NL514L3,Alkmaar,2001,230,47562,47792,0.48125209240040173
509.0,NL515L3,Venlo,2001,463,50773,51236,0.9036614880162386
510.0,NL519L3,Almelo,2001,4,42021,42025,0.009518143961927425
511.0,NL520L3,Lelystad,2001,59361,59481,118842,49.94951279850558
512.0,NL521L3,Oss,2001,124,33022,33146,0.37410245580160506
513.0,NL522L3,Assen,2001,51,70811,70862,0.07197087296435326
514.0,NL524L3,Veenendaal,2001,19,8166,8185,0.23213194868662188
515.0,NL529L3,Soest,2001,11,7931,7942,0.13850415512465375
516.0,NO001L1,Oslo,2001,25238,721405,746643,3.3801964258688555
517.0,NO002L1,Bergen,2001,19157,338586,357743,5.354961522657327
518.0,NO003L1,Trondheim,2001,30594,642662,673256,4.544185272764
519.0,NO004L1,Stavanger,2001,41633,247444,289077,14.402045129844298
520.0,NO005L1,Kristiansand,2001,5419,310043,315462,1.7177980232167422
521.0,NO006L1,TromsÃ¸,2001,374613,0,374613,100.0
522.0,PL001L2,Warszawa,2001,1926,859317,861243,0.22363026462914648
523.0,PL002L2,ÅÃ³dÅº,2001,88,169412,169500,0.05191740412979351
524.0,PL003L2,KrakÃ³w,2001,1299,374449,375748,0.34571042294303633
525.0,PL004L2,WrocÅaw,2001,695,264005,264700,0.2625613902531167
526.0,PL005L2,PoznaÅ,2001,2453,306875,309328,0.7930093622303833
527.0,PL006L2,GdaÅsk,2001,8383,255133,263516,3.1812110080602314
528.0,PL007L2,Szczecin,2001,6279,106781,113060,5.553688307093578
529.0,PL008L2,Bydgoszcz,2001,6264,203872,210136,2.9809266379868276
530.0,PL009L2,Lublin,2001,222,322562,322784,0.06877664320412412
531.0,PL010L2,Katowice,2001,2909,391686,394595,0.7372115713579745
532.0,PL011L2,BiaÅystok,2001,6,223316,223322,0.002686703504356937
533.0,PL012L2,Kielce,2001,4,224225,224229,0.0017838905761520588
534.0,PL013L2,ToruÅ,2001,1338,157595,158933,0.8418641817621262
535.0,PL014L2,Olsztyn,2001,5938,196606,202544,2.931708665771388
536.0,PL015L2,RzeszÃ³w,2001,33,229316,229349,0.014388551944852605
537.0,PL016L2,Opole,2001,231,176385,176616,0.13079222720478326
538.0,PL017L2,GorzÃ³w Wielkopolski,2001,3628,93792,97420,3.724081297474851
539.0,PL018L2,Zielona GÃ³ra,2001,278,169006,169284,0.16422107228090074
540.0,PL019L2,Jelenia GÃ³ra,2001,274,83067,83341,0.3287697531827072
541.0,PL020L2,Nowy SÄcz,2001,115,130303,130418,0.08817801223757457
542.0,PL021L2,SuwaÅki,2001,2226,69907,72133,3.085966201322557
543.0,PL022L2,Konin,2001,329,117834,118163,0.2784289498404746
544.0,PL024L2,CzÄstochowa,2001,27,193871,193898,0.013924847084549608
545.0,PL025L2,Radom,2001,0,68022,68022,0.0
546.0,PL026L2,PÅock,2001,3199,167876,171075,1.869940084758147
547.0,PL027L2,Kalisz,2001,75,148948,149023,0.050327801748723346
548.0,PL028L2,Koszalin,2001,432,129239,129671,0.3331508201525399
549.0,PL029L1,SÅupsk,2001,7923,227081,235004,3.371431975625947
550.0,PL030L1,JastrzÄbie-ZdrÃ³j,2001,87,29484,29571,0.2942071624226438
551.0,PL031L1,Siedlce,2001,179,125990,126169,0.14187320181661106
552.0,PL032L1,PiotrkÃ³w Trybunalski,2001,178,116744,116922,0.15223824429961855
553.0,PL033L1,Lubin,2001,421,92885,93306,0.4512035667588365
554.0,PL034L1,PiÅa,2001,1741,50451,52192,3.3357602697731457
555.0,PL035L1,InowrocÅaw,2001,18,20110,20128,0.08942766295707473
556.0,PL036L1,Ostrowiec ÅwiÄtokrzyski,2001,0,61460,61460,0.0
557.0,PL037L1,Gniezno,2001,639,65932,66571,0.9598774241035887
558.0,PL038L1,Stargard SzczeciÅski,2001,5417,31247,36664,14.774710888064588
559.0,PL039L1,OstrÃ³w Wielkopolski,2001,57,84704,84761,0.06724790882599309
560.0,PL040L1,PrzemyÅl,2001,347,84742,85089,0.40780829484422193
561.0,PL041L1,ZamoÅÄ,2001,5016,107691,112707,4.450477787537597
562.0,PL042L1,CheÅm,2001,608,45962,46570,1.3055615202920334
563.0,PL043L1,Pabianice,2001,15,32944,32959,0.04551108953548348
564.0,PL044L1,GÅogÃ³w,2001,231,63850,64081,0.36048126589784807
565.0,PL045L1,Stalowa Wola,2001,108,190205,190313,0.056748619379653524
566.0,PL046L1,TomaszÃ³w Mazowiecki,2001,676,18487,19163,3.527631372958305
567.0,PL047L1,ÅomÅ¼a,2001,3,55999,56002,0.0053569515374450915
568.0,PL048L1,Leszno,2001,421,77151,77572,0.5427216005775279
569.0,PL049L1,Åwidnica,2001,3,47987,47990,0.0062513023546572205
570.0,PL051L1,Tczew,2001,101,27023,27124,0.37236395811827167
571.0,PL052L1,EÅk,2001,1641,38411,40052,4.09717367422351
572.0,PL506L2,Bielsko-BiaÅa,2001,375,73060,73435,0.5106556818955539
573.0,PL508L1,Rybnik,2001,427,14454,14881,2.869430817821383
574.0,PL511L2,WaÅbrzych,2001,24,51486,51510,0.046592894583576
575.0,PL512L2,ElblÄg,2001,64,96411,96475,0.06633842964498575
576.0,PL513L2,WÅocÅawek,2001,3094,119385,122479,2.526147339543922
577.0,PL514L2,TarnÃ³w,2001,6,125321,125327,0.004787475962881103
578.0,PL516L2,Legnica,2001,56,56444,56500,0.09911504424778761
579.0,PL517L2,GrudziÄdz,2001,106,54937,55043,0.19257671275184854
580.0,PT001L3,Lisboa,2001,7552,431729,439281,1.7191729212053333
581.0,PT002L2,Porto,2001,1188,94552,95740,1.2408606642991435
582.0,PT003L1,Braga,2001,59,49290,49349,0.11955662728728039
583.0,PT004L2,Funchal,2001,35962,0,35962,100.0
584.0,PT005L2,Coimbra,2001,422,162365,162787,0.25923445975415726
585.0,PT007L1,Ponta Delgada,2001,55294,0,55294,100.0
586.0,PT008L2,Aveiro,2001,1758,41572,43330,4.057235171936303
587.0,PT009L1,Faro,2001,2549,46601,49150,5.186164801627671
588.0,PT014L1,Viseu,2001,6,70868,70874,0.008465727911504925
589.0,PT016L0,Viana do Castelo,2001,361,31891,32252,1.1193104303609078
590.0,PT019L0,PÃ³voa de Varzim,2001,40,8366,8406,0.4758505829169641
591.0,PT505L1,GuimarÃ£es,2001,0,26541,26541,0.0
592.0,RO001L1,BucureÅti,2001,249,107593,107842,0.23089334396617273
593.0,RO002L1,Cluj-Napoca,2001,0,59302,59302,0.0
594.0,RO003L1,TimiÅoara,2001,40,23614,23654,0.1691045911896508
595.0,RO004L1,Craiova,2001,82,34314,34396,0.23839981393185256
596.0,RO005L1,BrÄila,2001,1242,22287,23529,5.278592375366569
597.0,RO006L1,Oradea,2001,3,20336,20339,0.014749987708343577
598.0,RO007L1,BacÄu,2001,58,22035,22093,0.26252659213325485
599.0,RO008L1,Arad,2001,16,51592,51608,0.031002945279801578
600.0,RO009L1,Sibiu,2001,2,56338,56340,0.003549875754348598
601.0,RO010L1,TÃ¢rgu MureÅ,2001,36,13704,13740,0.26200873362445415
602.0,RO011L1,Piatra NeamÅ£,2001,25,14974,14999,0.1666777785185679
603.0,RO012L1,CÇlÇraÅi,2001,566,23978,24544,2.30606258148631
604.0,RO013L1,Giurgiu,2001,551,10399,10950,5.031963470319635
605.0,RO014L1,Alba Iulia,2001,2,26000,26002,0.007691716021844474
606.0,RO015L1,FocÅani,2001,91,27011,27102,0.33576857796472587
607.0,RO016L1,TÃ¢rgu Jiu,2001,16,24506,24522,0.06524753282766496
608.0,RO017L1,Tulcea,2001,1554,39393,40947,3.795149827826214
609.0,RO018L1,TÃ¢rgoviÅte,2001,2,20255,20257,0.009873130275953991
610.0,RO019L1,Slatina,2001,104,7019,7123,1.4600589639196966
611.0,RO020L1,BÃ¢rlad,2001,3737,22582,26319,14.198867738135949
612.0,RO021L1,Roman,2001,14,14376,14390,0.09728978457261987
613.0,RO022L1,BistriÅ£a,2001,6,42625,42631,0.014074265206070698
614.0,RO501L1,Constanta,2001,6359,52992,59351,10.714225539586527
615.0,RO502L1,Iasi,2001,234,79702,79936,0.2927341873498799
616.0,RO503L1,Galati,2001,937,40295,41232,2.2725067908420646
617.0,RO504L1,Brasov,2001,4107,94396,98503,4.1694161599139115
618.0,RO505L1,Ploiesti,2001,0,34337,34337,0.0
619.0,RO506L1,Pitesti,2001,49,24835,24884,0.19691367947275357
620.0,RO507L1,Baia Mare,2001,28,52513,52541,0.05329171504158657
621.0,RO508L1,Buzau,2001,20,38520,38540,0.05189413596263622
622.0,RO509L1,Satu Mare,2001,1,70843,70844,0.0014115521427361527
623.0,RO510L1,Botosani,2001,79,37261,37340,0.21156936261381895
624.0,RO511L1,Ramnicu Valcea,2001,445,28728,29173,1.5253830596784697
625.0,RO512L1,Suceava,2001,105,39573,39678,0.26463027370331166
626.0,RO513L1,Drobeta-Turnu Severin,2001,2315,30619,32934,7.029209935021559
627.0,RS001L1,Beograd,2001,5766,307258,313024,1.842031281946432
628.0,RS002L1,Novi Sad,2001,2093,187350,189443,1.104817807995017
629.0,RS003L1,NiÅ¡,2001,40,341524,341564,0.01171083603658465
630.0,RS004L1,Kragujevac,2001,21,144054,144075,0.014575741801145238
631.0,RS005L1,Subotica,2001,157,160135,160292,0.09794624809722258
632.0,RS006L1,Novi Pazar,2001,0,140791,140791,0.0
633.0,RS008L1,Zrenjanin,2001,763,184368,185131,0.4121405923373179
634.0,RS009L1,Kraljevo,2001,2,176510,176512,0.0011330674401740391
635.0,RS011L0,ÄaÄak,2001,1,63686,63687,0.0015701791574418641
636.0,RS012L1,KruÅ¡evac,2001,1,122648,122649,0.0008153348172427007
637.0,RS013L1,Leskovac,2001,3,166279,166282,0.0018041640105363177
638.0,RS014L1,Valjevo,2001,2,141660,141662,0.0014118112126046505
639.0,RS015L1,Vranje,2001,3,195353,195356,0.001535657978255083
640.0,RS016L1,Smederevo,2001,1347,158877,160224,0.8406980227681247
641.0,SE001L1,Stockholm,2001,79284,676442,755726,10.491103918616005
642.0,SE002L1,GÃ¶teborg,2001,28018,407241,435259,6.437086883901309
643.0,SE003L1,MalmÃ¶,2001,3932,184084,188016,2.0913113777550847
644.0,SE004L1,JÃ¶nkÃ¶ping,2001,170461,176730,347191,49.09718281867906
645.0,SE005L1,UmeÃ¥,2001,154651,833598,988249,15.648991296727848
646.0,SE006L1,Uppsala,2001,15804,681723,697527,2.265718746371108
647.0,SE007L1,LinkÃ¶ping,2001,25109,398087,423196,5.933184623673192
648.0,SE008L1,Ãrebro,2001,30335,338262,368597,8.22985537049949
649.0,SE501L1,VÃ¤sterÃ¥s,2001,16375,274040,290415,5.638482860733777
650.0,SE502L1,NorrkÃ¶ping,2001,18711,293027,311738,6.00215565635245
651.0,SE503L1,Helsingborg,2001,908,113514,114422,0.7935536872279806
652.0,SE505L1,BorÃ¥s,2001,52805,44557,97362,54.2357387892607
653.0,SI001L2,Ljubljana,2001,430,232857,233287,0.18432231543120706
654.0,SI002L1,Maribor,2001,419,216566,216985,0.1931009055925525
655.0,SK001L1,Bratislava,2001,1579,203362,204941,0.7704656462103727
656.0,SK002L1,KoÅ¡ice,2001,35,177599,177634,0.019703435153180134
657.0,SK003L1,BanskÃ¡ Bystrica,2001,3238,77642,80880,4.003461918892186
658.0,SK004L1,Nitra,2001,6,87121,87127,0.0068864990186738905
659.0,SK005L1,PreÅ¡ov,2001,0,93299,93299,0.0
660.0,SK006L1,Å½ilina,2001,307,81141,81448,0.3769276102543955
661.0,SK007L1,Trnava,2001,19,74201,74220,0.025599568849366747
662.0,SK008L1,TrenÄÃ­n,2001,1,67422,67423,0.001483173397801937
739.0,UK001L3,London,2001,21032,677138,698170,3.012446825271782
740.0,UK002L3,West Midlands urban area,2001,2636,212673,215309,1.2242869550274256
741.0,UK003L2,Leeds,2001,36720,475707,512427,7.165898752407659
742.0,UK004L1,Glasgow,2001,80812,256872,337684,23.93124933369659
743.0,UK006L3,Liverpool,2001,835,99668,100503,0.830820970518293
744.0,UK007L1,Edinburgh,2001,28242,147176,175418,16.099830120056094
745.0,UK008L3,Greater Manchester,2001,17872,294374,312246,5.723692217034005
746.0,UK009L1,Cardiff,2001,12852,71639,84491,15.211087571457316
747.0,UK010L3,Sheffield,2001,1645,124442,126087,1.3046547225328542
748.0,UK011L2,Bristol,2001,2346,96039,98385,2.384509833816131
749.0,UK012L2,Belfast,2001,33344,161801,195145,17.086781623920675
750.0,UK013L2,Newcastle upon Tyne,2001,21107,525601,546708,3.8607446754025916
751.0,UK014L1,Leicester,2001,381,139400,139781,0.2725692333006632
752.0,UK016L1,Aberdeen,2001,62978,590970,653948,9.630429330772477
753.0,UK017L2,Cambridge,2001,51,159568,159619,0.03195108351762635
754.0,UK018L3,Exeter,2001,42145,205581,247726,17.01274795540234
755.0,UK019L3,Lincoln,2001,13663,197880,211543,6.458734158067155
756.0,UK023L1,Portsmouth,2001,412,20441,20853,1.9757349062485015
757.0,UK024L1,Worcester,2001,2864,58338,61202,4.67958563445639
758.0,UK025L3,Coventry,2001,220,81227,81447,0.2701143074637494
759.0,UK026L1,Kingston upon Hull,2001,6245,245453,251698,2.4811480424953714
760.0,UK027L1,Stoke-on-Trent,2001,2979,85197,88176,3.3784703320631464
761.0,UK029L1,Nottingham,2001,64,90225,90289,0.07088349632845639
762.0,UK033L1,Guildford,2001,27,61664,61691,0.04376651375403219
763.0,UK050L1,Burnley,2001,651,27323,27974,2.3271609351540716
764.0,UK056L1,Hastings,2001,141,54609,54750,0.25753424657534246
765.0,UK515L1,Brighton and Hove,2001,13591,28816,42407,32.04895418209258
766.0,UK516L1,Plymouth,2001,1158,214617,215775,0.5366701425095586
767.0,UK517L1,Swansea,2001,5942,78100,84042,7.070274386616216
768.0,UK518L1,Derby,2001,456,67646,68102,0.6695838595048603
769.0,UK520L2,Southampton,2001,4472,148880,153352,2.9161667275288226
770.0,UK528L1,Northampton,2001,252,154293,154545,0.16305930311559738
771.0,UK539L1,Bournemouth,2001,1129,92664,93793,1.2037145629204737
772.0,UK546L1,Colchester,2001,1910,67585,69495,2.7483991654075837
773.0,UK550L0,Dundee City,2001,14953,211463,226416,6.604215249805668
774.0,UK551L1,Falkirk,2001,4403,25386,29789,14.780623720165162
775.0,UK552L0,Reading,2001,45,21876,21921,0.20528260572054194
776.0,UK553L1,Blackpool,2001,86,48869,48955,0.1756715350832397
777.0,UK557L1,Blackburn with Darwen,2001,716,78838,79554,0.9000175981094602
778.0,UK558L1,Newport,2001,4419,27281,31700,13.94006309148265
779.0,UK559L2,Middlesbrough,2001,1975,59794,61769,3.1973967524162608
780.0,UK560L1,Oxford,2001,1663,191260,192923,0.8620019385972643
781.0,UK562L2,Preston,2001,94,25668,25762,0.36487850322179954
782.0,UK566L1,Norwich,2001,37,150203,150240,0.024627263045793397
783.0,UK568L1,Cheshire West and Chester,2001,2129,134016,136145,1.5637739175144147
784.0,UK569L2,Ipswich,2001,2388,153258,155646,1.5342507998920627
785.0,UK571L1,Cheltenham,2001,8,46175,46183,0.01732239135612671
786.0,XK001L1,Pristina,2001,15,255792,255807,0.005863795752266357
787.0,XK002L1,Prizren,2001,3,127630,127633,0.002350489293521268
788.0,XK003L1,MitrovicÃ«,2001,0,117914,117914,0.0
1.0,AL001L1,Tirana,2002,1653,165468,167121,0.9891037033047911
2.0,AL003L1,Elbasan,2002,841,125163,126004,0.6674391289165423
3.0,AL004L1,ShkodÃ«r,2002,14863,170466,185329,8.019791829665083
4.0,AL005L0,VlorÃ«,2002,2827,60906,63733,4.4356926552963145
5.0,AT001L3,Wien,2002,11514,906976,918490,1.2535792441942755
6.0,AT002L3,Graz,2002,1528,289604,291132,0.524847835346166
7.0,AT003L3,Linz,2002,3316,355914,359230,0.9230854884057567
8.0,AT004L3,Salzburg,2002,6490,130986,137476,4.720823998370625
9.0,AT005L3,Innsbruck,2002,60884,151938,212822,28.607944667374614
10.0,AT006L2,Klagenfurt,2002,3795,179465,183260,2.0708283313325326
11.0,BA001L1,Sarajevo,2002,5423,258351,263774,2.0559266644930885
12.0,BA002L1,Banja Luka,2002,44,275258,275302,0.015982448365794655
13.0,BA003L1,Mostar,2002,1919,180428,182347,1.0523891262263707
14.0,BA004L1,Tuzla,2002,499,111762,112261,0.44449987083671083
15.0,BA005L1,Zenica,2002,417,86299,86716,0.4808801143964205
16.0,BE001L2,Bruxelles / Brussel,2002,138213,188438,326651,42.31213129609277
17.0,BE002L2,Antwerpen,2002,24181,95031,119212,20.2840318088783
18.0,BE003L2,Gent,2002,2313,99528,101841,2.2711874392435267
19.0,BE004L2,Charleroi,2002,27376,82389,109765,24.940554821664467
20.0,BE005L2,LiÃ¨ge,2002,85713,55685,141398,60.618254855089894
21.0,BE006L2,Brugge,2002,4952,51587,56539,8.758556040962876
22.0,BE007L2,Namur,2002,61277,22830,84107,72.85600485096366
23.0,BE008L1,Leuven,2002,38013,7063,45076,84.33090780015972
24.0,BE009L1,Mons,2002,383,38817,39200,0.9770408163265305
25.0,BE010L1,Kortrijk,2002,7080,15259,22339,31.693450915439364
26.0,BE011L1,Oostende,2002,292,20640,20932,1.3949933116759028
27.0,BG001L2,Sofia,2002,209904,361870,571774,36.711008195545794
28.0,BG002L2,Plovdiv,2002,34087,242999,277086,12.30195679319778
29.0,BG003L2,Varna,2002,3753,201045,204798,1.8325374271233117
30.0,BG004L2,Burgas,2002,6521,289379,295900,2.203785062521122
31.0,BG005L1,Pleven,2002,13179,165897,179076,7.359445151779133
32.0,BG006L2,Ruse,2002,2694,131323,134017,2.0101927367423533
33.0,BG007L2,Vidin,2002,1903,59061,60964,3.1215143363296374
34.0,BG008L2,Stara Zagora,2002,50,132018,132068,0.03785928461095799
35.0,BG009L1,Sliven,2002,5214,131560,136774,3.81212803603024
36.0,BG010L1,Dobrich,2002,48,140290,140338,0.03420313813792415
37.0,BG011L1,Shumen,2002,65,94442,94507,0.06877797411831928
38.0,BG013L1,Yambol,2002,435,130371,130806,0.3325535525893308
39.0,BG014L1,Haskovo,2002,530,73438,73968,0.7165260653255462
40.0,BG015L1,Pazardzhik,2002,11332,52490,63822,17.75563285387484
41.0,BG016L1,Blagoevgrad,2002,64133,71346,135479,47.33796381727057
42.0,BG017L1,Veliko Tarnovo,2002,44,88495,88539,0.04969561436203255
43.0,BG018L1,Vratsa,2002,18956,51601,70557,26.866221636407445
44.0,CH001L2,ZÃ¼rich,2002,567,127150,127717,0.44395029635835476
45.0,CH002L2,GenÃ¨ve,2002,278,53619,53897,0.5157986529862516
46.0,CH003L2,Basel,2002,323,69097,69420,0.46528377989052144
47.0,CH004L2,Bern,2002,296,77992,78288,0.3780911506233395
48.0,CH005L2,Lausanne,2002,66,77439,77505,0.08515579640023224
49.0,CH006L1,Winterthur,2002,5,13286,13291,0.03761944172748476
50.0,CH007L2,St. Gallen,2002,20211,11698,31909,63.33949669372277
51.0,CH008L2,Luzern,2002,570,28689,29259,1.9481185276325232
52.0,CH009L2,Lugano,2002,81,30544,30625,0.26448979591836735
53.0,CH010L1,Biel/Bienne,2002,23,9072,9095,0.2528862012094557
54.0,CY001L2,Lefkosia,2002,59,162569,162628,0.03627911552746144
55.0,CY501L2,Lemesos,2002,1175,124724,125899,0.933287794184227
56.0,CZ001L2,Praha,2002,1732,568830,570562,0.30356034926966746
57.0,CZ002L2,Brno,2002,281,267634,267915,0.10488401172013512
58.0,CZ003L2,Ostrava,2002,5747,136919,142666,4.028289851821738
59.0,CZ004L2,PlzeÅ,2002,158,195799,195957,0.08062993411819941
60.0,CZ005L2,ÃstÃ­ nad Labem,2002,97,35814,35911,0.2701122218818746
61.0,CZ006L2,Olomouc,2002,116,93448,93564,0.12397930828096275
62.0,CZ007L2,Liberec,2002,2,61314,61316,0.0032617913758236023
63.0,CZ008L2,ÄeskÃ© BudÄjovice,2002,2101,127303,129404,1.6235974158449507
64.0,CZ009L2,Hradec KrÃ¡lovÃ©,2002,41,79464,79505,0.05156908370542733
65.0,CZ010L2,Pardubice,2002,182,86175,86357,0.2107530368123024
66.0,CZ011L2,ZlÃ­n,2002,22034,35918,57952,38.02112092766428
67.0,CZ013L2,Karlovy Vary,2002,137,46847,46984,0.2915886259152052
68.0,CZ014L2,Jihlava,2002,139,95888,96027,0.14475095546044342
69.0,CZ016L2,Most,2002,108,27670,27778,0.38879688962488296
70.0,CZ018L2,Chomutov-Jirkov,2002,456,45230,45686,0.998117585255877
71.0,DE001L1,Berlin,2002,173103,1575162,1748265,9.901416547262572
72.0,DE002L1,Hamburg,2002,242340,491834,734174,33.00852386491486
73.0,DE003L1,MÃ¼nchen,2002,58439,491502,549941,10.626412651538983
74.0,DE004L1,KÃ¶ln,2002,6688,155942,162630,4.11240238578368
75.0,DE005L1,Frankfurt am Main,2002,3504,426827,430331,0.8142569324543201
76.0,DE007L1,Stuttgart,2002,17551,347619,365170,4.806254621135361
77.0,DE008L2,Leipzig,2002,85331,312358,397689,21.456716177716757
78.0,DE009L2,Dresden,2002,6939,576257,583196,1.189822975466224
79.0,DE011L1,DÃ¼sseldorf,2002,16252,104065,120317,13.507650622937739
80.0,DE012L1,Bremen,2002,342656,246883,589539,58.122702654107705
81.0,DE013L1,Hannover,2002,5718,291594,297312,1.9232321601549887
82.0,DE014L1,NÃ¼rnberg,2002,607,292894,293501,0.2068136054050923
83.0,DE017L0,Bielefeld,2002,186,25697,25883,0.7186183981764093
84.0,DE018L1,Halle an der Saale,2002,43032,114554,157586,27.306994276141282
85.0,DE019L2,Magdeburg,2002,164555,252479,417034,39.4584134626913
86.0,DE020L1,Wiesbaden,2002,1373,100065,101438,1.3535361501606893
87.0,DE021L1,GÃ¶ttingen,2002,6611,232346,238957,2.766606544273656
88.0,DE025L1,Darmstadt,2002,91,78096,78187,0.11638763477304412
89.0,DE026L1,Trier,2002,12959,108168,121127,10.698688153755976
90.0,DE027L1,Freiburg im Breisgau,2002,1608,219588,221196,0.7269570878316064
91.0,DE028L1,Regensburg,2002,6788,246874,253662,2.676001923819886
92.0,DE029L0,Frankfurt (Oder),2002,523,14321,14844,3.523309081110213
93.0,DE030L1,Weimar,2002,13357,75671,89028,15.003145077953004
94.0,DE031L1,Schwerin,2002,41014,448989,490003,8.370152835798965
95.0,DE032L1,Erfurt,2002,135457,150055,285512,47.443540026338646
96.0,DE033L1,Augsburg,2002,19027,180907,199934,9.51664049136215
97.0,DE034L1,Bonn,2002,1869,127468,129337,1.4450621245273976
98.0,DE035L1,Karlsruhe,2002,2384,123428,125812,1.8948907894318505
99.0,DE036L0,MÃ¶nchengladbach,2002,9234,7789,17023,54.244257768900894
100.0,DE037L1,Mainz,2002,1553,68752,70305,2.208946732095868
101.0,DE038L1,Ruhrgebiet,2002,94169,349583,443752,21.221087454253727
102.0,DE039L1,Kiel,2002,145869,193893,339762,42.93269994878768
103.0,DE040L1,SaarbrÃ¼cken,2002,61618,92064,153682,40.09448081102536
104.0,DE042L1,Koblenz,2002,7075,85101,92176,7.675533761499739
105.0,DE043L2,Rostock,2002,100487,261317,361804,27.77387756907055
106.0,DE044L1,Kaiserslautern,2002,3323,132204,135527,2.451909951522575
107.0,DE045L1,Iserlohn,2002,29281,76826,106107,27.595728839756095
108.0,DE048L1,Wilhelmshaven,2002,12978,61069,74047,17.52670601104704
109.0,DE050L1,TÃ¼bingen,2002,66,51959,52025,0.1268620855358001
110.0,DE051L1,Villingen-Schwenningen,2002,854,101706,102560,0.8326833073322933
111.0,DE052L1,Flensburg,2002,86340,119135,205475,42.01971042705925
112.0,DE053L1,Marburg,2002,209,126033,126242,0.16555504507216298
113.0,DE054L1,Konstanz,2002,345,81555,81900,0.42124542124542125
114.0,DE055L0,NeumÃ¼nster,2002,2098,5078,7176,29.23634336677815
115.0,DE056L0,Brandenburg an der Havel,2002,5636,17194,22830,24.686815593517302
116.0,DE057L1,GieÃen,2002,241,85287,85528,0.28177906650453655
117.0,DE058L1,LÃ¼neburg,2002,31954,100548,132502,24.11586240207695
118.0,DE059L1,Bayreuth,2002,23577,176343,199920,11.793217286914766
119.0,DE060L1,Celle,2002,12667,142380,155047,8.169780776151747
120.0,DE061L1,Aschaffenburg,2002,935,146681,147616,0.6334001734229352
121.0,DE062L1,Bamberg,2002,11553,110602,122155,9.457656256395563
122.0,DE063L1,Plauen,2002,4396,136892,141288,3.111375346809354
123.0,DE064L1,Neubrandenburg,2002,210413,373578,583991,36.030178547272136
124.0,DE065L1,Fulda,2002,278,137947,138225,0.20112136010128415
125.0,DE066L1,Kempten (AllgÃ¤u),2002,80250,78917,159167,50.41874257854957
126.0,DE067L1,Landshut,2002,192,141261,141453,0.1357341307713516
127.0,DE069L1,Rosenheim,2002,552,147211,147763,0.3735711917056367
128.0,DE071L1,Stralsund,2002,143585,194663,338248,42.44962276199711
129.0,DE072L1,Friedrichshafen,2002,46246,20373,66619,69.41863432354133
130.0,DE073L1,Offenburg,2002,1927,183957,185884,1.0366680295237891
131.0,DE074L1,GÃ¶rlitz,2002,1251,209856,211107,0.5925904872884367
132.0,DE077L1,Schweinfurt,2002,42387,158953,201340,21.052448594417402
133.0,DE078L1,Greifswald,2002,96371,253423,349794,27.550787034654682
134.0,DE079L1,Wetzlar,2002,665,105825,106490,0.6244717813879238
135.0,DE081L1,Passau,2002,769,159297,160066,0.48042682393512676
136.0,DE082L0,Dessau-RoÃlau,2002,2418,22230,24648,9.81012658227848
137.0,DE083L1,Braunschweig-Salzgitter-Wolfsburg,2002,4411,408433,412844,1.0684423171948727
138.0,DE084L1,Mannheim-Ludwigshafen,2002,2741,201687,204428,1.340814369851488
139.0,DE504L1,MÃ¼nster,2002,22597,119166,141763,15.939984340060523
140.0,DE505L0,Chemnitz,2002,1,22192,22193,0.004505925291758662
141.0,DE507L1,Aachen,2002,15975,54545,70520,22.653148043108338
142.0,DE508L0,Krefeld,2002,3955,9725,13680,28.910818713450293
143.0,DE510L1,LÃ¼beck,2002,12372,149777,162149,7.630019303233445
144.0,DE513L1,Kassel,2002,989,138872,139861,0.7071306511464955
145.0,DE516L0,Solingen,2002,1904,7050,8954,21.26423944605763
146.0,DE517L1,OsnabrÃ¼ck,2002,130657,93473,224130,58.29518582965243
147.0,DE520L1,Oldenburg (Oldenburg),2002,89980,99989,189969,47.36562281214303
148.0,DE522L1,Heidelberg,2002,1042,116063,117105,0.889799752358994
149.0,DE523L1,Paderborn,2002,1112,123571,124683,0.8918617614269788
150.0,DE524L2,WÃ¼rzburg,2002,43460,262469,305929,14.205910521722359
151.0,DE527L1,Bremerhaven,2002,94332,120147,214479,43.9819283006728
152.0,DE529L1,Heilbronn,2002,118,119866,119984,0.0983464461928257
153.0,DE530L0,Remscheid,2002,686,6683,7369,9.309268557470485
154.0,DE532L1,Ulm,2002,62778,136530,199308,31.49798302125354
155.0,DE533L1,Pforzheim,2002,71,67077,67148,0.1057365818788348
156.0,DE534L1,Ingolstadt,2002,79274,205561,284835,27.831551600049153
157.0,DE535L1,Gera,2002,13633,86153,99786,13.662237187581425
158.0,DE537L1,Reutlingen,2002,7789,101493,109282,7.127431781995205
159.0,DE539L1,Cottbus,2002,2379,179901,182280,1.3051349572086899
160.0,DE540L2,Siegen,2002,6901,170663,177564,3.8864859994142957
161.0,DE542L1,Hildesheim,2002,612,120198,120810,0.5065805810777253
162.0,DE544L1,Zwickau,2002,2439,92365,94804,2.572676258385722
163.0,DE546L0,Wuppertal,2002,3841,12992,16833,22.818273629180776
164.0,DE547L2,Jena,2002,13416,79652,93068,14.415266256930417
165.0,DE548L1,DÃ¼ren,2002,13974,80064,94038,14.859950232884579
166.0,DE549L1,Bocholt,2002,24129,118136,142265,16.960601694021722
167.0,DK001L2,KÃ¸benhavn,2002,16120,275103,291223,5.5352770900650015
168.0,DK002L3,Ãrhus,2002,6186,456338,462524,1.3374441110082937
169.0,DK003L2,Odense,2002,15218,344621,359839,4.229113575793619
170.0,DK004L3,Aalborg,2002,7117,613342,620459,1.147054035802527
171.0,EE001L1,Tallinn,2002,6453,432608,439061,1.4697274410617203
172.0,EE002L1,Tartu,2002,17091,282551,299642,5.70380654247402
173.0,EE003L0,Narva,2002,637,6252,6889,9.246625054434606
174.0,EL001L1,Athina,2002,5345,304042,309387,1.7276097573589067
175.0,EL002L1,Thessaloniki,2002,1579,140540,142119,1.1110407475425523
176.0,EL003L1,Patra,2002,711,50879,51590,1.3781740647412288
177.0,EL004L1,Irakleio,2002,1094,60290,61384,1.7822233806855208
178.0,EL005L1,Larisa,2002,372,155147,155519,0.23919906892405426
179.0,EL006L1,Volos,2002,281,30535,30816,0.9118639667705088
180.0,EL007L1,Ioannina,2002,4420,128221,132641,3.332302983240476
181.0,EL008L1,Kavala,2002,338,35230,35568,0.9502923976608186
182.0,EL009L1,Kalamata,2002,270,44182,44452,0.6073967425537659
183.0,ES001L3,Madrid,2002,2429,785174,787603,0.30840410714535116
184.0,ES002L2,Barcelona,2002,1661,262946,264607,0.6277233784442589
185.0,ES003L3,Valencia,2002,3326,171794,175120,1.899269072635907
186.0,ES004L3,Sevilla,2002,4997,463429,468426,1.0667640139531112
187.0,ES005L2,Zaragoza,2002,176,275962,276138,0.06373624781811991
188.0,ES006L2,MÃ¡laga,2002,1026,151716,152742,0.6717209411949562
189.0,ES007L2,Murcia,2002,138,119998,120136,0.11486981421056136
190.0,ES008L2,Las Palmas,2002,76596,0,76596,100.0
191.0,ES009L2,Valladolid,2002,290,115239,115529,0.25101922461027104
192.0,ES010L2,Palma de Mallorca,2002,2350,201884,204234,1.1506409314805566
193.0,ES011L2,Santiago de Compostela,2002,22,126234,126256,0.017424914459510835
194.0,ES012L2,Vitoria/Gasteiz,2002,215,159106,159321,0.13494768423497217
195.0,ES013L2,Oviedo,2002,529,92958,93487,0.5658540759677816
196.0,ES014L3,Pamplona/IruÃ±a,2002,21360,148154,169514,12.600729143315597
197.0,ES015L2,Santander,2002,547,68936,69483,0.7872429227293007
198.0,ES016L2,Toledo,2002,487,92911,93398,0.5214244416368659
199.0,ES017L2,Badajoz,2002,769,217980,218749,0.3515444642032649
200.0,ES018L2,LogroÃ±o,2002,42,46096,46138,0.09103125406389527
201.0,ES019L3,Bilbao,2002,1511,151810,153321,0.9855140522172435
202.0,ES020L2,CÃ³rdoba,2002,1449,185453,186902,0.7752726027543846
203.0,ES021L2,Alicante/Alacant,2002,492,35566,36058,1.3644683565366909
204.0,ES022L2,Vigo,2002,1031,135440,136471,0.7554718584900821
205.0,ES023L2,GijÃ³n,2002,1097,52305,53402,2.0542301786449944
206.0,ES025L3,Santa Cruz de Tenerife,2002,66983,0,66983,100.0
207.0,ES026L2,CoruÃ±a (A),2002,756,75219,75975,0.9950641658440276
208.0,ES028L1,Reus,2002,0,11534,11534,0.0
209.0,ES031L1,Lugo,2002,4437,129574,134011,3.3109222377267535
210.0,ES033L1,Girona,2002,2,39619,39621,0.005047828171929028
211.0,ES034L1,CÃ¡ceres,2002,1985,236288,238273,0.833078023947321
212.0,ES035L1,Torrevieja,2002,1762,7076,8838,19.936637248246207
213.0,ES039L1,AvilÃ©s,2002,641,18501,19142,3.3486574025702645
214.0,ES040L1,Talavera de la Reina,2002,551,82715,83266,0.6617346816227512
215.0,ES041L1,Palencia,2002,344,28037,28381,1.212078503223988
216.0,ES043L1,Ferrol,2002,1237,45733,46970,2.633595912284437
217.0,ES044L1,Pontevedra,2002,187,51429,51616,0.36229076255424675
218.0,ES046L1,Gandia,2002,264,17073,17337,1.5227548018688355
219.0,ES048L1,Guadalajara,2002,4,45379,45383,0.008813873036158914
220.0,ES050L1,Manresa,2002,3,29600,29603,0.010134108029591596
221.0,ES053L1,Ciudad Real,2002,826,95519,96345,0.857335616793814
222.0,ES054L1,Benidorm,2002,342,20331,20673,1.654331737048324
223.0,ES057L1,Ponferrada,2002,264,62079,62343,0.423463740917184
224.0,ES059L1,Zamora,2002,324,33856,34180,0.9479227618490346
225.0,ES070L1,Irun,2002,131,7111,7242,1.8088925711129522
226.0,ES072L1,Arrecife,2002,58934,0,58934,100.0
227.0,ES501L3,Granada,2002,338,162286,162624,0.2078414010232192
228.0,ES505L1,Elche/Elx,2002,985,37833,38818,2.5374826111597715
229.0,ES506L1,Cartagena,2002,1615,59333,60948,2.649799829362735
230.0,ES508L1,Jerez de la Frontera,2002,165,125941,126106,0.13084230726531648
231.0,ES510L1,Donostia-San SebastiÃ¡n,2002,311,33009,33320,0.9333733493397359
232.0,ES514L1,AlmerÃ­a,2002,788,39942,40730,1.934691873312055
233.0,ES515L1,Burgos,2002,13,149378,149391,0.008701996773567349
234.0,ES516L1,Salamanca,2002,32,45612,45644,0.07010779072824468
235.0,ES519L1,Albacete,2002,6,245319,245325,0.0024457352491592784
236.0,ES520L1,CastellÃ³n/CastellÃ³,2002,541,32253,32794,1.6496920168323475
237.0,ES521L1,Huelva,2002,3974,93446,97420,4.079244508314515
238.0,ES522L1,CÃ¡diz,2002,1089,23744,24833,4.38529376233238
239.0,ES523L1,LeÃ³n,2002,46,118841,118887,0.038692203520990516
240.0,ES525L1,Tarragona,2002,535,21205,21740,2.4609015639374427
241.0,ES527L1,JaÃ©n,2002,31,99900,99931,0.03102140476929081
242.0,ES528L1,Lleida,2002,114,70561,70675,0.1613017332861691
243.0,ES529L1,Ourense,2002,11668,53500,65168,17.90449300270071
244.0,ES532L1,Algeciras,2002,598,41696,42294,1.4139121388376603
245.0,ES533L1,Marbella,2002,628,68577,69205,0.907448883751174
246.0,ES537L1,Alcoy,2002,7,20522,20529,0.03409810511958692
247.0,ES538L1,Ãvila,2002,502,53144,53646,0.9357640830630429
248.0,ES542L1,Cuenca,2002,83,164499,164582,0.050430788300057115
249.0,ES543L1,Eivissa,2002,2183,57219,59402,3.6749604390424566
250.0,ES544L1,Linares,2002,13,25763,25776,0.05043451272501552
251.0,ES545L1,Lorca,2002,115,182092,182207,0.0631150285115281
252.0,ES546L1,MÃ©rida,2002,996,127303,128299,0.7763115846577137
253.0,ES547L1,Sagunto,2002,344,15184,15528,2.215352910870685
254.0,ES550L1,Puerto de la Cruz,2002,27472,0,27472,100.0
255.0,ES552L1,Igualada,2002,2,25424,25426,0.007865963973884999
256.0,FI001L3,Helsinki,2002,22874,468644,491518,4.653746149683227
257.0,FI002L3,Tampere,2002,137258,551385,688643,19.931662704768655
258.0,FI003L4,Turku,2002,60680,405764,466444,13.009064324977917
259.0,FI004L4,Oulu,2002,704019,19802,723821,97.26424074460398
260.0,FI007L2,Lahti,2002,40090,295313,335403,11.952785156960433
261.0,FI008L2,Kuopio,2002,163723,756683,920406,17.7881282825188
262.0,FI009L2,JyvÃ¤skylÃ¤,2002,64350,412592,476942,13.492206599544598
263.0,FR001L1,Paris,2002,93817,1116135,1209952,7.753778662294042
264.0,FR003L2,Lyon,2002,2037,365194,367231,0.5546917335410138
265.0,FR004L2,Toulouse,2002,1634,523038,524672,0.3114326665040254
266.0,FR006L2,Strasbourg,2002,1844,202039,203883,0.9044402917359466
267.0,FR007L2,Bordeaux,2002,5377,550377,555754,0.9675144038549429
268.0,FR008L2,Nantes,2002,620,315999,316619,0.19581894958925397
269.0,FR009L2,Lille,2002,50086,94367,144453,34.672869376198484
270.0,FR010L2,Montpellier,2002,7311,216607,223918,3.265034521565931
271.0,FR011L2,Saint-Etienne,2002,2972,178083,181055,1.641490154925299
272.0,FR012L2,Le Havre,2002,1429,75009,76438,1.8694889976189855
273.0,FR013L2,Rennes,2002,125,382012,382137,0.03271078173534622
274.0,FR014L2,Amiens,2002,17784,227011,244795,7.264854265814252
275.0,FR016L2,Nancy,2002,364,283145,283509,0.12839098582408318
276.0,FR017L2,Metz,2002,22238,154692,176930,12.568812524727294
277.0,FR018L2,Reims,2002,25024,218127,243151,10.291547227854297
278.0,FR019L2,OrlÃ©ans,2002,176571,115396,291967,60.47635520452654
279.0,FR020L2,Dijon,2002,14587,371174,385761,3.781356850485145
280.0,FR021L2,Poitiers,2002,558,249884,250442,0.2228060788525886
281.0,FR022L2,Clermont-Ferrand,2002,1256,264870,266126,0.47195689259974594
282.0,FR023L2,Caen,2002,327,225946,226273,0.14451569564199
283.0,FR024L2,Limoges,2002,188479,129355,317834,59.30108169673477
284.0,FR025L2,BesanÃ§on,2002,93,238943,239036,0.03890627353202028
285.0,FR026L2,Grenoble,2002,2705,263143,265848,1.0174987210736963
286.0,FR027L2,Ajaccio,2002,2801,144208,147009,1.9053255242876286
289.0,FR032L2,Toulon,2002,2238,104818,107056,2.0904946943655656
290.0,FR034L2,Valenciennes,2002,5376,73070,78446,6.853121892766999
291.0,FR035L2,Tours,2002,10761,274087,284848,3.7778043026456216
292.0,FR036L2,Angers,2002,178,231073,231251,0.076972640118313
293.0,FR037L2,Brest,2002,52911,82083,134994,39.195075336681626
294.0,FR038L2,Le Mans,2002,842,223269,224111,0.375706681064294
295.0,FR039L1,Avignon,2002,1546,85679,87225,1.772427629693322
296.0,FR040L2,Mulhouse,2002,227,129539,129766,0.17493025908173174
297.0,FR042L2,Dunkerque,2002,28743,62382,91125,31.54238683127572
298.0,FR043L2,Perpignan,2002,1974,181056,183030,1.0785117193902638
299.0,FR044L2,NÃ®mes,2002,1400,149091,150491,0.9302881899914281
300.0,FR045L2,Pau,2002,1353,200406,201759,0.6706020549269178
301.0,FR046L2,Bayonne,2002,17390,85240,102630,16.94436324661405
302.0,FR047L0,Annemasse,2002,10,7790,7800,0.1282051282051282
303.0,FR048L2,Annecy,2002,2297,116746,119043,1.929554866728829
304.0,FR049L2,Lorient,2002,1393,111789,113182,1.2307610750826103
305.0,FR050L2,MontbÃ©liard,2002,47,123010,123057,0.03819368260237126
306.0,FR051L2,Troyes,2002,1358,259592,260950,0.5204062080858403
307.0,FR052L2,Saint-Nazaire,2002,750,106385,107135,0.7000513370980539
308.0,FR053L2,La Rochelle,2002,329,111011,111340,0.2954912879468295
309.0,FR056L2,AngoulÃªme,2002,168,214124,214292,0.07839770033412354
310.0,FR057L2,Boulogne-sur-Mer,2002,5987,62551,68538,8.735300125477837
311.0,FR058L2,ChambÃ©ry,2002,404,101285,101689,0.39728977568861923
312.0,FR059L2,Chalon-sur-SaÃ´ne,2002,5374,150984,156358,3.4369843564128475
313.0,FR060L2,Chartres,2002,5829,155531,161360,3.612419434804165
314.0,FR061L2,Niort,2002,43,178876,178919,0.024033221737210696
315.0,FR062L2,Calais,2002,7160,43070,50230,14.254429623730838
316.0,FR063L2,BÃ©ziers,2002,749,84394,85143,0.8796965105763246
317.0,FR064L2,Arras,2002,691,106872,107563,0.6424142130658312
318.0,FR065L2,Bourges,2002,339,249980,250319,0.1354271948993085
319.0,FR066L2,Saint-Brieuc,2002,5225,109956,115181,4.536338458599943
320.0,FR067L2,Quimper,2002,35961,85961,121922,29.495087022850676
321.0,FR068L2,Vannes,2002,1206,119828,121034,0.9964142307120314
322.0,FR069L2,Cherbourg,2002,701,90017,90718,0.7727242664079895
323.0,FR073L2,Tarbes,2002,138,104191,104329,0.1322738644097039
324.0,FR074L2,CompiÃ¨gne,2002,6374,92363,98737,6.455533386673689
325.0,FR076L2,Belfort,2002,77,65542,65619,0.11734406193328152
326.0,FR077L2,Roanne,2002,5025,118175,123200,4.078733766233766
327.0,FR079L2,Saint-Quentin,2002,1509,97865,99374,1.518505846599714
328.0,FR082L2,Beauvais,2002,665,130477,131142,0.5070839242958014
329.0,FR084L2,Creil,2002,906,28737,29643,3.0563708126707825
330.0,FR086L2,Evreux,2002,294,126276,126570,0.23228253140554633
331.0,FR090L2,ChÃ¢teauroux,2002,133698,127479,261177,51.19057191100288
332.0,FR093L2,Brive-la-Gaillarde,2002,55,132527,132582,0.041483760993196665
333.0,FR096L2,Albi,2002,313,133925,134238,0.2331679554224586
334.0,FR099L2,FrÃ©jus,2002,446,43967,44413,1.0042104789138315
335.0,FR104L2,ChÃ¢lons-en-Champagne,2002,1223,151586,152809,0.8003455293863581
336.0,FR203L2,Marseille,2002,2919,422857,425776,0.6855717560407351
337.0,FR205L2,Nice,2002,12728,294612,307340,4.141341836402681
338.0,FR207L2,Lens - LiÃ©vin,2002,4538,20770,25308,17.931088983720564
339.0,FR208L1,HÃ©nin - Carvin,2002,10795,803,11598,93.07639248146232
340.0,FR209L2,Douai,2002,12693,32391,45084,28.154112323662495
341.0,FR214L1,Valence,2002,662,90299,90961,0.727784435087565
342.0,FR215L2,Rouen,2002,79630,207496,287126,27.733468930016787
343.0,FR304L1,Melun,2002,18,44818,44836,0.04014631100008922
344.0,FR324L1,Martigues,2002,1771,18685,20456,8.657606570199453
345.0,FR505L1,Charleville-MÃ©ziÃ¨res,2002,8991,126378,135369,6.641845621966624
346.0,FR506L1,Colmar,2002,312,101673,101985,0.30592734225621415
347.0,FR519L1,Cannes,2002,519,19617,20136,2.5774731823599524
348.0,HR001L2,Grad Zagreb,2002,3294,502574,505868,0.6511580095993421
349.0,HR002L2,Rijeka,2002,4154,103080,107234,3.873771378480706
350.0,HR003L2,Slavonski Brod,2002,399,97431,97830,0.4078503526525606
351.0,HR004L2,Osijek,2002,1252,171682,172934,0.7239756207570518
352.0,HR005L2,Split,2002,3637,335433,339070,1.0726398678738904
353.0,HR006L1,Pula - Pola,2002,1527,57370,58897,2.592661765454947
354.0,HR007L1,Zadar,2002,2793,153707,156500,1.784664536741214
355.0,HU001L2,Budapest,2002,6901,632233,639134,1.0797422762675746
356.0,HU002L2,Miskolc,2002,64,164605,164669,0.03886584603052184
357.0,HU003L2,NyÃ­regyhÃ¡za,2002,160,168065,168225,0.09511071481646605
358.0,HU004L2,PÃ©cs,2002,262,185226,185488,0.14124902958681962
359.0,HU005L2,Debrecen,2002,597,200981,201578,0.2961632717856115
360.0,HU006L2,Szeged,2002,881,160052,160933,0.5474327825865423
361.0,HU007L2,GyÃµr,2002,735,203905,204640,0.3591673182173573
362.0,HU008L2,KecskemÃ©t,2002,85,182054,182139,0.04666765492288857
363.0,HU009L2,SzÃ©kesfehÃ©rvÃ¡r,2002,1679,299444,301123,0.5575794608847547
364.0,HU010L1,Szombathely,2002,34,134243,134277,0.025320792093955033
365.0,HU011L1,Szolnok,2002,858,143117,143975,0.5959367945823928
366.0,HU012L1,TatabÃ¡nya,2002,157,69673,69830,0.22483173421165686
367.0,HU013L1,VeszprÃ©m,2002,7185,124135,131320,5.471367651538228
368.0,HU014L1,BÃ©kÃ©scsaba,2002,15,106148,106163,0.014129216393658807
369.0,HU015L1,KaposvÃ¡r,2002,1524,144036,145560,1.0469909315746084
370.0,HU016L1,Eger,2002,120,100458,100578,0.11931038596909863
371.0,HU017L1,DunaÃºjvÃ¡ros,2002,870,60800,61670,1.410734554888925
372.0,HU018L1,Zalaegerszeg,2002,240,139739,139979,0.17145428957200723
373.0,HU019L1,Sopron,2002,816,79854,80670,1.0115284492376349
374.0,IE001L1,Dublin,2002,247959,455643,703602,35.241372253063524
375.0,IE002L1,Cork,2002,110646,219017,329663,33.56336622550908
376.0,IE003L1,Limerick,2002,36439,120019,156458,23.28995641002697
377.0,IE004L1,Galway,2002,11528,214755,226283,5.094505552781252
378.0,IE005L1,Waterford,2002,22142,73715,95857,23.098991205650083
379.0,IS001L1,ReykjavÃ­k,2002,1297230,0,1297230,100.0
380.0,IT001L3,Roma,2002,10318,606898,617216,1.6717000207382828
381.0,IT002L3,Milano,2002,276,383769,384045,0.07186657813537475
382.0,IT003L3,Napoli,2002,14287,138655,152942,9.341449699886232
383.0,IT004L2,Torino,2002,1621,168558,170179,0.9525264574359938
384.0,IT005L3,Palermo,2002,1834,148239,150073,1.2220719249965017
385.0,IT006L3,Genova,2002,875,119889,120764,0.7245536749362392
386.0,IT007L3,Firenze,2002,111,163660,163771,0.06777756745699788
387.0,IT008L3,Bari,2002,821,112608,113429,0.7238007916846662
388.0,IT009L1,Bologna,2002,158,185099,185257,0.08528692573020183
389.0,IT010L2,Catania,2002,605,60820,61425,0.9849409849409849
390.0,IT011L2,Venezia,2002,1820,65217,67037,2.7149186270268655
391.0,IT012L3,Verona,2002,74,73087,73161,0.10114678585585217
392.0,IT013L3,Cremona,2002,593,59804,60397,0.9818368462009702
393.0,IT014L3,Trento,2002,1925,96262,98187,1.96054467495697
394.0,IT015L1,Trieste,2002,385,21252,21637,1.7793594306049825
395.0,IT016L3,Perugia,2002,5608,125420,131028,4.280001221113045
396.0,IT017L3,Ancona,2002,591,43652,44243,1.3358045340505842
397.0,IT019L2,Pescara,2002,304,16139,16443,1.848811044213343
398.0,IT020L3,Campobasso,2002,57016,45819,102835,55.44415811737249
399.0,IT021L2,Caserta,2002,5,9337,9342,0.05352172982230786
400.0,IT022L2,Taranto,2002,3543,103385,106928,3.313444560825976
401.0,IT023L2,Potenza,2002,83,138372,138455,0.059947275287999716
402.0,IT024L3,Catanzaro,2002,402,89681,90083,0.4462551202779659
403.0,IT025L3,Reggio di Calabria,2002,656,47592,48248,1.3596418504393966
404.0,IT026L3,Sassari,2002,2754,150471,153225,1.7973568281938326
405.0,IT027L2,Cagliari,2002,4974,190318,195292,2.546955328431272
406.0,IT028L3,Padova,2002,32,61413,61445,0.05207909512572219
407.0,IT029L3,Brescia,2002,687,59582,60269,1.1398894954288274
408.0,IT030L3,Modena,2002,144,69124,69268,0.20788820234451696
409.0,IT031L3,Foggia,2002,10652,79059,89711,11.873683271839573
410.0,IT032L3,Salerno,2002,17314,20525,37839,45.75702317714527
411.0,IT033L2,Piacenza,2002,1026,93101,94127,1.0900166795924655
412.0,IT034L1,Bolzano,2002,4105,102651,106756,3.845217130653078
413.0,IT035L2,Udine,2002,5,71825,71830,0.006960879855213699
414.0,IT036L2,La Spezia,2002,681,42238,42919,1.5867098487849205
415.0,IT037L1,Lecce,2002,359,61151,61510,0.5836449357827995
416.0,IT038L1,Barletta,2002,238,14859,15097,1.5764721467841292
417.0,IT039L2,Pesaro,2002,118,25573,25691,0.4593048149157292
418.0,IT040L2,Como,2002,276,19465,19741,1.3981054657818752
419.0,IT041L2,Pisa,2002,498,47555,48053,1.0363556905916385
420.0,IT042L1,Treviso,2002,31,24014,24045,0.1289249324183822
421.0,IT043L2,Varese,2002,659,23005,23664,2.784820824881677
422.0,IT045L2,Asti,2002,99,54737,54836,0.1805383324823109
423.0,IT046L2,Pavia,2002,643,35561,36204,1.7760468456524139
424.0,IT047L1,Massa,2002,161,11082,11243,1.4320021346615672
425.0,IT048L2,Cosenza,2002,307,92172,92479,0.33196725743141686
426.0,IT052L1,Savona,2002,278,28427,28705,0.9684723915694129
427.0,IT054L1,Matera,2002,588,77201,77789,0.7558909357364152
428.0,IT056L1,Acireale,2002,52,5936,5988,0.8684034736138945
429.0,IT057L2,Avellino,2002,38619,1140,39759,97.13272466611333
430.0,IT058L2,Pordenone,2002,0,37050,37050,0.0
431.0,IT060L1,Lecco,2002,1455,28757,30212,4.815967165364755
432.0,IT061L0,Altamura,2002,2,42798,42800,0.004672897196261682
433.0,IT064L1,Battipaglia,2002,60,6426,6486,0.9250693802035153
434.0,IT065L0,Bisceglie,2002,93,6851,6944,1.3392857142857142
435.0,IT066L1,Carpi,2002,9,20613,20622,0.043642711667151585
436.0,IT067L0,Cerignola,2002,133,58764,58897,0.22581795337623306
437.0,IT068L1,Gallarate,2002,0,5319,5319,0.0
438.0,IT069L1,Gela,2002,442,57453,57895,0.7634510752223853
439.0,IT073L1,Sassuolo,2002,2,24060,24062,0.00831186102568365
440.0,IT501L2,Messina,2002,831,33612,34443,2.4126818221409283
441.0,IT502L2,Prato,2002,6,40953,40959,0.014648795136600013
442.0,IT503L3,Parma,2002,479,113028,113507,0.4220004052613495
443.0,IT504L3,Livorno,2002,472,25342,25814,1.8284651739366233
444.0,IT505L3,Reggio nell'Emilia,2002,1,69033,69034,0.0014485615783526957
445.0,IT506L2,Ravenna,2002,3647,77542,81189,4.491987830863787
446.0,IT507L2,Ferrara,2002,985,90498,91483,1.0767027753790321
447.0,IT508L3,Rimini,2002,415,32164,32579,1.273826698179809
448.0,IT509L3,Siracusa,2002,558,33584,34142,1.6343506531544725
449.0,IT511L2,Bergamo,2002,8,18548,18556,0.04311273981461522
450.0,IT512L3,ForlÃ¬,2002,18,72733,72751,0.024741927946007613
451.0,IT513L3,Latina,2002,535,65958,66493,0.8045959725083843
452.0,IT514L2,Vicenza,2002,32,34950,34982,0.09147561603110171
453.0,IT515L2,Terni,2002,138,102194,102332,0.1348551772661533
454.0,IT516L2,Novara,2002,4,54161,54165,0.007384842610541863
455.0,IT518L1,Alessandria,2002,145,76769,76914,0.18852224562498374
456.0,IT519L1,Arezzo,2002,33,88594,88627,0.037234702742956434
457.0,IT520L1,Grosseto,2002,421,119178,119599,0.3520096321875601
458.0,IT521L1,Brindisi,2002,921,63066,63987,1.439354868957757
459.0,IT522L1,Trapani,2002,1000,49790,50790,1.9688915140775742
460.0,IT523L1,Ragusa,2002,283,52567,52850,0.5354777672658467
461.0,IT524L0,Andria,2002,0,39880,39880,0.0
462.0,IT525L0,Trani,2002,131,10248,10379,1.2621639849696502
463.0,IT526L1,L'Aquila,2002,10850,129419,140269,7.735137485830797
464.0,LT001L1,Vilnius,2002,51450,373119,424569,12.118171604615505
465.0,LT002L1,Kaunas,2002,2999,159052,162051,1.8506519552486562
466.0,LT003L1,PanevÄÅ¾ys,2002,158,222650,222808,0.07091307313920506
467.0,LT004L0,Alytus,2002,432,3527,3959,10.911846425865116
468.0,LT501L0,KlaipÄda,2002,130,8793,8923,1.4569091112854422
469.0,LT502L0,Å iauliai,2002,1202,6843,8045,14.940957116221258
470.0,LU001L1,Luxembourg,2002,27075,232640,259715,10.424888820437788
471.0,LV001L1,RÄ«ga,2002,12382,603867,616249,2.009252753351324
472.0,LV002L2,LiepÄja,2002,4044,268013,272057,1.4864532064971678
473.0,LV003L1,Jelgava,2002,506,165953,166459,0.30397875753188475
474.0,LV501L1,Daugavpils,2002,2896,256779,259675,1.1152402041012806
475.0,ME001L1,Podgorica,2002,1154,183327,184481,0.6255386733593161
476.0,MK001L1,Skopje,2002,1960,222393,224353,0.8736232633394694
477.0,MK003L1,Bitola,2002,2556,117106,119662,2.1360164463238123
478.0,MK004L1,Tetovo,2002,3653,101968,105621,3.4585925147461207
479.0,MK005L1,Prilep,2002,101,86730,86831,0.11631790489571697
480.0,MT001L1,Valletta,2002,1021,24935,25956,3.9335799044536905
481.0,NL001L3,s' Gravenhage,2002,5494,37213,42707,12.86440162034327
482.0,NL002L3,Amsterdam,2002,109016,223941,332957,32.741765453196656
483.0,NL003L3,Rotterdam,2002,45851,171320,217171,21.112855768035327
484.0,NL004L3,Utrecht,2002,2025,95262,97287,2.0814702889389127
485.0,NL005L3,Eindhoven,2002,10257,134149,144406,7.102890461615169
486.0,NL006L3,Tilburg,2002,964,42270,43234,2.229726604061618
487.0,NL007L3,Groningen,2002,27328,180832,208160,13.128362797847808
488.0,NL008L3,Enschede,2002,25177,59779,84956,29.635340646923115
489.0,NL009L3,Arnhem,2002,2068,53830,55898,3.6995956921535655
490.0,NL010L3,Heerlen,2002,2260,31083,33343,6.77803437003269
491.0,NL012L3,Breda,2002,25849,47521,73370,35.23102085320976
492.0,NL013L3,Nijmegen,2002,1943,37893,39836,4.877497740737022
493.0,NL014L3,Apeldoorn,2002,1056,70068,71124,1.4847308925257299
494.0,NL015L3,Leeuwarden,2002,31594,79329,110923,28.482821416658403
495.0,NL016L3,Sittard-Geleen,2002,551,22361,22912,2.4048533519553073
496.0,NL020L3,Roosendaal,2002,3505,21069,24574,14.263042239765605
497.0,NL026L0,Alphen aan den Rijn,2002,250,12960,13210,1.8925056775170326
498.0,NL028L3,Bergen op Zoom,2002,4031,30750,34781,11.589661021822259
499.0,NL030L0,Gouda,2002,16,1772,1788,0.8948545861297539
500.0,NL032L3,MiddelburgÂ Â Â Â Â Â ,2002,1964,21424,23388,8.397468787412349
501.0,NL503L3,s-Hertogenbosch,2002,1108,35751,36859,3.0060500827477683
502.0,NL504L3,Amersfoort,2002,123,12121,12244,1.0045736687357074
503.0,NL505L3,Maastricht,2002,6599,13786,20385,32.37184204071622
504.0,NL507L3,Leiden,2002,984,18797,19781,4.974470451443304
505.0,NL511L3,Zwolle,2002,6932,116088,123020,5.634856120955942
506.0,NL512L3,Ede,2002,187,35078,35265,0.5302708067489011
507.0,NL513L3,Deventer,2002,1328,23917,25245,5.26044761338879
508.0,NL514L3,Alkmaar,2002,2226,45566,47792,4.657683294275192
509.0,NL515L3,Venlo,2002,15107,36129,51236,29.485127644624875
510.0,NL519L3,Almelo,2002,4565,37460,42025,10.862581796549673
511.0,NL520L3,Lelystad,2002,57943,60899,118842,48.75633193652076
512.0,NL521L3,Oss,2002,490,32656,33146,1.4783080914740845
513.0,NL522L3,Assen,2002,2432,68430,70862,3.4320228048883745
514.0,NL524L3,Veenendaal,2002,213,7972,8185,2.602321319486866
515.0,NL529L3,Soest,2002,140,7802,7942,1.7627801561319565
516.0,NO001L1,Oslo,2002,125558,621085,746643,16.816336589240105
517.0,NO002L1,Bergen,2002,197765,159978,357743,55.281305294582985
518.0,NO003L1,Trondheim,2002,517815,155441,673256,76.91205128509809
519.0,NO004L1,Stavanger,2002,229206,59871,289077,79.28890918336637
520.0,NO005L1,Kristiansand,2002,195421,120041,315462,61.94755628253166
521.0,NO006L1,TromsÃ¸,2002,374613,0,374613,100.0
522.0,PL001L2,Warszawa,2002,17537,843706,861243,2.036242965109731
523.0,PL002L2,ÅÃ³dÅº,2002,20659,148841,169500,12.188200589970503
524.0,PL003L2,KrakÃ³w,2002,14856,360892,375748,3.9537136591545394
525.0,PL004L2,WrocÅaw,2002,616,264084,264700,0.2327162825840574
526.0,PL005L2,PoznaÅ,2002,18217,291111,309328,5.889217917550303
527.0,PL006L2,GdaÅsk,2002,154405,109111,263516,58.5941650601861
528.0,PL007L2,Szczecin,2002,6879,106181,113060,6.084379975234389
529.0,PL008L2,Bydgoszcz,2002,117966,92170,210136,56.13792972170404
530.0,PL009L2,Lublin,2002,1274,321510,322784,0.39469118667591946
531.0,PL010L2,Katowice,2002,64126,330469,394595,16.251092892712784
532.0,PL011L2,BiaÅystok,2002,5044,218278,223322,2.2586220793293985
533.0,PL012L2,Kielce,2002,30,224199,224229,0.01337917932114044
534.0,PL013L2,ToruÅ,2002,77842,81091,158933,48.9778711784211
535.0,PL014L2,Olsztyn,2002,7144,195400,202544,3.527134844774469
536.0,PL015L2,RzeszÃ³w,2002,691,228658,229349,0.3012875573907015
537.0,PL016L2,Opole,2002,1823,174793,176616,1.0321828146940255
538.0,PL017L2,GorzÃ³w Wielkopolski,2002,747,96673,97420,0.7667830014370766
539.0,PL018L2,Zielona GÃ³ra,2002,36824,132460,169284,21.7527941211219
540.0,PL019L2,Jelenia GÃ³ra,2002,204,83137,83341,0.24477748047179662
541.0,PL020L2,Nowy SÄcz,2002,751,129667,130418,0.5758407581775522
542.0,PL021L2,SuwaÅki,2002,1829,70304,72133,2.535593972245713
543.0,PL022L2,Konin,2002,2212,115951,118163,1.8719903861614886
544.0,PL024L2,CzÄstochowa,2002,2351,191547,193898,1.212493166510227
545.0,PL025L2,Radom,2002,0,68022,68022,0.0
546.0,PL026L2,PÅock,2002,4203,166872,171075,2.4568171854449803
547.0,PL027L2,Kalisz,2002,156,148867,149023,0.10468182763734457
548.0,PL028L2,Koszalin,2002,769,128902,129671,0.5930393071696832
549.0,PL029L1,SÅupsk,2002,160864,74140,235004,68.45160082381577
550.0,PL030L1,JastrzÄbie-ZdrÃ³j,2002,423,29148,29571,1.4304555138480268
551.0,PL031L1,Siedlce,2002,187,125982,126169,0.14821390357377803
552.0,PL032L1,PiotrkÃ³w Trybunalski,2002,2580,114342,116922,2.2065992713090776
553.0,PL033L1,Lubin,2002,448,92858,93306,0.4801406126079781
554.0,PL034L1,PiÅa,2002,12258,39934,52192,23.486358062538322
555.0,PL035L1,InowrocÅaw,2002,19830,298,20128,98.51947535771065
556.0,PL036L1,Ostrowiec ÅwiÄtokrzyski,2002,11,61449,61460,0.017897819720143184
557.0,PL037L1,Gniezno,2002,1075,65496,66571,1.614817262772078
558.0,PL038L1,Stargard SzczeciÅski,2002,2288,34376,36664,6.240453851189177
559.0,PL039L1,OstrÃ³w Wielkopolski,2002,293,84468,84761,0.34567784712308725
560.0,PL040L1,PrzemyÅl,2002,71907,13182,85089,84.50798575609069
561.0,PL041L1,ZamoÅÄ,2002,8274,104433,112707,7.341158934227687
562.0,PL042L1,CheÅm,2002,2645,43925,46570,5.679622074296757
563.0,PL043L1,Pabianice,2002,4958,28001,32959,15.042932127795138
564.0,PL044L1,GÅogÃ³w,2002,468,63613,64081,0.7303256815592766
565.0,PL045L1,Stalowa Wola,2002,385,189928,190313,0.202298319084876
566.0,PL046L1,TomaszÃ³w Mazowiecki,2002,922,18241,19163,4.81135521578041
567.0,PL047L1,ÅomÅ¼a,2002,13,55989,56002,0.02321345666226206
568.0,PL048L1,Leszno,2002,196,77376,77572,0.25266848862991803
569.0,PL049L1,Åwidnica,2002,12,47978,47990,0.025005209418628882
570.0,PL051L1,Tczew,2002,16356,10768,27124,60.30084058398466
571.0,PL052L1,EÅk,2002,1548,38504,40052,3.864975531808649
572.0,PL506L2,Bielsko-BiaÅa,2002,5177,68258,73435,7.049771907128753
573.0,PL508L1,Rybnik,2002,461,14420,14881,3.0979100866877225
574.0,PL511L2,WaÅbrzych,2002,33,51477,51510,0.064065230052417
575.0,PL512L2,ElblÄg,2002,16535,79940,96475,17.13915522155999
576.0,PL513L2,WÅocÅawek,2002,26806,95673,122479,21.88620089974608
577.0,PL514L2,TarnÃ³w,2002,161,125166,125327,0.1284639383373096
578.0,PL516L2,Legnica,2002,237,56263,56500,0.4194690265486726
579.0,PL517L2,GrudziÄdz,2002,1141,53902,55043,2.0729248042439545
580.0,PT001L3,Lisboa,2002,7677,431604,439281,1.7476285111352414
581.0,PT002L2,Porto,2002,1586,94154,95740,1.65656987674953
582.0,PT003L1,Braga,2002,198,49151,49349,0.4012239356420596
583.0,PT004L2,Funchal,2002,35962,0,35962,100.0
584.0,PT005L2,Coimbra,2002,736,162051,162787,0.4521245554006155
585.0,PT007L1,Ponta Delgada,2002,55294,0,55294,100.0
586.0,PT008L2,Aveiro,2002,2377,40953,43330,5.485806600507731
587.0,PT009L1,Faro,2002,2603,46547,49150,5.296032553407935
588.0,PT014L1,Viseu,2002,17,70857,70874,0.023986229082597284
589.0,PT016L0,Viana do Castelo,2002,445,31807,32252,1.3797593947662161
590.0,PT019L0,PÃ³voa de Varzim,2002,74,8332,8406,0.8803235783963836
591.0,PT505L1,GuimarÃ£es,2002,32,26509,26541,0.12056817753664142
592.0,RO001L1,BucureÅti,2002,1942,105900,107842,1.8007826264349696
593.0,RO002L1,Cluj-Napoca,2002,2,59300,59302,0.0033725675356649017
594.0,RO003L1,TimiÅoara,2002,16,23638,23654,0.06764183647586032
595.0,RO004L1,Craiova,2002,672,33724,34396,1.953715548319572
596.0,RO005L1,BrÄila,2002,1896,21633,23529,8.058141017467806
597.0,RO006L1,Oradea,2002,13,20326,20339,0.06391661340282216
598.0,RO007L1,BacÄu,2002,265,21828,22093,1.1994749468157335
599.0,RO008L1,Arad,2002,57,51551,51608,0.11044799255929313
600.0,RO009L1,Sibiu,2002,9237,47103,56340,16.395101171458997
601.0,RO010L1,TÃ¢rgu MureÅ,2002,2697,11043,13740,19.62882096069869
602.0,RO011L1,Piatra NeamÅ£,2002,172,14827,14999,1.146743116207747
603.0,RO012L1,CÇlÇraÅi,2002,684,23860,24544,2.786831812255541
604.0,RO013L1,Giurgiu,2002,621,10329,10950,5.671232876712329
605.0,RO014L1,Alba Iulia,2002,0,26002,26002,0.0
606.0,RO015L1,FocÅani,2002,6098,21004,27102,22.500184488229653
607.0,RO016L1,TÃ¢rgu Jiu,2002,27,24495,24522,0.1101052116466846
608.0,RO017L1,Tulcea,2002,1498,39449,40947,3.6583876718685127
609.0,RO018L1,TÃ¢rgoviÅte,2002,83,20174,20257,0.4097349064520906
610.0,RO019L1,Slatina,2002,426,6697,7123,5.980626140671066
611.0,RO020L1,BÃ¢rlad,2002,3270,23049,26319,12.424484212926023
612.0,RO021L1,Roman,2002,51,14339,14390,0.354412786657401
613.0,RO022L1,BistriÅ£a,2002,67,42564,42631,0.15716262813445614
614.0,RO501L1,Constanta,2002,6372,52979,59351,10.736129130090479
615.0,RO502L1,Iasi,2002,277,79659,79936,0.34652722177742196
616.0,RO503L1,Galati,2002,2934,38298,41232,7.1158323632130385
617.0,RO504L1,Brasov,2002,28229,70274,98503,28.658010415926416
618.0,RO505L1,Ploiesti,2002,39,34298,34337,0.1135801030957859
619.0,RO506L1,Pitesti,2002,168,24716,24884,0.6751326153351551
620.0,RO507L1,Baia Mare,2002,10691,41850,52541,20.34791876820007
621.0,RO508L1,Buzau,2002,78,38462,38540,0.2023871302542813
622.0,RO509L1,Satu Mare,2002,53,70791,70844,0.0748122635650161
623.0,RO510L1,Botosani,2002,653,36687,37340,1.7487948580610604
624.0,RO511L1,Ramnicu Valcea,2002,207,28966,29173,0.7095602097830185
625.0,RO512L1,Suceava,2002,2238,37440,39678,5.640405262362014
626.0,RO513L1,Drobeta-Turnu Severin,2002,2340,30594,32934,7.105119329568227
627.0,RS001L1,Beograd,2002,6685,306339,313024,2.135618994070742
628.0,RS002L1,Novi Sad,2002,2373,187070,189443,1.2526195214391664
629.0,RS003L1,NiÅ¡,2002,7748,333816,341564,2.2683889402864468
630.0,RS004L1,Kragujevac,2002,440,143635,144075,0.3053964948811383
631.0,RS005L1,Subotica,2002,167,160125,160292,0.10418486262570809
632.0,RS006L1,Novi Pazar,2002,24,140767,140791,0.017046544168306213
633.0,RS008L1,Zrenjanin,2002,871,184260,185131,0.47047766176383204
634.0,RS009L1,Kraljevo,2002,4,176508,176512,0.0022661348803480782
635.0,RS011L0,ÄaÄak,2002,10,63677,63687,0.01570179157441864
636.0,RS012L1,KruÅ¡evac,2002,10,122639,122649,0.008153348172427008
637.0,RS013L1,Leskovac,2002,7402,158880,166282,4.451474001996608
638.0,RS014L1,Valjevo,2002,1,141661,141662,0.0007059056063023252
639.0,RS015L1,Vranje,2002,6368,188988,195356,3.2596900018427895
640.0,RS016L1,Smederevo,2002,2599,157625,160224,1.6221040543239467
641.0,SE001L1,Stockholm,2002,89100,666626,755726,11.789987376377152
642.0,SE002L1,GÃ¶teborg,2002,66991,368268,435259,15.391066008973967
643.0,SE003L1,MalmÃ¶,2002,50061,137955,188016,26.62592545315292
644.0,SE004L1,JÃ¶nkÃ¶ping,2002,103196,243995,347191,29.723120703013617
645.0,SE005L1,UmeÃ¥,2002,322561,665688,988249,32.63964850963674
646.0,SE006L1,Uppsala,2002,23425,674102,697527,3.3582929406316886
647.0,SE007L1,LinkÃ¶ping,2002,40125,383071,423196,9.481422319681661
648.0,SE008L1,Ãrebro,2002,34074,334523,368597,9.244242356828732
649.0,SE501L1,VÃ¤sterÃ¥s,2002,23880,266535,290415,8.222715768813595
650.0,SE502L1,NorrkÃ¶ping,2002,25831,285907,311738,8.286124886924275
651.0,SE503L1,Helsingborg,2002,1751,112671,114422,1.5303001171103459
652.0,SE505L1,BorÃ¥s,2002,18717,78645,97362,19.22413261847538
653.0,SI001L2,Ljubljana,2002,1338,231949,233287,0.5735424605743141
654.0,SI002L1,Maribor,2002,5021,211964,216985,2.3139848376615895
655.0,SK001L1,Bratislava,2002,1792,203149,204941,0.8743979974724432
656.0,SK002L1,KoÅ¡ice,2002,72,177562,177634,0.04053278088654199
657.0,SK003L1,BanskÃ¡ Bystrica,2002,2260,78620,80880,2.794263105835806
658.0,SK004L1,Nitra,2002,28,87099,87127,0.032136995420478154
659.0,SK005L1,PreÅ¡ov,2002,0,93299,93299,0.0
660.0,SK006L1,Å½ilina,2002,5797,75651,81448,7.117424614477949
661.0,SK007L1,Trnava,2002,955,73265,74220,1.2867151711129077
662.0,SK008L1,TrenÄÃ­n,2002,5016,62407,67423,7.439597763374516
739.0,UK001L3,London,2002,2746,695424,698170,0.39331394932466307
740.0,UK002L3,West Midlands urban area,2002,111432,103877,215309,51.75445522481643
741.0,UK003L2,Leeds,2002,97292,415135,512427,18.986509297909752
742.0,UK004L1,Glasgow,2002,227522,110162,337684,67.37719287854918
743.0,UK006L3,Liverpool,2002,11541,88962,100503,11.483239306289365
744.0,UK007L1,Edinburgh,2002,101754,73664,175418,58.006589973662905
745.0,UK008L3,Greater Manchester,2002,56213,256033,312246,18.00279266988208
746.0,UK009L1,Cardiff,2002,11548,72943,84491,13.667727923684177
747.0,UK010L3,Sheffield,2002,48669,77418,126087,38.599538413952274
748.0,UK011L2,Bristol,2002,21752,76633,98385,22.10906134065152
749.0,UK012L2,Belfast,2002,152453,42692,195145,78.12293422839427
750.0,UK013L2,Newcastle upon Tyne,2002,90542,456166,546708,16.56130877909231
751.0,UK014L1,Leicester,2002,49576,90205,139781,35.4669089504296
752.0,UK016L1,Aberdeen,2002,44066,609882,653948,6.738456268694147
753.0,UK017L2,Cambridge,2002,160,159459,159619,0.10023869338863169
754.0,UK018L3,Exeter,2002,59769,187957,247726,24.12705973535277
755.0,UK019L3,Lincoln,2002,83453,128090,211543,39.449662716327175
756.0,UK023L1,Portsmouth,2002,602,20251,20853,2.8868747901980534
757.0,UK024L1,Worcester,2002,15038,46164,61202,24.571092447959217
758.0,UK025L3,Coventry,2002,14462,66985,81447,17.756332338821565
759.0,UK026L1,Kingston upon Hull,2002,47299,204399,251698,18.79196497389729
760.0,UK027L1,Stoke-on-Trent,2002,40122,48054,88176,45.50217746325531
761.0,UK029L1,Nottingham,2002,61419,28870,90289,68.02489782808537
762.0,UK033L1,Guildford,2002,11,61680,61691,0.017830801899790895
763.0,UK050L1,Burnley,2002,9065,18909,27974,32.4050904411239
764.0,UK056L1,Hastings,2002,68,54682,54750,0.12420091324200913
765.0,UK515L1,Brighton and Hove,2002,377,42030,42407,0.8890041738392246
766.0,UK516L1,Plymouth,2002,21967,193808,215775,10.180512107519407
767.0,UK517L1,Swansea,2002,14566,69476,84042,17.331810285333525
768.0,UK518L1,Derby,2002,37740,30362,68102,55.41687468796804
769.0,UK520L2,Southampton,2002,2257,151095,153352,1.4717773488444885
770.0,UK528L1,Northampton,2002,31267,123278,154545,20.231647740140414
771.0,UK539L1,Bournemouth,2002,2015,91778,93793,2.148347957736718
772.0,UK546L1,Colchester,2002,796,68699,69495,1.1454061443269299
773.0,UK550L0,Dundee City,2002,11218,215198,226416,4.954596848279273
774.0,UK551L1,Falkirk,2002,10957,18832,29789,36.78203363657726
775.0,UK552L0,Reading,2002,41,21880,21921,0.18703526298982712
776.0,UK553L1,Blackpool,2002,8683,40272,48955,17.73669696660198
777.0,UK557L1,Blackburn with Darwen,2002,11118,68436,79554,13.975412927068406
778.0,UK558L1,Newport,2002,5259,26441,31700,16.589905362776026
779.0,UK559L2,Middlesbrough,2002,2167,59602,61769,3.5082322848030567
780.0,UK560L1,Oxford,2002,65853,127070,192923,34.13434375372558
781.0,UK562L2,Preston,2002,1052,24710,25762,4.0835338871205655
782.0,UK566L1,Norwich,2002,71,150169,150240,0.04725772097976571
783.0,UK568L1,Cheshire West and Chester,2002,9143,127002,136145,6.715634066620148
784.0,UK569L2,Ipswich,2002,1602,154044,155646,1.0292587024401527
785.0,UK571L1,Cheltenham,2002,14862,31321,46183,32.1806725418444
786.0,XK001L1,Pristina,2002,524,255283,255807,0.20484193161250472
787.0,XK002L1,Prizren,2002,2197,125436,127633,1.7213416592887418
788.0,XK003L1,MitrovicÃ«,2002,50,117864,117914,0.04240378580999712
1.0,AL001L1,Tirana,2003,1638,165483,167121,0.9801281706069256
2.0,AL003L1,Elbasan,2003,606,125398,126004,0.4809371131075204
3.0,AL004L1,ShkodÃ«r,2003,5025,180304,185329,2.711394331162419
4.0,AL005L0,VlorÃ«,2003,2274,61459,63733,3.5680102929408624
5.0,AT001L3,Wien,2003,4280,914210,918490,0.465982209931518
6.0,AT002L3,Graz,2003,48,291084,291132,0.016487366555376942
7.0,AT003L3,Linz,2003,2115,357115,359230,0.5887592907051192
8.0,AT004L3,Salzburg,2003,2063,135413,137476,1.500625563734761
9.0,AT005L3,Innsbruck,2003,10387,202435,212822,4.88060444878819
10.0,AT006L2,Klagenfurt,2003,953,182307,183260,0.5200261922950999
11.0,BA001L1,Sarajevo,2003,4,263770,263774,0.0015164496879904767
12.0,BA002L1,Banja Luka,2003,4,275298,275302,0.0014529498514358778
13.0,BA003L1,Mostar,2003,1513,180834,182347,0.829736710776706
14.0,BA004L1,Tuzla,2003,713,111548,112261,0.6351270699530559
15.0,BA005L1,Zenica,2003,26,86690,86716,0.029982932792102956
16.0,BE001L2,Bruxelles / Brussel,2003,318,326333,326651,0.09735160767914379
17.0,BE002L2,Antwerpen,2003,5541,113671,119212,4.648022011206925
18.0,BE003L2,Gent,2003,560,101281,101841,0.5498767686884457
19.0,BE004L2,Charleroi,2003,149,109616,109765,0.13574454516466997
20.0,BE005L2,LiÃ¨ge,2003,381,141017,141398,0.26945218461364373
21.0,BE006L2,Brugge,2003,1108,55431,56539,1.9597092272590604
22.0,BE007L2,Namur,2003,40,84067,84107,0.047558467190602444
23.0,BE008L1,Leuven,2003,37,45039,45076,0.08208359215547076
24.0,BE009L1,Mons,2003,22,39178,39200,0.05612244897959184
25.0,BE010L1,Kortrijk,2003,5,22334,22339,0.022382380589999553
26.0,BE011L1,Oostende,2003,252,20680,20932,1.2038983374737244
27.0,BG001L2,Sofia,2003,2465,569309,571774,0.43111439135042867
28.0,BG002L2,Plovdiv,2003,405,276681,277086,0.14616400684264091
29.0,BG003L2,Varna,2003,3904,200894,204798,1.9062686159044522
30.0,BG004L2,Burgas,2003,5316,290584,295900,1.7965528894896925
31.0,BG005L1,Pleven,2003,1158,177918,179076,0.6466528177980299
32.0,BG006L2,Ruse,2003,2466,131551,134017,1.8400650663721767
33.0,BG007L2,Vidin,2003,1742,59222,60964,2.857424053539794
34.0,BG008L2,Stara Zagora,2003,51,132017,132068,0.03861647030317715
35.0,BG009L1,Sliven,2003,507,136267,136774,0.37068448681767
36.0,BG010L1,Dobrich,2003,60,140278,140338,0.042753922672405194
37.0,BG011L1,Shumen,2003,581,93926,94507,0.6147692763499
38.0,BG013L1,Yambol,2003,405,130401,130806,0.30961882482454933
39.0,BG014L1,Haskovo,2003,551,73417,73968,0.7449167207441055
40.0,BG015L1,Pazardzhik,2003,34,63788,63822,0.0532731659929178
41.0,BG016L1,Blagoevgrad,2003,15,135464,135479,0.01107182662995741
42.0,BG017L1,Veliko Tarnovo,2003,15,88524,88539,0.016941686714329277
43.0,BG018L1,Vratsa,2003,213,70344,70557,0.30188358348569244
44.0,CH001L2,ZÃ¼rich,2003,15,127702,127717,0.01174471683487711
45.0,CH002L2,GenÃ¨ve,2003,286,53611,53897,0.5306417796908919
46.0,CH003L2,Basel,2003,32,69388,69420,0.04609622587150677
47.0,CH004L2,Bern,2003,69,78219,78288,0.0881361128142244
48.0,CH005L2,Lausanne,2003,101,77404,77505,0.1303141732791433
49.0,CH006L1,Winterthur,2003,0,13291,13291,0.0
50.0,CH007L2,St. Gallen,2003,385,31524,31909,1.2065561440345984
51.0,CH008L2,Luzern,2003,0,29259,29259,0.0
52.0,CH009L2,Lugano,2003,45,30580,30625,0.14693877551020407
53.0,CH010L1,Biel/Bienne,2003,7,9088,9095,0.07696536558548653
54.0,CY001L2,Lefkosia,2003,48,162580,162628,0.029515212632511008
55.0,CY501L2,Lemesos,2003,1282,124617,125899,1.0182765550163226
56.0,CZ001L2,Praha,2003,1703,568859,570562,0.2984776413430968
57.0,CZ002L2,Brno,2003,135,267780,267915,0.05038911595095459
58.0,CZ003L2,Ostrava,2003,663,142003,142666,0.4647217977654101
59.0,CZ004L2,PlzeÅ,2003,2814,193143,195957,1.4360293329659057
60.0,CZ005L2,ÃstÃ­ nad Labem,2003,1460,34451,35911,4.065606638634402
61.0,CZ006L2,Olomouc,2003,36,93528,93564,0.038476337052712584
62.0,CZ007L2,Liberec,2003,6,61310,61316,0.009785374127470806
63.0,CZ008L2,ÄeskÃ© BudÄjovice,2003,1170,128234,129404,0.9041451578003771
64.0,CZ009L2,Hradec KrÃ¡lovÃ©,2003,33,79472,79505,0.041506823470222
65.0,CZ010L2,Pardubice,2003,133,86224,86357,0.15401183459360562
66.0,CZ011L2,ZlÃ­n,2003,24,57928,57952,0.041413583655438985
67.0,CZ013L2,Karlovy Vary,2003,104,46880,46984,0.22135194959986376
68.0,CZ014L2,Jihlava,2003,18,96009,96027,0.018744728045237274
69.0,CZ016L2,Most,2003,180,27598,27778,0.6479948160414717
70.0,CZ018L2,Chomutov-Jirkov,2003,817,44869,45686,1.7882940069167796
71.0,DE001L1,Berlin,2003,18297,1729968,1748265,1.0465804669200607
72.0,DE002L1,Hamburg,2003,15673,718501,734174,2.134780038519479
73.0,DE003L1,MÃ¼nchen,2003,6648,543293,549941,1.2088569501091935
74.0,DE004L1,KÃ¶ln,2003,1163,161467,162630,0.7151202115230892
75.0,DE005L1,Frankfurt am Main,2003,1115,429216,430331,0.2591028766228787
76.0,DE007L1,Stuttgart,2003,139,365031,365170,0.03806446312676288
77.0,DE008L2,Leipzig,2003,3645,394044,397689,0.9165453407059284
78.0,DE009L2,Dresden,2003,5111,578085,583196,0.8763777529338336
79.0,DE011L1,DÃ¼sseldorf,2003,1372,118945,120317,1.1403209853969098
80.0,DE012L1,Bremen,2003,2120,587419,589539,0.3596030118448482
81.0,DE013L1,Hannover,2003,2662,294650,297312,0.8953557205898182
82.0,DE014L1,NÃ¼rnberg,2003,291,293210,293501,0.09914787343143636
83.0,DE017L0,Bielefeld,2003,0,25883,25883,0.0
84.0,DE018L1,Halle an der Saale,2003,1166,156420,157586,0.7399134440876728
85.0,DE019L2,Magdeburg,2003,396,416638,417034,0.09495628653778829
86.0,DE020L1,Wiesbaden,2003,882,100556,101438,0.8694966383406613
87.0,DE021L1,GÃ¶ttingen,2003,91,238866,238957,0.03808216541051319
88.0,DE025L1,Darmstadt,2003,40,78147,78187,0.051159399900239176
89.0,DE026L1,Trier,2003,173,120954,121127,0.14282529906626928
90.0,DE027L1,Freiburg im Breisgau,2003,523,220673,221196,0.2364418886417476
91.0,DE028L1,Regensburg,2003,758,252904,253662,0.29882284299579753
92.0,DE029L0,Frankfurt (Oder),2003,111,14733,14844,0.7477768795472919
93.0,DE030L1,Weimar,2003,28,89000,89028,0.03145077953003549
94.0,DE031L1,Schwerin,2003,9339,480664,490003,1.9059066985304172
95.0,DE032L1,Erfurt,2003,492,285020,285512,0.172322003978817
96.0,DE033L1,Augsburg,2003,43,199891,199934,0.0215070973421229
97.0,DE034L1,Bonn,2003,551,128786,129337,0.4260188499810572
98.0,DE035L1,Karlsruhe,2003,571,125241,125812,0.45385177884462535
99.0,DE036L0,MÃ¶nchengladbach,2003,0,17023,17023,0.0
100.0,DE037L1,Mainz,2003,998,69307,70305,1.4195291942251618
101.0,DE038L1,Ruhrgebiet,2003,2992,440760,443752,0.6742504822513475
102.0,DE039L1,Kiel,2003,10275,329487,339762,3.024175746551998
103.0,DE040L1,SaarbrÃ¼cken,2003,31,153651,153682,0.020171523015057067
104.0,DE042L1,Koblenz,2003,887,91289,92176,0.9622895330671758
105.0,DE043L2,Rostock,2003,4870,356934,361804,1.3460326585665168
106.0,DE044L1,Kaiserslautern,2003,13,135514,135527,0.009592184583145794
107.0,DE045L1,Iserlohn,2003,39,106068,106107,0.03675535073086601
108.0,DE048L1,Wilhelmshaven,2003,997,73050,74047,1.34644212459654
109.0,DE050L1,TÃ¼bingen,2003,10,52015,52025,0.019221528111484865
110.0,DE051L1,Villingen-Schwenningen,2003,26,102534,102560,0.02535101404056162
111.0,DE052L1,Flensburg,2003,1480,203995,205475,0.720282272782577
112.0,DE053L1,Marburg,2003,23,126219,126242,0.01821897625196052
113.0,DE054L1,Konstanz,2003,47,81853,81900,0.057387057387057384
114.0,DE055L0,NeumÃ¼nster,2003,102,7074,7176,1.4214046822742474
115.0,DE056L0,Brandenburg an der Havel,2003,1710,21120,22830,7.490144546649145
116.0,DE057L1,GieÃen,2003,96,85432,85528,0.11224394350388177
117.0,DE058L1,LÃ¼neburg,2003,247,132255,132502,0.18641228056934991
118.0,DE059L1,Bayreuth,2003,8,199912,199920,0.004001600640256103
119.0,DE060L1,Celle,2003,55,154992,155047,0.0354731146039588
120.0,DE061L1,Aschaffenburg,2003,78,147538,147616,0.05283980056362454
121.0,DE062L1,Bamberg,2003,236,121919,122155,0.19319716753305227
122.0,DE063L1,Plauen,2003,204,141084,141288,0.1443859351112621
123.0,DE064L1,Neubrandenburg,2003,25418,558573,583991,4.352464335922985
124.0,DE065L1,Fulda,2003,1,138224,138225,0.0007234581298607343
125.0,DE066L1,Kempten (AllgÃ¤u),2003,310,158857,159167,0.19476399002305753
126.0,DE067L1,Landshut,2003,208,141245,141453,0.1470453083356309
127.0,DE069L1,Rosenheim,2003,57,147706,147763,0.038575286100038575
128.0,DE071L1,Stralsund,2003,20400,317848,338248,6.031077789077837
129.0,DE072L1,Friedrichshafen,2003,81,66538,66619,0.12158693465828067
130.0,DE073L1,Offenburg,2003,244,185640,185884,0.13126465968023068
131.0,DE074L1,GÃ¶rlitz,2003,717,210390,211107,0.3396381929542838
132.0,DE077L1,Schweinfurt,2003,88,201252,201340,0.04370716201450283
133.0,DE078L1,Greifswald,2003,3165,346629,349794,0.9048182644642275
134.0,DE079L1,Wetzlar,2003,52,106438,106490,0.04883087613860456
135.0,DE081L1,Passau,2003,998,159068,160066,0.6234928092161983
136.0,DE082L0,Dessau-RoÃlau,2003,3,24645,24648,0.012171372930866602
137.0,DE083L1,Braunschweig-Salzgitter-Wolfsburg,2003,581,412263,412844,0.14073112362054432
138.0,DE084L1,Mannheim-Ludwigshafen,2003,824,203604,204428,0.4030758995832273
139.0,DE504L1,MÃ¼nster,2003,54,141709,141763,0.03809174467244626
140.0,DE505L0,Chemnitz,2003,4,22189,22193,0.01802370116703465
141.0,DE507L1,Aachen,2003,78,70442,70520,0.1106069200226886
142.0,DE508L0,Krefeld,2003,164,13516,13680,1.198830409356725
143.0,DE510L1,LÃ¼beck,2003,5201,156948,162149,3.2075436789619425
144.0,DE513L1,Kassel,2003,7,139854,139861,0.005004969219439301
145.0,DE516L0,Solingen,2003,0,8954,8954,0.0
146.0,DE517L1,OsnabrÃ¼ck,2003,52,224078,224130,0.023200820952125997
147.0,DE520L1,Oldenburg (Oldenburg),2003,414,189555,189969,0.21793029389005572
148.0,DE522L1,Heidelberg,2003,179,116926,117105,0.1528542760770249
149.0,DE523L1,Paderborn,2003,123,124560,124683,0.09865017684848776
150.0,DE524L2,WÃ¼rzburg,2003,233,305696,305929,0.07616146230007616
151.0,DE527L1,Bremerhaven,2003,1223,213256,214479,0.5702189957991225
152.0,DE529L1,Heilbronn,2003,87,119897,119984,0.07250966795572743
153.0,DE530L0,Remscheid,2003,5,7364,7369,0.06785181164337087
154.0,DE532L1,Ulm,2003,182,199126,199308,0.0913159531980653
155.0,DE533L1,Pforzheim,2003,1,67147,67148,0.001489247632096265
156.0,DE534L1,Ingolstadt,2003,540,284295,284835,0.18958344304597397
157.0,DE535L1,Gera,2003,88,99698,99786,0.08818872386907983
158.0,DE537L1,Reutlingen,2003,4,109278,109282,0.0036602551197818488
159.0,DE539L1,Cottbus,2003,1824,180456,182280,1.000658327847268
160.0,DE540L2,Siegen,2003,29,177535,177564,0.016332139397625643
161.0,DE542L1,Hildesheim,2003,79,120731,120810,0.06539193775349722
162.0,DE544L1,Zwickau,2003,122,94682,94804,0.12868655330998693
163.0,DE546L0,Wuppertal,2003,4,16829,16833,0.023762846789045326
164.0,DE547L2,Jena,2003,0,93068,93068,0.0
165.0,DE548L1,DÃ¼ren,2003,60,93978,94038,0.06380399413003254
166.0,DE549L1,Bocholt,2003,42,142223,142265,0.029522370224580888
167.0,DK001L2,KÃ¸benhavn,2003,13881,277342,291223,4.7664504520590745
168.0,DK002L3,Ãrhus,2003,6182,456342,462524,1.336579291020574
169.0,DK003L2,Odense,2003,7896,351943,359839,2.194314679620608
170.0,DK004L3,Aalborg,2003,3818,616641,620459,0.6153508934514609
171.0,EE001L1,Tallinn,2003,6634,432427,439061,1.51095178118758
172.0,EE002L1,Tartu,2003,1159,298483,299642,0.3867949085909185
173.0,EE003L0,Narva,2003,578,6311,6889,8.390187255044273
174.0,EL001L1,Athina,2003,5312,304075,309387,1.7169435044135661
175.0,EL002L1,Thessaloniki,2003,2442,139677,142119,1.7182783442045046
176.0,EL003L1,Patra,2003,691,50899,51590,1.3394068617949215
177.0,EL004L1,Irakleio,2003,1100,60284,61384,1.791997914766063
178.0,EL005L1,Larisa,2003,117,155402,155519,0.07523196522611385
179.0,EL006L1,Volos,2003,288,30528,30816,0.9345794392523363
180.0,EL007L1,Ioannina,2003,2011,130630,132641,1.5161224659042076
181.0,EL008L1,Kavala,2003,337,35231,35568,0.947480881691408
182.0,EL009L1,Kalamata,2003,270,44182,44452,0.6073967425537659
183.0,ES001L3,Madrid,2003,2735,784868,787603,0.3472561683995617
184.0,ES002L2,Barcelona,2003,1668,262939,264607,0.6303688111047705
185.0,ES003L3,Valencia,2003,3361,171759,175120,1.9192553677478301
186.0,ES004L3,Sevilla,2003,4602,463824,468426,0.9824390618795711
187.0,ES005L2,Zaragoza,2003,178,275960,276138,0.06446052336150765
188.0,ES006L2,MÃ¡laga,2003,1044,151698,152742,0.6835055191106572
189.0,ES007L2,Murcia,2003,132,120004,120136,0.10987547446227608
190.0,ES008L2,Las Palmas,2003,76596,0,76596,100.0
191.0,ES009L2,Valladolid,2003,195,115334,115529,0.1687887889620788
192.0,ES010L2,Palma de Mallorca,2003,2299,201935,204234,1.125669575095234
193.0,ES011L2,Santiago de Compostela,2003,9,126247,126256,0.0071283740970726145
194.0,ES012L2,Vitoria/Gasteiz,2003,1310,158011,159321,0.8222393783619233
195.0,ES013L2,Oviedo,2003,24436,69051,93487,26.13839357343802
196.0,ES014L3,Pamplona/IruÃ±a,2003,136,169378,169514,0.08022936158665361
197.0,ES015L2,Santander,2003,861,68622,69483,1.239152022796943
198.0,ES016L2,Toledo,2003,493,92905,93398,0.5278485620677102
199.0,ES017L2,Badajoz,2003,763,217986,218749,0.34880159452157494
200.0,ES018L2,LogroÃ±o,2003,90,46048,46138,0.19506697299406128
201.0,ES019L3,Bilbao,2003,1735,151586,153321,1.1316127601567951
202.0,ES020L2,CÃ³rdoba,2003,1339,185563,186902,0.7164182298744797
203.0,ES021L2,Alicante/Alacant,2003,472,35586,36058,1.309002163181541
204.0,ES022L2,Vigo,2003,1131,135340,136471,0.8287474994687516
205.0,ES023L2,GijÃ³n,2003,3870,49532,53402,7.246919591026553
206.0,ES025L3,Santa Cruz de Tenerife,2003,66983,0,66983,100.0
207.0,ES026L2,CoruÃ±a (A),2003,780,75195,75975,1.0266535044422507
208.0,ES028L1,Reus,2003,11,11523,11534,0.09537020981446159
209.0,ES031L1,Lugo,2003,76,133935,134011,0.05671176246726015
210.0,ES033L1,Girona,2003,6,39615,39621,0.015143484515787082
211.0,ES034L1,CÃ¡ceres,2003,2338,235935,238273,0.9812274156115044
212.0,ES035L1,Torrevieja,2003,1734,7104,8838,19.619823489477255
213.0,ES039L1,AvilÃ©s,2003,15325,3817,19142,80.05955490544353
214.0,ES040L1,Talavera de la Reina,2003,564,82702,83266,0.6773472966156655
215.0,ES041L1,Palencia,2003,15,28366,28381,0.05285226031499947
216.0,ES043L1,Ferrol,2003,960,46010,46970,2.0438577815626995
217.0,ES044L1,Pontevedra,2003,228,51388,51616,0.4417234965902046
218.0,ES046L1,Gandia,2003,271,17066,17337,1.563130876160812
219.0,ES048L1,Guadalajara,2003,19,45364,45383,0.041865896921754846
220.0,ES050L1,Manresa,2003,4,29599,29603,0.01351214403945546
221.0,ES053L1,Ciudad Real,2003,617,95728,96345,0.6404068711401734
222.0,ES054L1,Benidorm,2003,336,20337,20673,1.6253083732404587
223.0,ES057L1,Ponferrada,2003,247,62096,62343,0.396195242449032
224.0,ES059L1,Zamora,2003,414,33766,34180,1.211234640140433
225.0,ES070L1,Irun,2003,111,7131,7242,1.532725766362883
226.0,ES072L1,Arrecife,2003,58934,0,58934,100.0
227.0,ES501L3,Granada,2003,396,162228,162624,0.2435064935064935
228.0,ES505L1,Elche/Elx,2003,766,38052,38818,1.9733113504044515
229.0,ES506L1,Cartagena,2003,1627,59321,60948,2.669488744503511
230.0,ES508L1,Jerez de la Frontera,2003,212,125894,126106,0.16811254024392178
231.0,ES510L1,Donostia-San SebastiÃ¡n,2003,286,33034,33320,0.8583433373349338
232.0,ES514L1,AlmerÃ­a,2003,778,39952,40730,1.9101399459857598
233.0,ES515L1,Burgos,2003,6,149385,149391,0.004016306203184931
234.0,ES516L1,Salamanca,2003,22,45622,45644,0.04819910612566822
235.0,ES519L1,Albacete,2003,18,245307,245325,0.007337205747477836
236.0,ES520L1,CastellÃ³n/CastellÃ³,2003,543,32251,32794,1.6557906934195281
237.0,ES521L1,Huelva,2003,3985,93435,97420,4.090535824266064
238.0,ES522L1,CÃ¡diz,2003,1242,23591,24833,5.001409414891475
239.0,ES523L1,LeÃ³n,2003,4,118883,118887,0.0033645394366078715
240.0,ES525L1,Tarragona,2003,544,21196,21740,2.5022999080036796
241.0,ES527L1,JaÃ©n,2003,36,99895,99931,0.03602485715143449
242.0,ES528L1,Lleida,2003,130,70545,70675,0.1839405730456314
243.0,ES529L1,Ourense,2003,61,65107,65168,0.09360422293150013
244.0,ES532L1,Algeciras,2003,523,41771,42294,1.236582021090462
245.0,ES533L1,Marbella,2003,611,68594,69205,0.8828841846687379
246.0,ES537L1,Alcoy,2003,0,20529,20529,0.0
247.0,ES538L1,Ãvila,2003,678,52968,53646,1.2638407336986914
248.0,ES542L1,Cuenca,2003,95,164487,164582,0.05772198660849911
249.0,ES543L1,Eivissa,2003,2208,57194,59402,3.717046564088751
250.0,ES544L1,Linares,2003,13,25763,25776,0.05043451272501552
251.0,ES545L1,Lorca,2003,128,182079,182207,0.0702497708650052
252.0,ES546L1,MÃ©rida,2003,1051,127248,128299,0.8191801962602983
253.0,ES547L1,Sagunto,2003,307,15221,15528,1.9770736733642453
254.0,ES550L1,Puerto de la Cruz,2003,27472,0,27472,100.0
255.0,ES552L1,Igualada,2003,3,25423,25426,0.011798945960827499
256.0,FI001L3,Helsinki,2003,20809,470709,491518,4.233619114661112
257.0,FI002L3,Tampere,2003,93405,595238,688643,13.563631664011686
258.0,FI003L4,Turku,2003,23024,443420,466444,4.936069496016671
259.0,FI004L4,Oulu,2003,639613,84208,723821,88.36618445720697
260.0,FI007L2,Lahti,2003,36462,298941,335403,10.871101331830664
261.0,FI008L2,Kuopio,2003,193005,727401,920406,20.96955039406523
262.0,FI009L2,JyvÃ¤skylÃ¤,2003,63289,413653,476942,13.269747684204788
263.0,FR001L1,Paris,2003,1785,1208167,1209952,0.14752651344846737
264.0,FR003L2,Lyon,2003,1743,365488,367231,0.47463313282375397
265.0,FR004L2,Toulouse,2003,1418,523254,524672,0.27026408880214686
266.0,FR006L2,Strasbourg,2003,715,203168,203883,0.3506913278694153
267.0,FR007L2,Bordeaux,2003,4996,550758,555754,0.8989588918838191
268.0,FR008L2,Nantes,2003,1634,314985,316619,0.5160776832723242
269.0,FR009L2,Lille,2003,128,144325,144453,0.08861013616885768
270.0,FR010L2,Montpellier,2003,7236,216682,223918,3.2315401173643927
271.0,FR011L2,Saint-Etienne,2003,37,181018,181055,0.02043577918312115
272.0,FR012L2,Le Havre,2003,1256,75182,76438,1.6431617781731598
273.0,FR013L2,Rennes,2003,260,381877,382137,0.06803842600952015
274.0,FR014L2,Amiens,2003,65,244730,244795,0.026552829918911745
275.0,FR016L2,Nancy,2003,145,283364,283509,0.05114476083651666
276.0,FR017L2,Metz,2003,231,176699,176930,0.13056010851749278
277.0,FR018L2,Reims,2003,185,242966,243151,0.07608440845400595
278.0,FR019L2,OrlÃ©ans,2003,675,291292,291967,0.23119051125640913
279.0,FR020L2,Dijon,2003,189,385572,385761,0.04899406627419568
280.0,FR021L2,Poitiers,2003,50,250392,250442,0.019964702406145934
281.0,FR022L2,Clermont-Ferrand,2003,134,265992,266126,0.05035208886016398
282.0,FR023L2,Caen,2003,4597,221676,226273,2.03161667543189
283.0,FR024L2,Limoges,2003,137,317697,317834,0.043104261973231306
284.0,FR025L2,BesanÃ§on,2003,39,238997,239036,0.01631553406181496
285.0,FR026L2,Grenoble,2003,1172,264676,265848,0.4408534199993982
286.0,FR027L2,Ajaccio,2003,1532,145477,147009,1.042113067907407
289.0,FR032L2,Toulon,2003,2285,104771,107056,2.1343969511283816
290.0,FR034L2,Valenciennes,2003,58,78388,78446,0.07393621089666777
291.0,FR035L2,Tours,2003,244,284604,284848,0.08565972027186429
292.0,FR036L2,Angers,2003,227,231024,231251,0.0981617376789722
293.0,FR037L2,Brest,2003,2647,132347,134994,1.960827888646903
294.0,FR038L2,Le Mans,2003,31,224080,224111,0.013832431250585649
295.0,FR039L1,Avignon,2003,1465,85760,87225,1.6795643450845517
296.0,FR040L2,Mulhouse,2003,42,129724,129766,0.03236595101952745
297.0,FR042L2,Dunkerque,2003,921,90204,91125,1.0106995884773662
298.0,FR043L2,Perpignan,2003,1440,181590,183030,0.7867562694640223
299.0,FR044L2,NÃ®mes,2003,1348,149143,150491,0.8957346286488893
300.0,FR045L2,Pau,2003,6,201753,201759,0.002973845032935334
301.0,FR046L2,Bayonne,2003,1279,101351,102630,1.2462243008866802
302.0,FR047L0,Annemasse,2003,3,7797,7800,0.038461538461538464
303.0,FR048L2,Annecy,2003,1788,117255,119043,1.5019782767571381
304.0,FR049L2,Lorient,2003,634,112548,113182,0.5601597427152727
305.0,FR050L2,MontbÃ©liard,2003,52,123005,123057,0.04225684032602778
306.0,FR051L2,Troyes,2003,1485,259465,260950,0.5690745353515999
307.0,FR052L2,Saint-Nazaire,2003,591,106544,107135,0.5516404536332664
308.0,FR053L2,La Rochelle,2003,474,110866,111340,0.4257230105981678
309.0,FR056L2,AngoulÃªme,2003,17,214275,214292,0.007933100629048215
310.0,FR057L2,Boulogne-sur-Mer,2003,282,68256,68538,0.4114505821588024
311.0,FR058L2,ChambÃ©ry,2003,3252,98437,101689,3.1979860161866083
312.0,FR059L2,Chalon-sur-SaÃ´ne,2003,433,155925,156358,0.2769285869606927
313.0,FR060L2,Chartres,2003,44,161316,161360,0.02726822012890431
314.0,FR061L2,Niort,2003,9,178910,178919,0.00503020920081154
315.0,FR062L2,Calais,2003,78,50152,50230,0.1552856858451125
316.0,FR063L2,BÃ©ziers,2003,472,84671,85143,0.5543614859706611
317.0,FR064L2,Arras,2003,3,107560,107563,0.0027890631536866767
318.0,FR065L2,Bourges,2003,223,250096,250319,0.08908632584821767
319.0,FR066L2,Saint-Brieuc,2003,83,115098,115181,0.07206049608876464
320.0,FR067L2,Quimper,2003,4634,117288,121922,3.800790669444399
321.0,FR068L2,Vannes,2003,807,120227,121034,0.6667547961729762
322.0,FR069L2,Cherbourg,2003,741,89977,90718,0.8168169492272757
323.0,FR073L2,Tarbes,2003,3,104326,104329,0.0028755187915153026
324.0,FR074L2,CompiÃ¨gne,2003,13,98724,98737,0.013166290245804511
325.0,FR076L2,Belfort,2003,121,65498,65619,0.18439781160944238
326.0,FR077L2,Roanne,2003,169,123031,123200,0.13717532467532467
327.0,FR079L2,Saint-Quentin,2003,47,99327,99374,0.04729607341960673
328.0,FR082L2,Beauvais,2003,0,131142,131142,0.0
329.0,FR084L2,Creil,2003,43,29600,29643,0.14505954188172587
330.0,FR086L2,Evreux,2003,49,126521,126570,0.03871375523425773
331.0,FR090L2,ChÃ¢teauroux,2003,114,261063,261177,0.04364856017183749
332.0,FR093L2,Brive-la-Gaillarde,2003,61,132521,132582,0.04600926219245448
333.0,FR096L2,Albi,2003,277,133961,134238,0.2063499158211535
334.0,FR099L2,FrÃ©jus,2003,433,43980,44413,0.9749397698871951
335.0,FR104L2,ChÃ¢lons-en-Champagne,2003,76,152733,152809,0.0497352904606404
336.0,FR203L2,Marseille,2003,3013,422763,425776,0.7076490924805531
337.0,FR205L2,Nice,2003,969,306371,307340,0.3152860024728314
338.0,FR207L2,Lens - LiÃ©vin,2003,47,25261,25308,0.18571202781729096
339.0,FR208L1,HÃ©nin - Carvin,2003,13,11585,11598,0.11208829108466976
340.0,FR209L2,Douai,2003,72,45012,45084,0.15970188980569602
341.0,FR214L1,Valence,2003,154,90807,90961,0.1693033277998263
342.0,FR215L2,Rouen,2003,1588,285538,287126,0.5530672944978859
343.0,FR304L1,Melun,2003,19,44817,44836,0.042376661611205284
344.0,FR324L1,Martigues,2003,1780,18676,20456,8.701603441533047
345.0,FR505L1,Charleville-MÃ©ziÃ¨res,2003,63,135306,135369,0.04653945881257895
346.0,FR506L1,Colmar,2003,51,101934,101985,0.05000735402265039
347.0,FR519L1,Cannes,2003,510,19626,20136,2.532777115613826
348.0,HR001L2,Grad Zagreb,2003,145,505723,505868,0.028663603944111903
349.0,HR002L2,Rijeka,2003,446,106788,107234,0.4159128634574855
350.0,HR003L2,Slavonski Brod,2003,274,97556,97830,0.28007768578145764
351.0,HR004L2,Osijek,2003,1240,171694,172934,0.7170365572993165
352.0,HR005L2,Split,2003,3641,335429,339070,1.0738195652815052
353.0,HR006L1,Pula - Pola,2003,1394,57503,58897,2.366843812078714
354.0,HR007L1,Zadar,2003,2594,153906,156500,1.6575079872204472
355.0,HU001L2,Budapest,2003,6252,632882,639134,0.9781986250144727
356.0,HU002L2,Miskolc,2003,482,164187,164669,0.29270840291736755
357.0,HU003L2,NyÃ­regyhÃ¡za,2003,95,168130,168225,0.05647198692227671
358.0,HU004L2,PÃ©cs,2003,53,185435,185488,0.028573276977486416
359.0,HU005L2,Debrecen,2003,489,201089,201578,0.24258599648771195
360.0,HU006L2,Szeged,2003,617,160316,160933,0.38338936078989394
361.0,HU007L2,GyÃµr,2003,526,204114,204640,0.25703674745895233
362.0,HU008L2,KecskemÃ©t,2003,104,182035,182139,0.05709924837624012
363.0,HU009L2,SzÃ©kesfehÃ©rvÃ¡r,2003,1223,299900,301123,0.4061463255878827
364.0,HU010L1,Szombathely,2003,54,134223,134277,0.04021537567863446
365.0,HU011L1,Szolnok,2003,634,143341,143975,0.44035422816461195
366.0,HU012L1,TatabÃ¡nya,2003,132,69698,69830,0.18903050264929114
367.0,HU013L1,VeszprÃ©m,2003,7162,124158,131320,5.45385318306427
368.0,HU014L1,BÃ©kÃ©scsaba,2003,109,106054,106163,0.10267230579392066
369.0,HU015L1,KaposvÃ¡r,2003,4,145556,145560,0.0027480076944215444
370.0,HU016L1,Eger,2003,88,100490,100578,0.08749428304400564
371.0,HU017L1,DunaÃºjvÃ¡ros,2003,705,60965,61670,1.1431814496513701
372.0,HU018L1,Zalaegerszeg,2003,198,139781,139979,0.14144978889690596
373.0,HU019L1,Sopron,2003,843,79827,80670,1.0449981405727036
374.0,IE001L1,Dublin,2003,55520,648082,703602,7.890824642340415
375.0,IE002L1,Cork,2003,4695,324968,329663,1.4241816643056697
376.0,IE003L1,Limerick,2003,468,155990,156458,0.29912180904779556
377.0,IE004L1,Galway,2003,8861,217422,226283,3.915892930533889
378.0,IE005L1,Waterford,2003,1208,94649,95857,1.2602105219232815
379.0,IS001L1,ReykjavÃ­k,2003,1297230,0,1297230,100.0
380.0,IT001L3,Roma,2003,8968,608248,617216,1.4529759435918705
381.0,IT002L3,Milano,2003,164,383881,384045,0.042703329036961814
382.0,IT003L3,Napoli,2003,3118,149824,152942,2.038681330177453
383.0,IT004L2,Torino,2003,56,170123,170179,0.03290652783245876
384.0,IT005L3,Palermo,2003,1558,148515,150073,1.038161428104989
385.0,IT006L3,Genova,2003,858,119906,120764,0.7104766321089067
386.0,IT007L3,Firenze,2003,120,163651,163771,0.07327304589945717
387.0,IT008L3,Bari,2003,807,112622,113429,0.7114582690493613
388.0,IT009L1,Bologna,2003,135,185122,185257,0.07287174033909649
389.0,IT010L2,Catania,2003,872,60553,61425,1.4196174196174196
390.0,IT011L2,Venezia,2003,1959,65078,67037,2.9222668078822145
391.0,IT012L3,Verona,2003,67,73094,73161,0.09157884665327155
392.0,IT013L3,Cremona,2003,369,60028,60397,0.610957497888968
393.0,IT014L3,Trento,2003,681,97506,98187,0.6935745057899722
394.0,IT015L1,Trieste,2003,394,21243,21637,1.820954845865878
395.0,IT016L3,Perugia,2003,5479,125549,131028,4.1815489818969995
396.0,IT017L3,Ancona,2003,622,43621,44243,1.4058721153628824
397.0,IT019L2,Pescara,2003,279,16164,16443,1.6967706622879035
398.0,IT020L3,Campobasso,2003,517,102318,102835,0.5027471191714883
399.0,IT021L2,Caserta,2003,3,9339,9342,0.03211303789338471
400.0,IT022L2,Taranto,2003,3543,103385,106928,3.313444560825976
401.0,IT023L2,Potenza,2003,88,138367,138455,0.06355855693185511
402.0,IT024L3,Catanzaro,2003,298,89785,90083,0.33080603443491
403.0,IT025L3,Reggio di Calabria,2003,634,47614,48248,1.3140441054551484
404.0,IT026L3,Sassari,2003,2343,150882,153225,1.5291238374938816
405.0,IT027L2,Cagliari,2003,4830,190462,195292,2.473219589128075
406.0,IT028L3,Padova,2003,7,61438,61445,0.01139230205875173
407.0,IT029L3,Brescia,2003,92,60177,60269,0.15264895717533059
408.0,IT030L3,Modena,2003,150,69118,69268,0.21655021077553852
409.0,IT031L3,Foggia,2003,17,89694,89711,0.0189497386050763
410.0,IT032L3,Salerno,2003,354,37485,37839,0.9355426940458258
411.0,IT033L2,Piacenza,2003,212,93915,94127,0.2252276180054607
412.0,IT034L1,Bolzano,2003,520,106236,106756,0.4870920603994155
413.0,IT035L2,Udine,2003,1,71829,71830,0.0013921759710427398
414.0,IT036L2,La Spezia,2003,706,42213,42919,1.6449591090193154
415.0,IT037L1,Lecce,2003,362,61148,61510,0.5885221915135751
416.0,IT038L1,Barletta,2003,236,14861,15097,1.563224481685103
417.0,IT039L2,Pesaro,2003,150,25541,25691,0.5838620528589779
418.0,IT040L2,Como,2003,586,19155,19741,2.968441315029634
419.0,IT041L2,Pisa,2003,529,47524,48053,1.1008677918132064
420.0,IT042L1,Treviso,2003,57,23988,24045,0.23705552089831566
421.0,IT043L2,Varese,2003,625,23039,23664,2.6411426639621363
422.0,IT045L2,Asti,2003,0,54836,54836,0.0
423.0,IT046L2,Pavia,2003,70,36134,36204,0.19334880123743234
424.0,IT047L1,Massa,2003,341,10902,11243,3.0329983100595923
425.0,IT048L2,Cosenza,2003,129,92350,92479,0.13949112771548136
426.0,IT052L1,Savona,2003,238,28467,28705,0.8291238460198571
427.0,IT054L1,Matera,2003,672,77117,77789,0.8638753551273316
428.0,IT056L1,Acireale,2003,52,5936,5988,0.8684034736138945
429.0,IT057L2,Avellino,2003,3,39756,39759,0.007545461404964914
430.0,IT058L2,Pordenone,2003,30,37020,37050,0.08097165991902834
431.0,IT060L1,Lecco,2003,1230,28982,30212,4.0712299748444325
432.0,IT061L0,Altamura,2003,3,42797,42800,0.007009345794392523
433.0,IT064L1,Battipaglia,2003,53,6433,6486,0.8171446191797719
434.0,IT065L0,Bisceglie,2003,97,6847,6944,1.396889400921659
435.0,IT066L1,Carpi,2003,6,20616,20622,0.02909514111143439
436.0,IT067L0,Cerignola,2003,165,58732,58897,0.2801500925344245
437.0,IT068L1,Gallarate,2003,0,5319,5319,0.0
438.0,IT069L1,Gela,2003,413,57482,57895,0.7133603938163918
439.0,IT073L1,Sassuolo,2003,2,24060,24062,0.00831186102568365
440.0,IT501L2,Messina,2003,819,33624,34443,2.377841651424092
441.0,IT502L2,Prato,2003,10,40949,40959,0.024414658561000026
442.0,IT503L3,Parma,2003,300,113207,113507,0.2643008801219308
443.0,IT504L3,Livorno,2003,430,25384,25814,1.6657627643914157
444.0,IT505L3,Reggio nell'Emilia,2003,17,69017,69034,0.02462554683199583
445.0,IT506L2,Ravenna,2003,3414,77775,81189,4.20500314081957
446.0,IT507L2,Ferrara,2003,673,90810,91483,0.7356558049036432
447.0,IT508L3,Rimini,2003,340,32239,32579,1.0436170539304461
448.0,IT509L3,Siracusa,2003,569,33573,34142,1.6665690352059048
449.0,IT511L2,Bergamo,2003,0,18556,18556,0.0
450.0,IT512L3,ForlÃ¬,2003,9,72742,72751,0.012370963973003806
451.0,IT513L3,Latina,2003,533,65960,66493,0.801588137097138
452.0,IT514L2,Vicenza,2003,1,34981,34982,0.0028586130009719286
453.0,IT515L2,Terni,2003,129,102203,102332,0.1260602744009694
454.0,IT516L2,Novara,2003,4,54161,54165,0.007384842610541863
455.0,IT518L1,Alessandria,2003,22,76892,76914,0.028603375198273395
456.0,IT519L1,Arezzo,2003,2,88625,88627,0.002256648651088269
457.0,IT520L1,Grosseto,2003,405,119194,119599,0.3386315939096481
458.0,IT521L1,Brindisi,2003,1004,62983,63987,1.5690687170831576
459.0,IT522L1,Trapani,2003,976,49814,50790,1.9216381177397126
460.0,IT523L1,Ragusa,2003,285,52565,52850,0.5392620624408704
461.0,IT524L0,Andria,2003,5,39875,39880,0.012537612838515547
462.0,IT525L0,Trani,2003,130,10249,10379,1.2525291453897291
463.0,IT526L1,L'Aquila,2003,435,139834,140269,0.31011841533054346
464.0,LT001L1,Vilnius,2003,4449,420120,424569,1.0478862093087342
465.0,LT002L1,Kaunas,2003,1141,160910,162051,0.7040993267551574
466.0,LT003L1,PanevÄÅ¾ys,2003,131,222677,222808,0.05879501633693584
467.0,LT004L0,Alytus,2003,9,3950,3959,0.22733013387218998
468.0,LT501L0,KlaipÄda,2003,83,8840,8923,0.9301804325899362
469.0,LT502L0,Å iauliai,2003,1182,6863,8045,14.692355500310752
470.0,LU001L1,Luxembourg,2003,98,259617,259715,0.03773366959936854
471.0,LV001L1,RÄ«ga,2003,15032,601217,616249,2.4392737351297935
472.0,LV002L2,LiepÄja,2003,3821,268236,272057,1.4044850895216812
473.0,LV003L1,Jelgava,2003,1153,165306,166459,0.6926630581704805
474.0,LV501L1,Daugavpils,2003,2733,256942,259675,1.0524694329450273
475.0,ME001L1,Podgorica,2003,1006,183475,184481,0.5453136095316048
476.0,MK001L1,Skopje,2003,10,224343,224353,0.0044572615476503544
477.0,MK003L1,Bitola,2003,422,119240,119662,0.3526599923116779
478.0,MK004L1,Tetovo,2003,194,105427,105621,0.18367559481542495
479.0,MK005L1,Prilep,2003,56,86775,86831,0.06449309578376387
480.0,MT001L1,Valletta,2003,1085,24871,25956,4.180151024811219
481.0,NL001L3,s' Gravenhage,2003,7934,34773,42707,18.57775072002248
482.0,NL002L3,Amsterdam,2003,81971,250986,332957,24.619094958207814
483.0,NL003L3,Rotterdam,2003,63407,153764,217171,29.19680804527308
484.0,NL004L3,Utrecht,2003,13426,83861,97287,13.800404987305601
485.0,NL005L3,Eindhoven,2003,87,144319,144406,0.060246804149412074
486.0,NL006L3,Tilburg,2003,208,43026,43234,0.4811028357311375
487.0,NL007L3,Groningen,2003,4383,203777,208160,2.1055918524212145
488.0,NL008L3,Enschede,2003,52,84904,84956,0.06120815480954847
489.0,NL009L3,Arnhem,2003,736,55162,55898,1.3166839600701277
490.0,NL010L3,Heerlen,2003,12,33331,33343,0.03598956302672225
491.0,NL012L3,Breda,2003,2622,70748,73370,3.5736677115987465
492.0,NL013L3,Nijmegen,2003,727,39109,39836,1.8249824279546139
493.0,NL014L3,Apeldoorn,2003,54,71070,71124,0.07592373882233845
494.0,NL015L3,Leeuwarden,2003,5189,105734,110923,4.678019887669825
495.0,NL016L3,Sittard-Geleen,2003,18,22894,22912,0.07856145251396648
496.0,NL020L3,Roosendaal,2003,278,24296,24574,1.131276959387971
497.0,NL026L0,Alphen aan den Rijn,2003,3036,10174,13210,22.982588947766843
498.0,NL028L3,Bergen op Zoom,2003,2118,32663,34781,6.089531640838389
499.0,NL030L0,Gouda,2003,467,1321,1788,26.11856823266219
500.0,NL032L3,MiddelburgÂ Â Â Â Â Â ,2003,7515,15873,23388,32.13186249358645
501.0,NL503L3,s-Hertogenbosch,2003,544,36315,36859,1.4758946254646084
502.0,NL504L3,Amersfoort,2003,3080,9164,12244,25.15517804639007
503.0,NL505L3,Maastricht,2003,62,20323,20385,0.3041452048074565
504.0,NL507L3,Leiden,2003,1349,18432,19781,6.8196754461351805
505.0,NL511L3,Zwolle,2003,1392,121628,123020,1.1315233295399123
506.0,NL512L3,Ede,2003,23,35242,35265,0.06522047355735149
507.0,NL513L3,Deventer,2003,76,25169,25245,0.3010497128144187
508.0,NL514L3,Alkmaar,2003,559,47233,47792,1.1696518245731502
509.0,NL515L3,Venlo,2003,204,51032,51236,0.39815754547583726
510.0,NL519L3,Almelo,2003,11,42014,42025,0.026174895895300414
511.0,NL520L3,Lelystad,2003,59316,59526,118842,49.91164739738476
512.0,NL521L3,Oss,2003,130,33016,33146,0.3922041875339407
513.0,NL522L3,Assen,2003,1218,69644,70862,1.71883378961926
514.0,NL524L3,Veenendaal,2003,9,8176,8185,0.10995723885155771
515.0,NL529L3,Soest,2003,566,7376,7942,7.1266683455049105
516.0,NO001L1,Oslo,2003,31221,715422,746643,4.181516467709468
517.0,NO002L1,Bergen,2003,18910,338833,357743,5.285917544158796
518.0,NO003L1,Trondheim,2003,18505,654751,673256,2.7485830055729172
519.0,NO004L1,Stavanger,2003,17435,271642,289077,6.031265026273277
520.0,NO005L1,Kristiansand,2003,11912,303550,315462,3.7760490962461404
521.0,NO006L1,TromsÃ¸,2003,374613,0,374613,100.0
522.0,PL001L2,Warszawa,2003,3796,857447,861243,0.4407582993417653
523.0,PL002L2,ÅÃ³dÅº,2003,530,168970,169500,0.31268436578171094
524.0,PL003L2,KrakÃ³w,2003,2158,373590,375748,0.5743210875373921
525.0,PL004L2,WrocÅaw,2003,553,264147,264700,0.20891575368341517
526.0,PL005L2,PoznaÅ,2003,379,308949,309328,0.12252366420110691
527.0,PL006L2,GdaÅsk,2003,1164,262352,263516,0.441718908908757
528.0,PL007L2,Szczecin,2003,4305,108755,113060,3.807712718910313
529.0,PL008L2,Bydgoszcz,2003,500,209636,210136,0.2379411428788975
530.0,PL009L2,Lublin,2003,153,322631,322784,0.04740011896500446
531.0,PL010L2,Katowice,2003,2798,391797,394595,0.7090814632724692
532.0,PL011L2,BiaÅystok,2003,64,223258,223322,0.028658170713140665
533.0,PL012L2,Kielce,2003,1310,222919,224229,0.5842241636897992
534.0,PL013L2,ToruÅ,2003,211,158722,158933,0.13276034555441601
535.0,PL014L2,Olsztyn,2003,7322,195222,202544,3.6150169839639785
536.0,PL015L2,RzeszÃ³w,2003,53,229296,229349,0.023108886456884484
537.0,PL016L2,Opole,2003,1326,175290,176616,0.7507813561625221
538.0,PL017L2,GorzÃ³w Wielkopolski,2003,179,97241,97420,0.18374050502976802
539.0,PL018L2,Zielona GÃ³ra,2003,35,169249,169284,0.020675314855509084
540.0,PL019L2,Jelenia GÃ³ra,2003,88,83253,83341,0.10559028569371617
541.0,PL020L2,Nowy SÄcz,2003,176,130242,130418,0.13495069698967935
542.0,PL021L2,SuwaÅki,2003,2399,69734,72133,3.3258009510210305
543.0,PL022L2,Konin,2003,860,117303,118163,0.7278081971513926
544.0,PL024L2,CzÄstochowa,2003,37,193861,193898,0.019082197856605018
545.0,PL025L2,Radom,2003,21,68001,68022,0.030872364823145454
546.0,PL026L2,PÅock,2003,2127,168948,171075,1.243314335817624
547.0,PL027L2,Kalisz,2003,148,148875,149023,0.09931352878414743
548.0,PL028L2,Koszalin,2003,110,129561,129671,0.08483006994624859
549.0,PL029L1,SÅupsk,2003,7872,227132,235004,3.3497302173580024
550.0,PL030L1,JastrzÄbie-ZdrÃ³j,2003,10,29561,29571,0.03381691522099354
551.0,PL031L1,Siedlce,2003,5,126164,126169,0.0039629385982293585
552.0,PL032L1,PiotrkÃ³w Trybunalski,2003,262,116660,116922,0.22408101127247226
553.0,PL033L1,Lubin,2003,250,93056,93306,0.2679356097142735
554.0,PL034L1,PiÅa,2003,157,52035,52192,0.30081238503985286
555.0,PL035L1,InowrocÅaw,2003,3,20125,20128,0.014904610492845785
556.0,PL036L1,Ostrowiec ÅwiÄtokrzyski,2003,2,61458,61460,0.003254149040026033
557.0,PL037L1,Gniezno,2003,69,66502,66571,0.10364873593606824
558.0,PL038L1,Stargard SzczeciÅski,2003,4446,32218,36664,12.126336460833516
559.0,PL039L1,OstrÃ³w Wielkopolski,2003,28,84733,84761,0.03303406047592643
560.0,PL040L1,PrzemyÅl,2003,487,84602,85089,0.5723419008332451
561.0,PL041L1,ZamoÅÄ,2003,83,112624,112707,0.07364227598995626
562.0,PL042L1,CheÅm,2003,171,46399,46570,0.36718917758213443
563.0,PL043L1,Pabianice,2003,1,32958,32959,0.0030340726356988985
564.0,PL044L1,GÅogÃ³w,2003,7,64074,64081,0.010923674724177213
565.0,PL045L1,Stalowa Wola,2003,306,190007,190313,0.1607877549090183
566.0,PL046L1,TomaszÃ³w Mazowiecki,2003,482,18681,19163,2.515263789594531
567.0,PL047L1,ÅomÅ¼a,2003,1,56001,56002,0.001785650512481697
568.0,PL048L1,Leszno,2003,46,77526,77572,0.059299747331511374
569.0,PL049L1,Åwidnica,2003,1,47989,47990,0.002083767451552407
570.0,PL051L1,Tczew,2003,22,27102,27124,0.08110898097625718
571.0,PL052L1,EÅk,2003,1577,38475,40052,3.937381404174573
572.0,PL506L2,Bielsko-BiaÅa,2003,158,73277,73435,0.21515626063866003
573.0,PL508L1,Rybnik,2003,313,14568,14881,2.1033532692695385
574.0,PL511L2,WaÅbrzych,2003,15,51495,51510,0.029120559114735003
575.0,PL512L2,ElblÄg,2003,5941,90534,96475,6.1580720393884425
576.0,PL513L2,WÅocÅawek,2003,1693,120786,122479,1.3822777782313702
577.0,PL514L2,TarnÃ³w,2003,180,125147,125327,0.1436242788864331
578.0,PL516L2,Legnica,2003,22,56478,56500,0.03893805309734513
579.0,PL517L2,GrudziÄdz,2003,175,54868,55043,0.3179332521846556
580.0,PT001L3,Lisboa,2003,8097,431184,439281,1.843239293299733
581.0,PT002L2,Porto,2003,1137,94603,95740,1.1875913933570086
582.0,PT003L1,Braga,2003,44,49305,49349,0.08916087458712435
583.0,PT004L2,Funchal,2003,35962,0,35962,100.0
584.0,PT005L2,Coimbra,2003,494,162293,162787,0.3034640358259566
585.0,PT007L1,Ponta Delgada,2003,55294,0,55294,100.0
586.0,PT008L2,Aveiro,2003,2089,41241,43330,4.821140087699054
587.0,PT009L1,Faro,2003,2645,46505,49150,5.38148524923703
588.0,PT014L1,Viseu,2003,6,70868,70874,0.008465727911504925
589.0,PT016L0,Viana do Castelo,2003,372,31880,32252,1.1534168423663649
590.0,PT019L0,PÃ³voa de Varzim,2003,51,8355,8406,0.6067094932191293
591.0,PT505L1,GuimarÃ£es,2003,0,26541,26541,0.0
592.0,RO001L1,BucureÅti,2003,677,107165,107842,0.6277702564863412
593.0,RO002L1,Cluj-Napoca,2003,46,59256,59302,0.07756905332029274
594.0,RO003L1,TimiÅoara,2003,59,23595,23654,0.24942927200473494
595.0,RO004L1,Craiova,2003,87,34309,34396,0.25293638795208745
596.0,RO005L1,BrÄila,2003,1133,22396,23529,4.815334268349696
597.0,RO006L1,Oradea,2003,67,20272,20339,0.32941639215300655
598.0,RO007L1,BacÄu,2003,175,21918,22093,0.7921060969537862
599.0,RO008L1,Arad,2003,116,51492,51608,0.2247713532785615
600.0,RO009L1,Sibiu,2003,2475,53865,56340,4.39297124600639
601.0,RO010L1,TÃ¢rgu MureÅ,2003,67,13673,13740,0.48762736535662304
602.0,RO011L1,Piatra NeamÅ£,2003,114,14885,14999,0.7600506700446696
603.0,RO012L1,CÇlÇraÅi,2003,529,24015,24544,2.1553129074315516
604.0,RO013L1,Giurgiu,2003,561,10389,10950,5.123287671232877
605.0,RO014L1,Alba Iulia,2003,13,25989,26002,0.049996154141989074
606.0,RO015L1,FocÅani,2003,2,27100,27102,0.007379529186037931
607.0,RO016L1,TÃ¢rgu Jiu,2003,13,24509,24522,0.05301362042247778
608.0,RO017L1,Tulcea,2003,1445,39502,40947,3.528952059979974
609.0,RO018L1,TÃ¢rgoviÅte,2003,15,20242,20257,0.07404847706965494
610.0,RO019L1,Slatina,2003,393,6730,7123,5.517338200196546
611.0,RO020L1,BÃ¢rlad,2003,94,26225,26319,0.35715642691591626
612.0,RO021L1,Roman,2003,2,14388,14390,0.01389854065323141
613.0,RO022L1,BistriÅ£a,2003,142,42489,42631,0.3330909432103399
614.0,RO501L1,Constanta,2003,4803,54548,59351,8.092534245421307
615.0,RO502L1,Iasi,2003,136,79800,79936,0.1701361088871097
616.0,RO503L1,Galati,2003,1677,39555,41232,4.067229336437718
617.0,RO504L1,Brasov,2003,12674,85829,98503,12.866613199597982
618.0,RO505L1,Ploiesti,2003,6,34331,34337,0.01747386201473629
619.0,RO506L1,Pitesti,2003,58,24826,24884,0.2330814981514226
620.0,RO507L1,Baia Mare,2003,91,52450,52541,0.17319807388515637
621.0,RO508L1,Buzau,2003,4,38536,38540,0.010378827192527244
622.0,RO509L1,Satu Mare,2003,6,70838,70844,0.008469312856416916
623.0,RO510L1,Botosani,2003,124,37216,37340,0.33208355650776644
624.0,RO511L1,Ramnicu Valcea,2003,215,28958,29173,0.7369828265862269
625.0,RO512L1,Suceava,2003,74,39604,39678,0.18650133575281014
626.0,RO513L1,Drobeta-Turnu Severin,2003,2124,30810,32934,6.449262160685007
627.0,RS001L1,Beograd,2003,5904,307120,313024,1.8861173584134125
628.0,RS002L1,Novi Sad,2003,2232,187211,189443,1.1781908014547913
629.0,RS003L1,NiÅ¡,2003,35,341529,341564,0.01024698153201157
630.0,RS004L1,Kragujevac,2003,384,143691,144075,0.2665278500780843
631.0,RS005L1,Subotica,2003,93,160199,160292,0.05801911511491528
632.0,RS006L1,Novi Pazar,2003,0,140791,140791,0.0
633.0,RS008L1,Zrenjanin,2003,775,184356,185131,0.4186224889402639
634.0,RS009L1,Kraljevo,2003,1,176511,176512,0.0005665337200870196
635.0,RS011L0,ÄaÄak,2003,0,63687,63687,0.0
636.0,RS012L1,KruÅ¡evac,2003,0,122649,122649,0.0
637.0,RS013L1,Leskovac,2003,33,166249,166282,0.019845804115899496
638.0,RS014L1,Valjevo,2003,3,141659,141662,0.0021177168189069756
639.0,RS015L1,Vranje,2003,7,195349,195356,0.0035832019492618604
640.0,RS016L1,Smederevo,2003,1327,158897,160224,0.8282154983023766
641.0,SE001L1,Stockholm,2003,69929,685797,755726,9.253221405641728
642.0,SE002L1,GÃ¶teborg,2003,18860,416399,435259,4.333052274622696
643.0,SE003L1,MalmÃ¶,2003,3709,184307,188016,1.9727044506850482
644.0,SE004L1,JÃ¶nkÃ¶ping,2003,49523,297668,347191,14.263906610482415
645.0,SE005L1,UmeÃ¥,2003,35504,952745,988249,3.592616840492629
646.0,SE006L1,Uppsala,2003,16083,681444,697527,2.3057171980439466
647.0,SE007L1,LinkÃ¶ping,2003,21649,401547,423196,5.115596555733041
648.0,SE008L1,Ãrebro,2003,25140,343457,368597,6.8204570303068115
649.0,SE501L1,VÃ¤sterÃ¥s,2003,19832,270583,290415,6.828848372157085
650.0,SE502L1,NorrkÃ¶ping,2003,16878,294860,311738,5.414161892358327
651.0,SE503L1,Helsingborg,2003,1119,113303,114422,0.9779587841499012
652.0,SE505L1,BorÃ¥s,2003,1368,95994,97362,1.4050656313551488
653.0,SI001L2,Ljubljana,2003,468,232819,233287,0.20061126423675557
654.0,SI002L1,Maribor,2003,486,216499,216985,0.22397861603336636
655.0,SK001L1,Bratislava,2003,1898,203043,204941,0.9261202004479339
656.0,SK002L1,KoÅ¡ice,2003,261,177373,177634,0.14693133071371473
657.0,SK003L1,BanskÃ¡ Bystrica,2003,1237,79643,80880,1.5294263105835806
658.0,SK004L1,Nitra,2003,11,87116,87127,0.01262524820090213
659.0,SK005L1,PreÅ¡ov,2003,5,93294,93299,0.0053591142455974876
660.0,SK006L1,Å½ilina,2003,182,81266,81448,0.22345545624201943
661.0,SK007L1,Trnava,2003,93,74127,74220,0.12530315278900567
662.0,SK008L1,TrenÄÃ­n,2003,44,67379,67423,0.06525962950328523
739.0,UK001L3,London,2003,2561,695609,698170,0.36681610496011
740.0,UK002L3,West Midlands urban area,2003,15601,199708,215309,7.245865244834168
741.0,UK003L2,Leeds,2003,1180,511247,512427,0.23027670282791501
742.0,UK004L1,Glasgow,2003,153040,184644,337684,45.32047713246704
743.0,UK006L3,Liverpool,2003,1145,99358,100503,1.1392694745430485
744.0,UK007L1,Edinburgh,2003,38547,136871,175418,21.974369791013466
745.0,UK008L3,Greater Manchester,2003,1795,310451,312246,0.5748672521025089
746.0,UK009L1,Cardiff,2003,4334,80157,84491,5.129540424423904
747.0,UK010L3,Sheffield,2003,209,125878,126087,0.16575856353152982
748.0,UK011L2,Bristol,2003,30730,67655,98385,31.234436143721094
749.0,UK012L2,Belfast,2003,28113,167032,195145,14.406210766353226
750.0,UK013L2,Newcastle upon Tyne,2003,2544,544164,546708,0.4653306701200641
751.0,UK014L1,Leicester,2003,120,139661,139781,0.08584857741753171
752.0,UK016L1,Aberdeen,2003,29769,624179,653948,4.5521968107555955
753.0,UK017L2,Cambridge,2003,88,159531,159619,0.055131281363747425
754.0,UK018L3,Exeter,2003,18401,229325,247726,7.427964767525411
755.0,UK019L3,Lincoln,2003,141,211402,211543,0.06665311544225051
756.0,UK023L1,Portsmouth,2003,445,20408,20853,2.1339855176713183
757.0,UK024L1,Worcester,2003,18822,42380,61202,30.75389693147283
758.0,UK025L3,Coventry,2003,328,81119,81447,0.40271587658231733
759.0,UK026L1,Kingston upon Hull,2003,722,250976,251698,0.28685170323165066
760.0,UK027L1,Stoke-on-Trent,2003,10871,77305,88176,12.328751587733624
761.0,UK029L1,Nottingham,2003,161,90128,90289,0.17831629545127312
762.0,UK033L1,Guildford,2003,7,61684,61691,0.011346873936230567
763.0,UK050L1,Burnley,2003,0,27974,27974,0.0
764.0,UK056L1,Hastings,2003,44,54706,54750,0.08036529680365297
765.0,UK515L1,Brighton and Hove,2003,349,42058,42407,0.8229773386469216
766.0,UK516L1,Plymouth,2003,4076,211699,215775,1.8890047503186191
767.0,UK517L1,Swansea,2003,14554,69488,84042,17.31753171033531
768.0,UK518L1,Derby,2003,158,67944,68102,0.23200493377580686
769.0,UK520L2,Southampton,2003,1272,152080,153352,0.8294642391361051
770.0,UK528L1,Northampton,2003,517,154028,154545,0.3345303956776344
771.0,UK539L1,Bournemouth,2003,1130,92663,93793,1.2047807405669932
772.0,UK546L1,Colchester,2003,1014,68481,69495,1.4590977768184763
773.0,UK550L0,Dundee City,2003,11325,215091,226416,5.00185499258003
774.0,UK551L1,Falkirk,2003,14236,15553,29789,47.78945248245997
775.0,UK552L0,Reading,2003,23,21898,21921,0.10492222070161034
776.0,UK553L1,Blackpool,2003,381,48574,48955,0.7782657542641201
777.0,UK557L1,Blackburn with Darwen,2003,34,79520,79554,0.042738265832013476
778.0,UK558L1,Newport,2003,526,31174,31700,1.6593059936908516
779.0,UK559L2,Middlesbrough,2003,1468,60301,61769,2.3765966747073772
780.0,UK560L1,Oxford,2003,447,192476,192923,0.23169865697713596
781.0,UK562L2,Preston,2003,11,25751,25762,0.04269854824935952
782.0,UK566L1,Norwich,2003,63,150177,150240,0.041932907348242815
783.0,UK568L1,Cheshire West and Chester,2003,959,135186,136145,0.7043960483308237
784.0,UK569L2,Ipswich,2003,1678,153968,155646,1.0780874548655281
785.0,UK571L1,Cheltenham,2003,39,46144,46183,0.08444665786111773
786.0,XK001L1,Pristina,2003,88,255719,255807,0.03440093507996263
787.0,XK002L1,Prizren,2003,4,127629,127633,0.0031339857246950238
788.0,XK003L1,MitrovicÃ«,2003,0,117914,117914,0.0
1.0,AL001L1,Tirana,2004,1693,165428,167121,1.0130384571657662
2.0,AL003L1,Elbasan,2004,844,125160,126004,0.6698200057141044
3.0,AL004L1,ShkodÃ«r,2004,6445,178884,185329,3.4775992963864266
4.0,AL005L0,VlorÃ«,2004,2532,61201,63733,3.972824125649193
5.0,AT001L3,Wien,2004,3179,915311,918490,0.3461115526570785
6.0,AT002L3,Graz,2004,85,291047,291132,0.029196378275146668
7.0,AT003L3,Linz,2004,1699,357531,359230,0.47295604487375775
8.0,AT004L3,Salzburg,2004,1822,135654,137476,1.3253222380633711
9.0,AT005L3,Innsbruck,2004,11663,201159,212822,5.480166524137542
10.0,AT006L2,Klagenfurt,2004,2014,181246,183260,1.0989850485648804
11.0,BA001L1,Sarajevo,2004,5,263769,263774,0.0018955621099880958
12.0,BA002L1,Banja Luka,2004,10,275292,275302,0.003632374628589694
13.0,BA003L1,Mostar,2004,3067,179280,182347,1.681958025084043
14.0,BA004L1,Tuzla,2004,578,111683,112261,0.5148715938749877
15.0,BA005L1,Zenica,2004,3,86713,86716,0.0034595691683195723
16.0,BE001L2,Bruxelles / Brussel,2004,29,326622,326651,0.008877976800928208
17.0,BE002L2,Antwerpen,2004,3676,115536,119212,3.083582189712445
18.0,BE003L2,Gent,2004,110,101731,101841,0.1080115081352304
19.0,BE004L2,Charleroi,2004,81,109684,109765,0.07379401448549174
20.0,BE005L2,LiÃ¨ge,2004,62,141336,141398,0.04384786206311263
21.0,BE006L2,Brugge,2004,651,55888,56539,1.1514176055466139
22.0,BE007L2,Namur,2004,11,84096,84107,0.013078578477415673
23.0,BE008L1,Leuven,2004,0,45076,45076,0.0
24.0,BE009L1,Mons,2004,4,39196,39200,0.010204081632653062
25.0,BE010L1,Kortrijk,2004,38,22301,22339,0.1701060924839966
26.0,BE011L1,Oostende,2004,103,20829,20932,0.4920695585706096
27.0,BG001L2,Sofia,2004,2250,569524,571774,0.393512121922298
28.0,BG002L2,Plovdiv,2004,211,276875,277086,0.07614964307110428
29.0,BG003L2,Varna,2004,3701,201097,204798,1.807146554165568
30.0,BG004L2,Burgas,2004,5405,290495,295900,1.8266306184521797
31.0,BG005L1,Pleven,2004,1124,177952,179076,0.6276664656347025
32.0,BG006L2,Ruse,2004,2479,131538,134017,1.8497653282792483
33.0,BG007L2,Vidin,2004,1773,59191,60964,2.908273735319205
34.0,BG008L2,Stara Zagora,2004,0,132068,132068,0.0
35.0,BG009L1,Sliven,2004,3,136771,136774,0.002193399330282071
36.0,BG010L1,Dobrich,2004,29,140309,140338,0.020664395958329175
37.0,BG011L1,Shumen,2004,39,94468,94507,0.041266784470991566
38.0,BG013L1,Yambol,2004,124,130682,130806,0.09479687476109659
39.0,BG014L1,Haskovo,2004,376,73592,73968,0.5083279255894441
40.0,BG015L1,Pazardzhik,2004,7,63815,63822,0.010968004763247783
41.0,BG016L1,Blagoevgrad,2004,70,135409,135479,0.05166852427313458
42.0,BG017L1,Veliko Tarnovo,2004,4,88535,88539,0.004517783123821141
43.0,BG018L1,Vratsa,2004,62,70495,70557,0.08787221678926257
44.0,CH001L2,ZÃ¼rich,2004,56,127661,127717,0.043846942850207876
45.0,CH002L2,GenÃ¨ve,2004,534,53363,53897,0.9907787075347422
46.0,CH003L2,Basel,2004,50,69370,69420,0.07202535292422932
47.0,CH004L2,Bern,2004,23,78265,78288,0.029378704271408134
48.0,CH005L2,Lausanne,2004,50,77455,77505,0.06451196696987291
49.0,CH006L1,Winterthur,2004,0,13291,13291,0.0
50.0,CH007L2,St. Gallen,2004,84,31825,31909,0.26324861324391235
51.0,CH008L2,Luzern,2004,2,29257,29259,0.006835503605728151
52.0,CH009L2,Lugano,2004,35,30590,30625,0.1142857142857143
53.0,CH010L1,Biel/Bienne,2004,7,9088,9095,0.07696536558548653
54.0,CY001L2,Lefkosia,2004,51,162577,162628,0.031359913422042945
55.0,CY501L2,Lemesos,2004,1244,124655,125899,0.9880936306086625
56.0,CZ001L2,Praha,2004,426,570136,570562,0.07466322678341705
57.0,CZ002L2,Brno,2004,2346,265569,267915,0.8756508594143665
58.0,CZ003L2,Ostrava,2004,812,141854,142666,0.5691615381380286
59.0,CZ004L2,PlzeÅ,2004,185,195772,195957,0.09440846716371448
60.0,CZ005L2,ÃstÃ­ nad Labem,2004,220,35691,35911,0.6126256578764167
61.0,CZ006L2,Olomouc,2004,7,93557,93564,0.007481509982471891
62.0,CZ007L2,Liberec,2004,1,61315,61316,0.0016308956879118011
63.0,CZ008L2,ÄeskÃ© BudÄjovice,2004,483,128921,129404,0.3732496677073352
64.0,CZ009L2,Hradec KrÃ¡lovÃ©,2004,37,79468,79505,0.046537953587824664
65.0,CZ010L2,Pardubice,2004,256,86101,86357,0.2964438319997221
66.0,CZ011L2,ZlÃ­n,2004,10,57942,57952,0.01725565985643291
67.0,CZ013L2,Karlovy Vary,2004,35,46949,46984,0.07449344457687723
68.0,CZ014L2,Jihlava,2004,15,96012,96027,0.015620606704364399
69.0,CZ016L2,Most,2004,91,27687,27778,0.3275973792209662
70.0,CZ018L2,Chomutov-Jirkov,2004,258,45428,45686,0.5647244232368778
71.0,DE001L1,Berlin,2004,13184,1735081,1748265,0.7541190837773449
72.0,DE002L1,Hamburg,2004,10749,723425,734174,1.4640943427579838
73.0,DE003L1,MÃ¼nchen,2004,3062,546879,549941,0.5567870007873571
74.0,DE004L1,KÃ¶ln,2004,558,162072,162630,0.34311012728278917
75.0,DE005L1,Frankfurt am Main,2004,4534,425797,430331,1.0536075718458582
76.0,DE007L1,Stuttgart,2004,24,365146,365170,0.00657228140318208
77.0,DE008L2,Leipzig,2004,1784,395905,397689,0.448591738770748
78.0,DE009L2,Dresden,2004,8354,574842,583196,1.4324515257306292
79.0,DE011L1,DÃ¼sseldorf,2004,272,120045,120317,0.2260694664926818
80.0,DE012L1,Bremen,2004,1480,588059,589539,0.2510436120426299
81.0,DE013L1,Hannover,2004,1961,295351,297312,0.6595764718544829
82.0,DE014L1,NÃ¼rnberg,2004,83,293418,293501,0.028279290360169133
83.0,DE017L0,Bielefeld,2004,2,25881,25883,0.007727079550283971
84.0,DE018L1,Halle an der Saale,2004,42,157544,157586,0.026652113766451335
85.0,DE019L2,Magdeburg,2004,185,416849,417034,0.04436089143810817
86.0,DE020L1,Wiesbaden,2004,772,100666,101438,0.7610560145113271
87.0,DE021L1,GÃ¶ttingen,2004,643,238314,238957,0.2690860698786811
88.0,DE025L1,Darmstadt,2004,50,78137,78187,0.06394924987529896
89.0,DE026L1,Trier,2004,31,121096,121127,0.025592972665054038
90.0,DE027L1,Freiburg im Breisgau,2004,665,220531,221196,0.3006383478905586
91.0,DE028L1,Regensburg,2004,88,253574,253662,0.03469183401534325
92.0,DE029L0,Frankfurt (Oder),2004,49,14795,14844,0.33009970358393964
93.0,DE030L1,Weimar,2004,8,89020,89028,0.008985937008581569
94.0,DE031L1,Schwerin,2004,4994,485009,490003,1.0191774336075492
95.0,DE032L1,Erfurt,2004,187,285325,285512,0.06549637143097313
96.0,DE033L1,Augsburg,2004,5,199929,199934,0.0025008252723398724
97.0,DE034L1,Bonn,2004,198,129139,129337,0.15308844336887356
98.0,DE035L1,Karlsruhe,2004,661,125151,125812,0.5253870854926398
99.0,DE036L0,MÃ¶nchengladbach,2004,0,17023,17023,0.0
100.0,DE037L1,Mainz,2004,846,69459,70305,1.203328355024536
101.0,DE038L1,Ruhrgebiet,2004,954,442798,443752,0.2149849465467198
102.0,DE039L1,Kiel,2004,3948,335814,339762,1.1619898634926802
103.0,DE040L1,SaarbrÃ¼cken,2004,23,153659,153682,0.014965968688590727
104.0,DE042L1,Koblenz,2004,175,92001,92176,0.18985419198055892
105.0,DE043L2,Rostock,2004,2803,359001,361804,0.7747288587190855
106.0,DE044L1,Kaiserslautern,2004,5,135522,135527,0.0036893017627483825
107.0,DE045L1,Iserlohn,2004,65,106042,106107,0.061258917884776685
108.0,DE048L1,Wilhelmshaven,2004,867,73180,74047,1.1708779558928788
109.0,DE050L1,TÃ¼bingen,2004,9,52016,52025,0.017299375300336376
110.0,DE051L1,Villingen-Schwenningen,2004,275,102285,102560,0.26813572542901715
111.0,DE052L1,Flensburg,2004,613,204862,205475,0.29833313055116195
112.0,DE053L1,Marburg,2004,7,126235,126242,0.005544905815814072
113.0,DE054L1,Konstanz,2004,102,81798,81900,0.12454212454212454
114.0,DE055L0,NeumÃ¼nster,2004,33,7143,7176,0.459866220735786
115.0,DE056L0,Brandenburg an der Havel,2004,1876,20954,22830,8.217257993867717
116.0,DE057L1,GieÃen,2004,4,85524,85528,0.004676830979328407
117.0,DE058L1,LÃ¼neburg,2004,81,132421,132502,0.061131152737317174
118.0,DE059L1,Bayreuth,2004,0,199920,199920,0.0
119.0,DE060L1,Celle,2004,591,154456,155047,0.38117474056253914
120.0,DE061L1,Aschaffenburg,2004,615,147001,147616,0.41662150444396273
121.0,DE062L1,Bamberg,2004,12,122143,122155,0.009823584789816217
122.0,DE063L1,Plauen,2004,30,141258,141288,0.021233225751656194
123.0,DE064L1,Neubrandenburg,2004,19833,564158,583991,3.396113981208614
124.0,DE065L1,Fulda,2004,2,138223,138225,0.0014469162597214686
125.0,DE066L1,Kempten (AllgÃ¤u),2004,411,158756,159167,0.2582193545144408
126.0,DE067L1,Landshut,2004,51,141402,141453,0.03605437848614027
127.0,DE069L1,Rosenheim,2004,34,147729,147763,0.02300981977897038
128.0,DE071L1,Stralsund,2004,19278,318970,338248,5.699368510678555
129.0,DE072L1,Friedrichshafen,2004,76,66543,66619,0.11408156832134976
130.0,DE073L1,Offenburg,2004,307,185577,185884,0.16515676443373287
131.0,DE074L1,GÃ¶rlitz,2004,1830,209277,211107,0.8668589862013102
132.0,DE077L1,Schweinfurt,2004,10,201330,201340,0.0049667229561935035
133.0,DE078L1,Greifswald,2004,3371,346423,349794,0.9637100693551062
134.0,DE079L1,Wetzlar,2004,13,106477,106490,0.01220771903465114
135.0,DE081L1,Passau,2004,827,159239,160066,0.5166618769757475
136.0,DE082L0,Dessau-RoÃlau,2004,1,24647,24648,0.004057124310288867
137.0,DE083L1,Braunschweig-Salzgitter-Wolfsburg,2004,396,412448,412844,0.09592000852622298
138.0,DE084L1,Mannheim-Ludwigshafen,2004,553,203875,204428,0.2705108889193261
139.0,DE504L1,MÃ¼nster,2004,5,141758,141763,0.0035270133955968767
140.0,DE505L0,Chemnitz,2004,2,22191,22193,0.009011850583517325
141.0,DE507L1,Aachen,2004,278,70242,70520,0.3942144072603517
142.0,DE508L0,Krefeld,2004,121,13559,13680,0.8845029239766081
143.0,DE510L1,LÃ¼beck,2004,1547,160602,162149,0.9540607712659345
144.0,DE513L1,Kassel,2004,62,139799,139861,0.04432972737217666
145.0,DE516L0,Solingen,2004,0,8954,8954,0.0
146.0,DE517L1,OsnabrÃ¼ck,2004,7,224123,224130,0.003123187435863115
147.0,DE520L1,Oldenburg (Oldenburg),2004,164,189805,189969,0.08632987487432159
148.0,DE522L1,Heidelberg,2004,464,116641,117105,0.39622560949575164
149.0,DE523L1,Paderborn,2004,89,124594,124683,0.07138102227248301
150.0,DE524L2,WÃ¼rzburg,2004,32,305897,305929,0.010459943320182134
151.0,DE527L1,Bremerhaven,2004,1039,213440,214479,0.484429711067284
152.0,DE529L1,Heilbronn,2004,21,119963,119984,0.017502333644485932
153.0,DE530L0,Remscheid,2004,1,7368,7369,0.013570362328674175
154.0,DE532L1,Ulm,2004,56,199252,199308,0.028097216368635478
155.0,DE533L1,Pforzheim,2004,47,67101,67148,0.06999463870852445
156.0,DE534L1,Ingolstadt,2004,357,284478,284835,0.12533572068039392
157.0,DE535L1,Gera,2004,10,99776,99786,0.010021445894213617
158.0,DE537L1,Reutlingen,2004,0,109282,109282,0.0
159.0,DE539L1,Cottbus,2004,1538,180742,182280,0.8437568575817425
160.0,DE540L2,Siegen,2004,41,177523,177564,0.023090266044919015
161.0,DE542L1,Hildesheim,2004,15,120795,120810,0.012416190712689347
162.0,DE544L1,Zwickau,2004,19,94785,94804,0.02004134846630944
163.0,DE546L0,Wuppertal,2004,0,16833,16833,0.0
164.0,DE547L2,Jena,2004,0,93068,93068,0.0
165.0,DE548L1,DÃ¼ren,2004,143,93895,94038,0.1520661860099109
166.0,DE549L1,Bocholt,2004,1,142264,142265,0.0007029135767757355
167.0,DK001L2,KÃ¸benhavn,2004,14036,277187,291223,4.819674270232777
168.0,DK002L3,Ãrhus,2004,5330,457194,462524,1.1523726336363087
169.0,DK003L2,Odense,2004,6938,352901,359839,1.9280845044589385
170.0,DK004L3,Aalborg,2004,2613,617846,620459,0.4211398335748212
171.0,EE001L1,Tallinn,2004,4900,434161,439061,1.1160180476061412
172.0,EE002L1,Tartu,2004,787,298855,299642,0.26264675846510166
173.0,EE003L0,Narva,2004,641,6248,6889,9.304688634054289
174.0,EL001L1,Athina,2004,5236,304151,309387,1.6923788006606613
175.0,EL002L1,Thessaloniki,2004,1719,140400,142119,1.2095497435247926
176.0,EL003L1,Patra,2004,669,50921,51590,1.2967629385539834
177.0,EL004L1,Irakleio,2004,1084,60300,61384,1.7659324905512839
178.0,EL005L1,Larisa,2004,129,155390,155519,0.08294806422366399
179.0,EL006L1,Volos,2004,279,30537,30816,0.9053738317757009
180.0,EL007L1,Ioannina,2004,1994,130647,132641,1.5033059159686673
181.0,EL008L1,Kavala,2004,329,35239,35568,0.9249887539361225
182.0,EL009L1,Kalamata,2004,269,44183,44452,0.6051471249887519
183.0,ES001L3,Madrid,2004,2538,785065,787603,0.3222435668731582
184.0,ES002L2,Barcelona,2004,1484,263123,264607,0.5608317240284649
185.0,ES003L3,Valencia,2004,3295,171825,175120,1.8815669255367748
186.0,ES004L3,Sevilla,2004,4193,464233,468426,0.8951253773274754
187.0,ES005L2,Zaragoza,2004,158,275980,276138,0.05721776792763039
188.0,ES006L2,MÃ¡laga,2004,925,151817,152742,0.6055963651124118
189.0,ES007L2,Murcia,2004,92,120044,120136,0.07657987614037425
190.0,ES008L2,Las Palmas,2004,76596,0,76596,100.0
191.0,ES009L2,Valladolid,2004,190,115339,115529,0.16446087129638445
192.0,ES010L2,Palma de Mallorca,2004,2292,201942,204234,1.1222421340227386
193.0,ES011L2,Santiago de Compostela,2004,4,126252,126256,0.0031681662653656067
194.0,ES012L2,Vitoria/Gasteiz,2004,517,158804,159321,0.3245021058115377
195.0,ES013L2,Oviedo,2004,9,93478,93487,0.009627006963535037
196.0,ES014L3,Pamplona/IruÃ±a,2004,3088,166426,169514,1.8216784454381347
197.0,ES015L2,Santander,2004,522,68961,69483,0.7512628988385648
198.0,ES016L2,Toledo,2004,460,92938,93398,0.49251589969806636
199.0,ES017L2,Badajoz,2004,730,218019,218749,0.3337158112722801
200.0,ES018L2,LogroÃ±o,2004,44,46094,46138,0.09536607568598553
201.0,ES019L3,Bilbao,2004,1117,152204,153321,0.7285368605735679
202.0,ES020L2,CÃ³rdoba,2004,1213,185689,186902,0.6490032209393158
203.0,ES021L2,Alicante/Alacant,2004,450,35608,36058,1.2479893504908757
204.0,ES022L2,Vigo,2004,1105,135366,136471,0.8096958328142976
205.0,ES023L2,GijÃ³n,2004,778,52624,53402,1.4568742743717464
206.0,ES025L3,Santa Cruz de Tenerife,2004,66983,0,66983,100.0
207.0,ES026L2,CoruÃ±a (A),2004,620,75355,75975,0.81605791378743
208.0,ES028L1,Reus,2004,0,11534,11534,0.0
209.0,ES031L1,Lugo,2004,17,133994,134011,0.012685525815045033
210.0,ES033L1,Girona,2004,4,39617,39621,0.010095656343858056
211.0,ES034L1,CÃ¡ceres,2004,1946,236327,238273,0.8167102441317313
212.0,ES035L1,Torrevieja,2004,1731,7107,8838,19.585879158180582
213.0,ES039L1,AvilÃ©s,2004,319,18823,19142,1.6664925295162472
214.0,ES040L1,Talavera de la Reina,2004,554,82712,83266,0.6653375927749622
215.0,ES041L1,Palencia,2004,10,28371,28381,0.035234840209999646
216.0,ES043L1,Ferrol,2004,1023,45947,46970,2.177985948477752
217.0,ES044L1,Pontevedra,2004,222,51394,51616,0.4300991940483571
218.0,ES046L1,Gandia,2004,242,17095,17337,1.3958585683797657
219.0,ES048L1,Guadalajara,2004,14,45369,45383,0.0308485556265562
220.0,ES050L1,Manresa,2004,3,29600,29603,0.010134108029591596
221.0,ES053L1,Ciudad Real,2004,614,95731,96345,0.6372930613939488
222.0,ES054L1,Benidorm,2004,317,20356,20673,1.5334010545155516
223.0,ES057L1,Ponferrada,2004,253,62090,62343,0.405819418378968
224.0,ES059L1,Zamora,2004,320,33860,34180,0.9362200117027502
225.0,ES070L1,Irun,2004,66,7176,7242,0.9113504556752278
226.0,ES072L1,Arrecife,2004,58934,0,58934,100.0
227.0,ES501L3,Granada,2004,472,162152,162624,0.29024006296733573
228.0,ES505L1,Elche/Elx,2004,681,38137,38818,1.754340769745994
229.0,ES506L1,Cartagena,2004,1546,59402,60948,2.536588567303275
230.0,ES508L1,Jerez de la Frontera,2004,160,125946,126106,0.1268773888633372
231.0,ES510L1,Donostia-San SebastiÃ¡n,2004,206,33114,33320,0.6182472989195678
232.0,ES514L1,AlmerÃ­a,2004,751,39979,40730,1.843849742204763
233.0,ES515L1,Burgos,2004,0,149391,149391,0.0
234.0,ES516L1,Salamanca,2004,18,45626,45644,0.03943563228463763
235.0,ES519L1,Albacete,2004,8,245317,245325,0.003260980332212371
236.0,ES520L1,CastellÃ³n/CastellÃ³,2004,455,32339,32794,1.3874489235835823
237.0,ES521L1,Huelva,2004,3915,93505,97420,4.018681995483473
238.0,ES522L1,CÃ¡diz,2004,996,23837,24833,4.010792091169009
239.0,ES523L1,LeÃ³n,2004,4,118883,118887,0.0033645394366078715
240.0,ES525L1,Tarragona,2004,500,21240,21740,2.2999080036798527
241.0,ES527L1,JaÃ©n,2004,31,99900,99931,0.03102140476929081
242.0,ES528L1,Lleida,2004,115,70560,70675,0.16271666077113547
243.0,ES529L1,Ourense,2004,389,64779,65168,0.59691873312055
244.0,ES532L1,Algeciras,2004,444,41850,42294,1.049794297063413
245.0,ES533L1,Marbella,2004,579,68626,69205,0.8366447511017991
246.0,ES537L1,Alcoy,2004,0,20529,20529,0.0
247.0,ES538L1,Ãvila,2004,552,53094,53646,1.028967676993625
248.0,ES542L1,Cuenca,2004,56,164526,164582,0.03402559210606263
249.0,ES543L1,Eivissa,2004,2121,57281,59402,3.5705868489276456
250.0,ES544L1,Linares,2004,13,25763,25776,0.05043451272501552
251.0,ES545L1,Lorca,2004,106,182101,182207,0.05817559149758242
252.0,ES546L1,MÃ©rida,2004,1038,127261,128299,0.809047615336051
253.0,ES547L1,Sagunto,2004,282,15246,15528,1.8160741885625966
254.0,ES550L1,Puerto de la Cruz,2004,27472,0,27472,100.0
255.0,ES552L1,Igualada,2004,8,25418,25426,0.031463855895539995
256.0,FI001L3,Helsinki,2004,23957,467561,491518,4.874083960302573
257.0,FI002L3,Tampere,2004,94858,593785,688643,13.774626330333714
258.0,FI003L4,Turku,2004,19324,447120,466444,4.142833866444846
259.0,FI004L4,Oulu,2004,14042,709779,723821,1.9399823989632796
260.0,FI007L2,Lahti,2004,36036,299367,335403,10.744089945528215
261.0,FI008L2,Kuopio,2004,140733,779673,920406,15.290317533784004
262.0,FI009L2,JyvÃ¤skylÃ¤,2004,78561,398381,476942,16.471814182856615
263.0,FR001L1,Paris,2004,2476,1207476,1209952,0.2046362169738965
264.0,FR003L2,Lyon,2004,778,366453,367231,0.21185575291846276
265.0,FR004L2,Toulouse,2004,551,524121,524672,0.10501799219321786
266.0,FR006L2,Strasbourg,2004,461,203422,203883,0.22611007293398666
267.0,FR007L2,Bordeaux,2004,6332,549422,555754,1.1393530231001485
268.0,FR008L2,Nantes,2004,1834,314785,316619,0.5792450863656319
269.0,FR009L2,Lille,2004,39,144414,144453,0.026998400863948828
270.0,FR010L2,Montpellier,2004,7283,216635,223918,3.2525299439973567
271.0,FR011L2,Saint-Etienne,2004,63,180992,181055,0.034796056446936015
272.0,FR012L2,Le Havre,2004,844,75594,76438,1.104162850938015
273.0,FR013L2,Rennes,2004,200,381937,382137,0.05233725077655396
274.0,FR014L2,Amiens,2004,126,244669,244795,0.05147163953512122
275.0,FR016L2,Nancy,2004,101,283408,283509,0.03562497134129781
276.0,FR017L2,Metz,2004,50,176880,176930,0.028259763748375064
277.0,FR018L2,Reims,2004,19,243132,243151,0.007814074381762773
278.0,FR019L2,OrlÃ©ans,2004,834,291133,291967,0.28564872057458546
279.0,FR020L2,Dijon,2004,53,385708,385761,0.01373907678588556
280.0,FR021L2,Poitiers,2004,61,250381,250442,0.02435693693549804
281.0,FR022L2,Clermont-Ferrand,2004,67,266059,266126,0.02517604443008199
282.0,FR023L2,Caen,2004,595,225678,226273,0.26295669390515
283.0,FR024L2,Limoges,2004,46,317788,317834,0.01447296387422365
284.0,FR025L2,BesanÃ§on,2004,7,239029,239036,0.0029284291905821718
285.0,FR026L2,Grenoble,2004,2950,262898,265848,1.109656645902922
286.0,FR027L2,Ajaccio,2004,1476,145533,147009,1.0040201620308962
289.0,FR032L2,Toulon,2004,2300,104756,107056,2.1484083096697053
290.0,FR034L2,Valenciennes,2004,14,78432,78446,0.017846671595747394
291.0,FR035L2,Tours,2004,524,284324,284848,0.183957759928102
292.0,FR036L2,Angers,2004,659,230592,231251,0.28497174066274306
293.0,FR037L2,Brest,2004,860,134134,134994,0.6370653510526394
294.0,FR038L2,Le Mans,2004,48,224063,224111,0.021417958065422935
295.0,FR039L1,Avignon,2004,1468,85757,87225,1.6830037259959876
296.0,FR040L2,Mulhouse,2004,65,129701,129766,0.05009016229212583
297.0,FR042L2,Dunkerque,2004,741,90384,91125,0.8131687242798354
298.0,FR043L2,Perpignan,2004,1487,181543,183030,0.8124351199256953
299.0,FR044L2,NÃ®mes,2004,1353,149138,150491,0.8990570864702874
300.0,FR045L2,Pau,2004,149,201610,201759,0.07385048498456079
301.0,FR046L2,Bayonne,2004,6161,96469,102630,6.003117996687129
302.0,FR047L0,Annemasse,2004,2,7798,7800,0.02564102564102564
303.0,FR048L2,Annecy,2004,2248,116795,119043,1.8883932696588626
304.0,FR049L2,Lorient,2004,610,112572,113182,0.5389549575020763
305.0,FR050L2,MontbÃ©liard,2004,37,123020,123057,0.030067367155058224
306.0,FR051L2,Troyes,2004,1354,259596,260950,0.5188733473845565
307.0,FR052L2,Saint-Nazaire,2004,411,106724,107135,0.3836281327297335
308.0,FR053L2,La Rochelle,2004,305,111035,111340,0.2739356924735046
309.0,FR056L2,AngoulÃªme,2004,15,214277,214292,0.006999794672689602
310.0,FR057L2,Boulogne-sur-Mer,2004,84,68454,68538,0.12255974787709009
311.0,FR058L2,ChambÃ©ry,2004,2647,99042,101689,2.6030347431875622
312.0,FR059L2,Chalon-sur-SaÃ´ne,2004,338,156020,156358,0.2161705828931043
313.0,FR060L2,Chartres,2004,9,161351,161360,0.005577590480912245
314.0,FR061L2,Niort,2004,2,178917,178919,0.001117824266847009
315.0,FR062L2,Calais,2004,64,50166,50230,0.12741389607804102
316.0,FR063L2,BÃ©ziers,2004,421,84722,85143,0.4944622576136617
317.0,FR064L2,Arras,2004,13,107550,107563,0.012085940332642264
318.0,FR065L2,Bourges,2004,86,250233,250319,0.03435616153787767
319.0,FR066L2,Saint-Brieuc,2004,96,115085,115181,0.08334707981351092
320.0,FR067L2,Quimper,2004,646,121276,121922,0.5298469513295385
321.0,FR068L2,Vannes,2004,1601,119433,121034,1.3227688087644793
322.0,FR069L2,Cherbourg,2004,1603,89115,90718,1.7670142639828919
323.0,FR073L2,Tarbes,2004,131,104198,104329,0.1255643205628349
324.0,FR074L2,CompiÃ¨gne,2004,226,98511,98737,0.22889089196552456
325.0,FR076L2,Belfort,2004,52,65567,65619,0.07924534052637193
326.0,FR077L2,Roanne,2004,12,123188,123200,0.00974025974025974
327.0,FR079L2,Saint-Quentin,2004,21,99353,99374,0.021132288123654076
328.0,FR082L2,Beauvais,2004,38,131104,131142,0.028976224245474372
329.0,FR084L2,Creil,2004,117,29526,29643,0.39469689302702154
330.0,FR086L2,Evreux,2004,8,126562,126570,0.006320613099470649
331.0,FR090L2,ChÃ¢teauroux,2004,306,260871,261177,0.1171619246717743
332.0,FR093L2,Brive-la-Gaillarde,2004,0,132582,132582,0.0
333.0,FR096L2,Albi,2004,45,134193,134238,0.03352254950163143
334.0,FR099L2,FrÃ©jus,2004,447,43966,44413,1.0064620719158806
335.0,FR104L2,ChÃ¢lons-en-Champagne,2004,33,152776,152809,0.021595586647383334
336.0,FR203L2,Marseille,2004,2941,422835,425776,0.6907387922287775
337.0,FR205L2,Nice,2004,811,306529,307340,0.2638771393245266
338.0,FR207L2,Lens - LiÃ©vin,2004,11,25297,25308,0.04346451714872768
339.0,FR208L1,HÃ©nin - Carvin,2004,11,11587,11598,0.09484393861010519
340.0,FR209L2,Douai,2004,180,44904,45084,0.3992547245142401
341.0,FR214L1,Valence,2004,120,90841,90961,0.13192467101285166
342.0,FR215L2,Rouen,2004,1254,285872,287126,0.4367420574939225
343.0,FR304L1,Melun,2004,14,44822,44836,0.031224908555624944
344.0,FR324L1,Martigues,2004,1747,18709,20456,8.540281579976535
345.0,FR505L1,Charleville-MÃ©ziÃ¨res,2004,30,135339,135369,0.022161647053609023
346.0,FR506L1,Colmar,2004,107,101878,101985,0.1049173898122273
347.0,FR519L1,Cannes,2004,503,19633,20136,2.4980135081446164
348.0,HR001L2,Grad Zagreb,2004,92,505776,505868,0.018186562502471002
349.0,HR002L2,Rijeka,2004,385,106849,107234,0.3590279202491747
350.0,HR003L2,Slavonski Brod,2004,790,97040,97830,0.8075232546253706
351.0,HR004L2,Osijek,2004,1471,171463,172934,0.8506135288607214
352.0,HR005L2,Split,2004,3364,335706,339070,0.9921255198041702
353.0,HR006L1,Pula - Pola,2004,1350,57547,58897,2.2921371207362005
354.0,HR007L1,Zadar,2004,2493,154007,156500,1.5929712460063898
355.0,HU001L2,Budapest,2004,6424,632710,639134,1.0051100395222285
356.0,HU002L2,Miskolc,2004,51,164618,164669,0.03097122105557209
357.0,HU003L2,NyÃ­regyhÃ¡za,2004,75,168150,168225,0.04458314757021846
358.0,HU004L2,PÃ©cs,2004,30,185458,185488,0.016173553006124386
359.0,HU005L2,Debrecen,2004,306,201272,201578,0.15180228001071544
360.0,HU006L2,Szeged,2004,594,160339,160933,0.36909769904245865
361.0,HU007L2,GyÃµr,2004,583,204057,204640,0.28489053948397186
362.0,HU008L2,KecskemÃ©t,2004,72,182067,182139,0.03953024887585855
363.0,HU009L2,SzÃ©kesfehÃ©rvÃ¡r,2004,1331,299792,301123,0.4420120681581945
364.0,HU010L1,Szombathely,2004,18,134259,134277,0.01340512522621149
365.0,HU011L1,Szolnok,2004,590,143385,143975,0.40979336690397633
366.0,HU012L1,TatabÃ¡nya,2004,198,69632,69830,0.28354575397393667
367.0,HU013L1,VeszprÃ©m,2004,7153,124167,131320,5.446999695400549
368.0,HU014L1,BÃ©kÃ©scsaba,2004,26,106137,106163,0.0244906417490086
369.0,HU015L1,KaposvÃ¡r,2004,1,145559,145560,0.0006870019236053861
370.0,HU016L1,Eger,2004,86,100492,100578,0.08550577661118734
371.0,HU017L1,DunaÃºjvÃ¡ros,2004,707,60963,61670,1.1464245175936436
372.0,HU018L1,Zalaegerszeg,2004,175,139804,139979,0.12501875281292193
373.0,HU019L1,Sopron,2004,398,80272,80670,0.493368042642866
374.0,IE001L1,Dublin,2004,5691,697911,703602,0.8088379510007078
375.0,IE002L1,Cork,2004,11449,318214,329663,3.472940548378192
376.0,IE003L1,Limerick,2004,1167,155291,156458,0.7458870751255928
377.0,IE004L1,Galway,2004,12952,213331,226283,5.7238060305016285
378.0,IE005L1,Waterford,2004,1171,94686,95857,1.2216113585862274
379.0,IS001L1,ReykjavÃ­k,2004,1297230,0,1297230,100.0
380.0,IT001L3,Roma,2004,8957,608259,617216,1.4511937474077146
381.0,IT002L3,Milano,2004,29,384016,384045,0.007551198427267637
382.0,IT003L3,Napoli,2004,3036,149906,152942,1.9850662342587386
383.0,IT004L2,Torino,2004,60,170119,170179,0.03525699410620582
384.0,IT005L3,Palermo,2004,1624,148449,150073,1.082140025187742
385.0,IT006L3,Genova,2004,665,120099,120764,0.5506607929515419
386.0,IT007L3,Firenze,2004,97,163674,163771,0.05922904543539454
387.0,IT008L3,Bari,2004,843,112586,113429,0.7431961843972882
388.0,IT009L1,Bologna,2004,83,185174,185257,0.04480262554181488
389.0,IT010L2,Catania,2004,742,60683,61425,1.207977207977208
390.0,IT011L2,Venezia,2004,1812,65225,67037,2.702984918776198
391.0,IT012L3,Verona,2004,54,73107,73161,0.07380981670562184
392.0,IT013L3,Cremona,2004,138,60259,60397,0.22848816994221569
393.0,IT014L3,Trento,2004,613,97574,98187,0.6243189016875961
394.0,IT015L1,Trieste,2004,335,21302,21637,1.5482737902666728
395.0,IT016L3,Perugia,2004,5350,125678,131028,4.0830967426809535
396.0,IT017L3,Ancona,2004,535,43708,44243,1.2092308387767556
397.0,IT019L2,Pescara,2004,261,16182,16443,1.5873015873015872
398.0,IT020L3,Campobasso,2004,536,102299,102835,0.5212233189089318
399.0,IT021L2,Caserta,2004,1,9341,9342,0.010704345964461572
400.0,IT022L2,Taranto,2004,3469,103459,106928,3.2442391141702833
401.0,IT023L2,Potenza,2004,130,138325,138455,0.09389332274024051
402.0,IT024L3,Catanzaro,2004,350,89733,90083,0.388530577356438
403.0,IT025L3,Reggio di Calabria,2004,630,47618,48248,1.3057536063671034
404.0,IT026L3,Sassari,2004,2264,150961,153225,1.4775656713982706
405.0,IT027L2,Cagliari,2004,4879,190413,195292,2.4983102226409684
406.0,IT028L3,Padova,2004,41,61404,61445,0.06672634062983156
407.0,IT029L3,Brescia,2004,73,60196,60269,0.12112362906303406
408.0,IT030L3,Modena,2004,125,69143,69268,0.1804585089796154
409.0,IT031L3,Foggia,2004,9,89702,89711,0.01003221455562863
410.0,IT032L3,Salerno,2004,356,37483,37839,0.9408282459895876
411.0,IT033L2,Piacenza,2004,180,93947,94127,0.1912309964197308
412.0,IT034L1,Bolzano,2004,561,106195,106756,0.5254973959309078
413.0,IT035L2,Udine,2004,0,71830,71830,0.0
414.0,IT036L2,La Spezia,2004,693,42226,42919,1.61466949369743
415.0,IT037L1,Lecce,2004,361,61149,61510,0.5868964396033165
416.0,IT038L1,Barletta,2004,235,14862,15097,1.55660064913559
417.0,IT039L2,Pesaro,2004,166,25525,25691,0.6461406718306022
418.0,IT040L2,Como,2004,378,19363,19741,1.914796616179525
419.0,IT041L2,Pisa,2004,492,47561,48053,1.02386947745198
420.0,IT042L1,Treviso,2004,31,24014,24045,0.1289249324183822
421.0,IT043L2,Varese,2004,467,23197,23664,1.9734617985125085
422.0,IT045L2,Asti,2004,0,54836,54836,0.0
423.0,IT046L2,Pavia,2004,6,36198,36204,0.016572754391779913
424.0,IT047L1,Massa,2004,193,11050,11243,1.7166236769545495
425.0,IT048L2,Cosenza,2004,756,91723,92479,0.817482888007007
426.0,IT052L1,Savona,2004,217,28488,28705,0.7559658596063403
427.0,IT054L1,Matera,2004,688,77101,77789,0.8844438159636967
428.0,IT056L1,Acireale,2004,52,5936,5988,0.8684034736138945
429.0,IT057L2,Avellino,2004,25,39734,39759,0.06287884504137428
430.0,IT058L2,Pordenone,2004,24,37026,37050,0.06477732793522267
431.0,IT060L1,Lecco,2004,1229,28983,30212,4.067920031775453
432.0,IT061L0,Altamura,2004,0,42800,42800,0.0
433.0,IT064L1,Battipaglia,2004,55,6431,6486,0.8479802651865556
434.0,IT065L0,Bisceglie,2004,104,6840,6944,1.497695852534562
435.0,IT066L1,Carpi,2004,3,20619,20622,0.014547570555717195
436.0,IT067L0,Cerignola,2004,189,58708,58897,0.32089919690306806
437.0,IT068L1,Gallarate,2004,0,5319,5319,0.0
438.0,IT069L1,Gela,2004,436,57459,57895,0.7530874859659729
439.0,IT073L1,Sassuolo,2004,0,24062,24062,0.0
440.0,IT501L2,Messina,2004,814,33629,34443,2.36332491362541
441.0,IT502L2,Prato,2004,14,40945,40959,0.03418052198540003
442.0,IT503L3,Parma,2004,103,113404,113507,0.09074330217519624
443.0,IT504L3,Livorno,2004,375,25439,25814,1.4527000852250715
444.0,IT505L3,Reggio nell'Emilia,2004,24,69010,69034,0.0347654778804647
445.0,IT506L2,Ravenna,2004,3363,77826,81189,4.1421867494365
446.0,IT507L2,Ferrara,2004,258,91225,91483,0.2820196102008023
447.0,IT508L3,Rimini,2004,282,32297,32579,0.8655882623776052
448.0,IT509L3,Siracusa,2004,579,33563,34142,1.6958584734344795
449.0,IT511L2,Bergamo,2004,0,18556,18556,0.0
450.0,IT512L3,ForlÃ¬,2004,14,72737,72751,0.0192437217357837
451.0,IT513L3,Latina,2004,529,65964,66493,0.7955724662746454
452.0,IT514L2,Vicenza,2004,1,34981,34982,0.0028586130009719286
453.0,IT515L2,Terni,2004,139,102193,102332,0.1358323886956182
454.0,IT516L2,Novara,2004,0,54165,54165,0.0
455.0,IT518L1,Alessandria,2004,6,76908,76914,0.007800920508620017
456.0,IT519L1,Arezzo,2004,35,88592,88627,0.03949135139404471
457.0,IT520L1,Grosseto,2004,407,119192,119599,0.34030384869438707
458.0,IT521L1,Brindisi,2004,890,63097,63987,1.3909075280916436
459.0,IT522L1,Trapani,2004,907,49883,50790,1.78578460326836
460.0,IT523L1,Ragusa,2004,262,52588,52850,0.4957426679280984
461.0,IT524L0,Andria,2004,0,39880,39880,0.0
462.0,IT525L0,Trani,2004,143,10236,10379,1.3777820599287023
463.0,IT526L1,L'Aquila,2004,715,139554,140269,0.5097348665777898
464.0,LT001L1,Vilnius,2004,3205,421364,424569,0.7548831874206549
465.0,LT002L1,Kaunas,2004,715,161336,162051,0.4412191223750548
466.0,LT003L1,PanevÄÅ¾ys,2004,62,222746,222808,0.027826648953358943
467.0,LT004L0,Alytus,2004,18,3941,3959,0.45466026774437995
468.0,LT501L0,KlaipÄda,2004,99,8824,8923,1.109492323209683
469.0,LT502L0,Å iauliai,2004,1125,6920,8045,13.983840894965818
470.0,LU001L1,Luxembourg,2004,2672,257043,259715,1.0288200527501299
471.0,LV001L1,RÄ«ga,2004,10809,605440,616249,1.7539987894503684
472.0,LV002L2,LiepÄja,2004,3228,268829,272057,1.1865160609725167
473.0,LV003L1,Jelgava,2004,222,166237,166459,0.1333661742531194
474.0,LV501L1,Daugavpils,2004,3399,256276,259675,1.308943872147877
475.0,ME001L1,Podgorica,2004,1147,183334,184481,0.6217442446647623
476.0,MK001L1,Skopje,2004,5,224348,224353,0.0022286307738251772
477.0,MK003L1,Bitola,2004,183,119479,119662,0.15293075495980346
478.0,MK004L1,Tetovo,2004,27,105594,105621,0.025563098247507597
479.0,MK005L1,Prilep,2004,89,86742,86831,0.10249795579919613
480.0,MT001L1,Valletta,2004,1037,24919,25956,3.9952226845430725
481.0,NL001L3,s' Gravenhage,2004,750,41957,42707,1.7561523871964784
482.0,NL002L3,Amsterdam,2004,65673,267284,332957,19.72416858633397
483.0,NL003L3,Rotterdam,2004,21220,195951,217171,9.771102034802068
484.0,NL004L3,Utrecht,2004,595,96692,97287,0.6115925046511866
485.0,NL005L3,Eindhoven,2004,23,144383,144406,0.015927316039499744
486.0,NL006L3,Tilburg,2004,2279,40955,43234,5.271314243419531
487.0,NL007L3,Groningen,2004,1977,206183,208160,0.949750192159877
488.0,NL008L3,Enschede,2004,104,84852,84956,0.12241630961909694
489.0,NL009L3,Arnhem,2004,69,55829,55898,0.12343912125657448
490.0,NL010L3,Heerlen,2004,9,33334,33343,0.02699217227004169
491.0,NL012L3,Breda,2004,906,72464,73370,1.2348371268911
492.0,NL013L3,Nijmegen,2004,209,39627,39836,0.5246510693844764
493.0,NL014L3,Apeldoorn,2004,83,71041,71124,0.11669759856026095
494.0,NL015L3,Leeuwarden,2004,448,110475,110923,0.4038837752314669
495.0,NL016L3,Sittard-Geleen,2004,2,22910,22912,0.008729050279329608
496.0,NL020L3,Roosendaal,2004,0,24574,24574,0.0
497.0,NL026L0,Alphen aan den Rijn,2004,3,13207,13210,0.02271006813020439
498.0,NL028L3,Bergen op Zoom,2004,1133,33648,34781,3.257525660561801
499.0,NL030L0,Gouda,2004,1,1787,1788,0.05592841163310962
500.0,NL032L3,MiddelburgÂ Â Â Â Â Â ,2004,929,22459,23388,3.9721224559603217
501.0,NL503L3,s-Hertogenbosch,2004,2025,34834,36859,5.493909221628368
502.0,NL504L3,Amersfoort,2004,0,12244,12244,0.0
503.0,NL505L3,Maastricht,2004,14,20371,20385,0.06867794947265146
504.0,NL507L3,Leiden,2004,40,19741,19781,0.20221424599363025
505.0,NL511L3,Zwolle,2004,587,122433,123020,0.4771581856608681
506.0,NL512L3,Ede,2004,17,35248,35265,0.048206436977172834
507.0,NL513L3,Deventer,2004,0,25245,25245,0.0
508.0,NL514L3,Alkmaar,2004,152,47640,47792,0.3180448610646133
509.0,NL515L3,Venlo,2004,11,51225,51236,0.021469279412912795
510.0,NL519L3,Almelo,2004,0,42025,42025,0.0
511.0,NL520L3,Lelystad,2004,57364,61478,118842,48.269130442099595
512.0,NL521L3,Oss,2004,46,33100,33146,0.13877994328124058
513.0,NL522L3,Assen,2004,43,70819,70862,0.060681324264062544
514.0,NL524L3,Veenendaal,2004,32,8153,8185,0.39095907147220527
515.0,NL529L3,Soest,2004,0,7942,7942,0.0
516.0,NO001L1,Oslo,2004,20641,726002,746643,2.764507267864294
517.0,NO002L1,Bergen,2004,19331,338412,357743,5.403599790911352
518.0,NO003L1,Trondheim,2004,15389,657867,673256,2.285757572156802
519.0,NO004L1,Stavanger,2004,43439,245638,289077,15.02679216956036
520.0,NO005L1,Kristiansand,2004,7229,308233,315462,2.2915596807222425
521.0,NO006L1,TromsÃ¸,2004,77522,297091,374613,20.693889427222224
522.0,PL001L2,Warszawa,2004,2291,858952,861243,0.26601087033508547
523.0,PL002L2,ÅÃ³dÅº,2004,130,169370,169500,0.07669616519174041
524.0,PL003L2,KrakÃ³w,2004,19017,356731,375748,5.061104782992857
525.0,PL004L2,WrocÅaw,2004,216,264484,264700,0.08160181337363052
526.0,PL005L2,PoznaÅ,2004,961,308367,309328,0.31067345988723943
527.0,PL006L2,GdaÅsk,2004,1616,261900,263516,0.6132454955296832
528.0,PL007L2,Szczecin,2004,3937,109123,113060,3.4822218291172833
529.0,PL008L2,Bydgoszcz,2004,527,209609,210136,0.25078996459435793
530.0,PL009L2,Lublin,2004,361,322423,322784,0.11183949638148112
531.0,PL010L2,Katowice,2004,2980,391615,394595,0.7552047035568115
532.0,PL011L2,BiaÅystok,2004,16,223306,223322,0.007164542678285166
533.0,PL012L2,Kielce,2004,5053,219176,224229,2.253499770324088
534.0,PL013L2,ToruÅ,2004,314,158619,158933,0.19756752845538683
535.0,PL014L2,Olsztyn,2004,2566,199978,202544,1.2668852200015799
536.0,PL015L2,RzeszÃ³w,2004,62,229287,229349,0.027033036987298836
537.0,PL016L2,Opole,2004,897,175719,176616,0.5078815056393532
538.0,PL017L2,GorzÃ³w Wielkopolski,2004,254,97166,97420,0.2607267501539725
539.0,PL018L2,Zielona GÃ³ra,2004,256,169028,169284,0.1512251600860093
540.0,PL019L2,Jelenia GÃ³ra,2004,146,83195,83341,0.17518388308275637
541.0,PL020L2,Nowy SÄcz,2004,796,129622,130418,0.6103451977487769
542.0,PL021L2,SuwaÅki,2004,1473,70660,72133,2.042061192519374
543.0,PL022L2,Konin,2004,601,117562,118163,0.508619449404636
544.0,PL024L2,CzÄstochowa,2004,35,193863,193898,0.018050727702193937
545.0,PL025L2,Radom,2004,0,68022,68022,0.0
546.0,PL026L2,PÅock,2004,1888,169187,171075,1.1036095279848022
547.0,PL027L2,Kalisz,2004,43,148980,149023,0.028854606335934722
548.0,PL028L2,Koszalin,2004,206,129465,129671,0.15886358553570187
549.0,PL029L1,SÅupsk,2004,6221,228783,235004,2.6471889840172933
550.0,PL030L1,JastrzÄbie-ZdrÃ³j,2004,67,29504,29571,0.22657333198065674
551.0,PL031L1,Siedlce,2004,13,126156,126169,0.010303640355396333
552.0,PL032L1,PiotrkÃ³w Trybunalski,2004,216,116706,116922,0.18473854364448095
553.0,PL033L1,Lubin,2004,271,93035,93306,0.2904422009302724
554.0,PL034L1,PiÅa,2004,106,52086,52192,0.20309625996321276
555.0,PL035L1,InowrocÅaw,2004,0,20128,20128,0.0
556.0,PL036L1,Ostrowiec ÅwiÄtokrzyski,2004,21,61439,61460,0.03416856492027335
557.0,PL037L1,Gniezno,2004,57,66514,66571,0.08562286881675203
558.0,PL038L1,Stargard SzczeciÅski,2004,1512,35152,36664,4.123936286275366
559.0,PL039L1,OstrÃ³w Wielkopolski,2004,34,84727,84761,0.040112787720767804
560.0,PL040L1,PrzemyÅl,2004,155,84934,85089,0.18216220663070432
561.0,PL041L1,ZamoÅÄ,2004,120,112587,112707,0.10647076046740665
562.0,PL042L1,CheÅm,2004,15,46555,46570,0.032209576980888985
563.0,PL043L1,Pabianice,2004,9,32950,32959,0.027306653721290087
564.0,PL044L1,GÅogÃ³w,2004,54,64027,64081,0.08426834787222422
565.0,PL045L1,Stalowa Wola,2004,324,189989,190313,0.17024585813896057
566.0,PL046L1,TomaszÃ³w Mazowiecki,2004,643,18520,19163,3.355424515994364
567.0,PL047L1,ÅomÅ¼a,2004,3,55999,56002,0.0053569515374450915
568.0,PL048L1,Leszno,2004,233,77339,77572,0.300366111483525
569.0,PL049L1,Åwidnica,2004,14,47976,47990,0.029172744321733696
570.0,PL051L1,Tczew,2004,18,27106,27124,0.06636189352602861
571.0,PL052L1,EÅk,2004,1217,38835,40052,3.038549885149306
572.0,PL506L2,Bielsko-BiaÅa,2004,659,72776,73435,0.89739225165112
573.0,PL508L1,Rybnik,2004,400,14481,14881,2.687991398427525
574.0,PL511L2,WaÅbrzych,2004,21,51489,51510,0.040768782760629
575.0,PL512L2,ElblÄg,2004,2,96473,96475,0.0020730759264058047
576.0,PL513L2,WÅocÅawek,2004,866,121613,122479,0.707059985793483
577.0,PL514L2,TarnÃ³w,2004,196,125131,125327,0.15639088145411603
578.0,PL516L2,Legnica,2004,9,56491,56500,0.01592920353982301
579.0,PL517L2,GrudziÄdz,2004,21,55022,55043,0.03815199026215868
580.0,PT001L3,Lisboa,2004,7447,431834,439281,1.6952702256642103
581.0,PT002L2,Porto,2004,1135,94605,95740,1.18550240233967
582.0,PT003L1,Braga,2004,44,49305,49349,0.08916087458712435
583.0,PT004L2,Funchal,2004,35962,0,35962,100.0
584.0,PT005L2,Coimbra,2004,443,162344,162787,0.27213475277509874
585.0,PT007L1,Ponta Delgada,2004,55294,0,55294,100.0
586.0,PT008L2,Aveiro,2004,1741,41589,43330,4.018001384721901
587.0,PT009L1,Faro,2004,2524,46626,49150,5.135300101729399
588.0,PT014L1,Viseu,2004,6,70868,70874,0.008465727911504925
589.0,PT016L0,Viana do Castelo,2004,349,31903,32252,1.0821034354458638
590.0,PT019L0,PÃ³voa de Varzim,2004,35,8371,8406,0.4163692600523436
591.0,PT505L1,GuimarÃ£es,2004,1,26540,26541,0.0037677555480200445
592.0,RO001L1,BucureÅti,2004,342,107500,107842,0.3171306170137794
593.0,RO002L1,Cluj-Napoca,2004,1,59301,59302,0.0016862837678324508
594.0,RO003L1,TimiÅoara,2004,30,23624,23654,0.12682844339223812
595.0,RO004L1,Craiova,2004,64,34332,34396,0.18606814745900685
596.0,RO005L1,BrÄila,2004,1228,22301,23529,5.219091334098347
597.0,RO006L1,Oradea,2004,54,20285,20339,0.2654997787501844
598.0,RO007L1,BacÄu,2004,76,22017,22093,0.34400036210564433
599.0,RO008L1,Arad,2004,177,51431,51608,0.342970082157805
600.0,RO009L1,Sibiu,2004,15,56325,56340,0.026624068157614485
601.0,RO010L1,TÃ¢rgu MureÅ,2004,34,13706,13740,0.24745269286754004
602.0,RO011L1,Piatra NeamÅ£,2004,80,14919,14999,0.5333688912594172
603.0,RO012L1,CÇlÇraÅi,2004,487,24057,24544,1.9841916558018253
604.0,RO013L1,Giurgiu,2004,537,10413,10950,4.904109589041096
605.0,RO014L1,Alba Iulia,2004,5,25997,26002,0.019229290054611183
606.0,RO015L1,FocÅani,2004,19,27083,27102,0.07010552726736034
607.0,RO016L1,TÃ¢rgu Jiu,2004,47,24475,24522,0.1916646276812658
608.0,RO017L1,Tulcea,2004,1812,39135,40947,4.4252326177741965
609.0,RO018L1,TÃ¢rgoviÅte,2004,12,20245,20257,0.059238781655723945
610.0,RO019L1,Slatina,2004,212,6911,7123,2.9762740418363047
611.0,RO020L1,BÃ¢rlad,2004,97,26222,26319,0.3685550362855732
612.0,RO021L1,Roman,2004,3,14387,14390,0.020847810979847115
613.0,RO022L1,BistriÅ£a,2004,3,42628,42631,0.007037132603035349
614.0,RO501L1,Constanta,2004,5223,54128,59351,8.800188707856648
615.0,RO502L1,Iasi,2004,147,79789,79936,0.18389711769415532
616.0,RO503L1,Galati,2004,1402,39830,41232,3.4002716336825762
617.0,RO504L1,Brasov,2004,31,98472,98503,0.031471122706922636
618.0,RO505L1,Ploiesti,2004,1,34336,34337,0.0029123103357893815
619.0,RO506L1,Pitesti,2004,201,24683,24884,0.8077479504902748
620.0,RO507L1,Baia Mare,2004,8,52533,52541,0.015226204297596165
621.0,RO508L1,Buzau,2004,11,38529,38540,0.028541774779449924
622.0,RO509L1,Satu Mare,2004,0,70844,70844,0.0
623.0,RO510L1,Botosani,2004,171,37169,37340,0.4579539367970006
624.0,RO511L1,Ramnicu Valcea,2004,718,28455,29173,2.461179858087958
625.0,RO512L1,Suceava,2004,175,39503,39678,0.4410504561721861
626.0,RO513L1,Drobeta-Turnu Severin,2004,2182,30752,32934,6.625371956033279
627.0,RS001L1,Beograd,2004,6358,306666,313024,2.0311541607033323
628.0,RS002L1,Novi Sad,2004,2314,187129,189443,1.221475588963435
629.0,RS003L1,NiÅ¡,2004,13,341551,341564,0.003806021711890012
630.0,RS004L1,Kragujevac,2004,2109,141966,144075,1.463820926600729
631.0,RS005L1,Subotica,2004,144,160148,160292,0.0898360492101914
632.0,RS006L1,Novi Pazar,2004,2329,138462,140791,1.6542250569993822
633.0,RS008L1,Zrenjanin,2004,718,184413,185131,0.38783348007627033
634.0,RS009L1,Kraljevo,2004,3417,173095,176512,1.9358457215373457
635.0,RS011L0,ÄaÄak,2004,900,62787,63687,1.4131612416976778
636.0,RS012L1,KruÅ¡evac,2004,1,122648,122649,0.0008153348172427007
637.0,RS013L1,Leskovac,2004,2,166280,166282,0.001202776007024212
638.0,RS014L1,Valjevo,2004,2,141660,141662,0.0014118112126046505
639.0,RS015L1,Vranje,2004,0,195356,195356,0.0
640.0,RS016L1,Smederevo,2004,2777,157447,160224,1.7331985220691033
641.0,SE001L1,Stockholm,2004,65697,690029,755726,8.693230086036474
642.0,SE002L1,GÃ¶teborg,2004,14718,420541,435259,3.381434961712452
643.0,SE003L1,MalmÃ¶,2004,2998,185018,188016,1.5945451450940347
644.0,SE004L1,JÃ¶nkÃ¶ping,2004,39026,308165,347191,11.240498745647209
645.0,SE005L1,UmeÃ¥,2004,25928,962321,988249,2.6236302794133866
646.0,SE006L1,Uppsala,2004,14759,682768,697527,2.1159037571305483
647.0,SE007L1,LinkÃ¶ping,2004,25509,397687,423196,6.02770347545818
648.0,SE008L1,Ãrebro,2004,23442,345155,368597,6.35979131680399
649.0,SE501L1,VÃ¤sterÃ¥s,2004,17308,273107,290415,5.959747258233906
650.0,SE502L1,NorrkÃ¶ping,2004,15115,296623,311738,4.8486228820355555
651.0,SE503L1,Helsingborg,2004,1420,113002,114422,1.2410200835503662
652.0,SE505L1,BorÃ¥s,2004,1183,96179,97362,1.2150531007990797
653.0,SI001L2,Ljubljana,2004,281,233006,233287,0.12045248985155622
654.0,SI002L1,Maribor,2004,762,216223,216985,0.35117634859552505
655.0,SK001L1,Bratislava,2004,1697,203244,204941,0.8280431929189376
656.0,SK002L1,KoÅ¡ice,2004,133,177501,177634,0.07487305358208451
657.0,SK003L1,BanskÃ¡ Bystrica,2004,7998,72882,80880,9.888724035608307
658.0,SK004L1,Nitra,2004,29,87098,87127,0.0332847452569238
659.0,SK005L1,PreÅ¡ov,2004,76,93223,93299,0.08145853653308181
660.0,SK006L1,Å½ilina,2004,456,80992,81448,0.5598664178371476
661.0,SK007L1,Trnava,2004,53,74167,74220,0.0714093236324441
662.0,SK008L1,TrenÄÃ­n,2004,43,67380,67423,0.06377645610548328
739.0,UK001L3,London,2004,1057,697113,698170,0.15139579185585172
740.0,UK002L3,West Midlands urban area,2004,496,214813,215309,0.23036658941335475
741.0,UK003L2,Leeds,2004,1388,511039,512427,0.27086785044503897
742.0,UK004L1,Glasgow,2004,4614,333070,337684,1.3663661885075988
743.0,UK006L3,Liverpool,2004,629,99874,100503,0.6258519646179717
744.0,UK007L1,Edinburgh,2004,6650,168768,175418,3.7909450569496856
745.0,UK008L3,Greater Manchester,2004,1144,311102,312246,0.3663777918692313
746.0,UK009L1,Cardiff,2004,209,84282,84491,0.24736362452805624
747.0,UK010L3,Sheffield,2004,416,125671,126087,0.32993092071347563
748.0,UK011L2,Bristol,2004,322,98063,98385,0.3272856634649591
749.0,UK012L2,Belfast,2004,23553,171592,195145,12.069486791872711
750.0,UK013L2,Newcastle upon Tyne,2004,3702,543006,546708,0.6771439232643385
751.0,UK014L1,Leicester,2004,128,139653,139781,0.09157181591203382
752.0,UK016L1,Aberdeen,2004,37170,616778,653948,5.683938172454079
753.0,UK017L2,Cambridge,2004,71,159548,159619,0.04448092019120531
754.0,UK018L3,Exeter,2004,1552,246174,247726,0.6264986315526024
755.0,UK019L3,Lincoln,2004,266,211277,211543,0.12574275679176336
756.0,UK023L1,Portsmouth,2004,609,20244,20853,2.920443101711984
757.0,UK024L1,Worcester,2004,17,61185,61202,0.0277768700369269
758.0,UK025L3,Coventry,2004,143,81304,81447,0.17557429985143713
759.0,UK026L1,Kingston upon Hull,2004,1570,250128,251698,0.6237633989940325
760.0,UK027L1,Stoke-on-Trent,2004,83,88093,88176,0.09412992197423335
761.0,UK029L1,Nottingham,2004,41,90248,90289,0.04540973983541738
762.0,UK033L1,Guildford,2004,15,61676,61691,0.024314729863351217
763.0,UK050L1,Burnley,2004,20,27954,27974,0.07149495960534782
764.0,UK056L1,Hastings,2004,37,54713,54750,0.06757990867579909
765.0,UK515L1,Brighton and Hove,2004,308,42099,42407,0.7262951871153347
766.0,UK516L1,Plymouth,2004,1191,214584,215775,0.5519638512339242
767.0,UK517L1,Swansea,2004,590,83452,84042,0.7020299374122463
768.0,UK518L1,Derby,2004,170,67932,68102,0.24962556165751376
769.0,UK520L2,Southampton,2004,16883,136469,153352,11.009311909854452
770.0,UK528L1,Northampton,2004,6240,148305,154545,4.037658934290983
771.0,UK539L1,Bournemouth,2004,1277,92516,93793,1.3615088546053544
772.0,UK546L1,Colchester,2004,555,68940,69495,0.7986186056550831
773.0,UK550L0,Dundee City,2004,1575,224841,226416,0.69562221751113
774.0,UK551L1,Falkirk,2004,250,29539,29789,0.8392359595823962
775.0,UK552L0,Reading,2004,34,21887,21921,0.15510241321107615
776.0,UK553L1,Blackpool,2004,53,48902,48955,0.1082626902257175
777.0,UK557L1,Blackburn with Darwen,2004,199,79355,79554,0.2501445558991377
778.0,UK558L1,Newport,2004,128,31572,31700,0.4037854889589906
779.0,UK559L2,Middlesbrough,2004,1413,60356,61769,2.2875552461590765
780.0,UK560L1,Oxford,2004,248,192675,192923,0.1285486955935788
781.0,UK562L2,Preston,2004,23,25739,25762,0.08927878270320627
782.0,UK566L1,Norwich,2004,519,149721,150240,0.3454472843450479
783.0,UK568L1,Cheshire West and Chester,2004,460,135685,136145,0.3378750596790187
784.0,UK569L2,Ipswich,2004,1193,154453,155646,0.766482916361487
785.0,UK571L1,Cheltenham,2004,20,46163,46183,0.04330597839031678
786.0,XK001L1,Pristina,2004,0,255807,255807,0.0
787.0,XK002L1,Prizren,2004,25,127608,127633,0.0195874107793439
788.0,XK003L1,MitrovicÃ«,2004,0,117914,117914,0.0
1.0,AL001L1,Tirana,2005,1849,165272,167121,1.1063839972235685
2.0,AL003L1,Elbasan,2005,633,125371,126004,0.5023650042855783
3.0,AL004L1,ShkodÃ«r,2005,9790,175539,185329,5.282497612354246
4.0,AL005L0,VlorÃ«,2005,3078,60655,63733,4.82952316696217
5.0,AT001L3,Wien,2005,1098,917392,918490,0.11954403423009505
6.0,AT002L3,Graz,2005,45,291087,291132,0.015456906145665885
7.0,AT003L3,Linz,2005,1840,357390,359230,0.5122066642540991
8.0,AT004L3,Salzburg,2005,709,136767,137476,0.5157263813320143
9.0,AT005L3,Innsbruck,2005,14393,198429,212822,6.762928644595013
10.0,AT006L2,Klagenfurt,2005,784,182476,183260,0.42780748663101603
11.0,BA001L1,Sarajevo,2005,13,263761,263774,0.004928461485969049
12.0,BA002L1,Banja Luka,2005,16,275286,275302,0.005811799405743511
13.0,BA003L1,Mostar,2005,927,181420,182347,0.5083714017779289
14.0,BA004L1,Tuzla,2005,277,111984,112261,0.24674642128611007
15.0,BA005L1,Zenica,2005,1,86715,86716,0.0011531897227731907
16.0,BE001L2,Bruxelles / Brussel,2005,89,326562,326651,0.0272462046649176
17.0,BE002L2,Antwerpen,2005,3095,116117,119212,2.596215146126229
18.0,BE003L2,Gent,2005,237,101604,101841,0.23271570389136004
19.0,BE004L2,Charleroi,2005,334,109431,109765,0.30428643010066964
20.0,BE005L2,LiÃ¨ge,2005,49,141349,141398,0.034653955501492244
21.0,BE006L2,Brugge,2005,918,55621,56539,1.6236580059781742
22.0,BE007L2,Namur,2005,3,84104,84107,0.0035668850392951835
23.0,BE008L1,Leuven,2005,14,45062,45076,0.031058656491259207
24.0,BE009L1,Mons,2005,8,39192,39200,0.020408163265306124
25.0,BE010L1,Kortrijk,2005,3,22336,22339,0.01342942835399973
26.0,BE011L1,Oostende,2005,233,20699,20932,1.1131282247276897
27.0,BG001L2,Sofia,2005,9509,562265,571774,1.663069674381836
28.0,BG002L2,Plovdiv,2005,262,276824,277086,0.0945554809698072
29.0,BG003L2,Varna,2005,3777,201021,204798,1.8442562915653473
30.0,BG004L2,Burgas,2005,5136,290764,295900,1.7357215275430888
31.0,BG005L1,Pleven,2005,1090,177986,179076,0.6086801134713753
32.0,BG006L2,Ruse,2005,2631,131386,134017,1.9631837751926995
33.0,BG007L2,Vidin,2005,1838,59126,60964,3.014894035824421
34.0,BG008L2,Stara Zagora,2005,0,132068,132068,0.0
35.0,BG009L1,Sliven,2005,22,136752,136774,0.016084928422068524
36.0,BG010L1,Dobrich,2005,3,140335,140338,0.0021376961336202595
37.0,BG011L1,Shumen,2005,46,94461,94507,0.04867364322219518
38.0,BG013L1,Yambol,2005,200,130606,130806,0.1528981850985429
39.0,BG014L1,Haskovo,2005,406,73562,73968,0.5488860047588145
40.0,BG015L1,Pazardzhik,2005,12,63810,63822,0.01880229387985334
41.0,BG016L1,Blagoevgrad,2005,16,135463,135479,0.011809948405287905
42.0,BG017L1,Veliko Tarnovo,2005,5,88534,88539,0.005647228904776426
43.0,BG018L1,Vratsa,2005,548,70009,70557,0.7766770129115467
44.0,CH001L2,ZÃ¼rich,2005,62,127655,127717,0.048544829584158726
45.0,CH002L2,GenÃ¨ve,2005,241,53656,53897,0.44714919197729003
46.0,CH003L2,Basel,2005,157,69263,69420,0.22615960818208009
47.0,CH004L2,Bern,2005,9,78279,78288,0.011496014714898835
48.0,CH005L2,Lausanne,2005,46,77459,77505,0.05935100961228308
49.0,CH006L1,Winterthur,2005,0,13291,13291,0.0
50.0,CH007L2,St. Gallen,2005,177,31732,31909,0.5547024350496724
51.0,CH008L2,Luzern,2005,0,29259,29259,0.0
52.0,CH009L2,Lugano,2005,23,30602,30625,0.07510204081632653
53.0,CH010L1,Biel/Bienne,2005,7,9088,9095,0.07696536558548653
54.0,CY001L2,Lefkosia,2005,44,162584,162628,0.02705561157980176
55.0,CY501L2,Lemesos,2005,1702,124197,125899,1.351877298469408
56.0,CZ001L2,Praha,2005,771,569791,570562,0.1351299245305506
57.0,CZ002L2,Brno,2005,260,267655,267915,0.09704570479443107
58.0,CZ003L2,Ostrava,2005,470,142196,142666,0.32944079177940083
59.0,CZ004L2,PlzeÅ,2005,238,195719,195957,0.12145521721602189
60.0,CZ005L2,ÃstÃ­ nad Labem,2005,36,35875,35911,0.10024783492523183
61.0,CZ006L2,Olomouc,2005,36,93528,93564,0.038476337052712584
62.0,CZ007L2,Liberec,2005,0,61316,61316,0.0
63.0,CZ008L2,ÄeskÃ© BudÄjovice,2005,1016,128388,129404,0.7851380173719514
64.0,CZ009L2,Hradec KrÃ¡lovÃ©,2005,7,79498,79505,0.008804477705804666
65.0,CZ010L2,Pardubice,2005,17,86340,86357,0.019685723218731545
66.0,CZ011L2,ZlÃ­n,2005,14,57938,57952,0.024157923799006074
67.0,CZ013L2,Karlovy Vary,2005,85,46899,46984,0.1809126511152733
68.0,CZ014L2,Jihlava,2005,0,96027,96027,0.0
69.0,CZ016L2,Most,2005,104,27674,27778,0.37439700482396143
70.0,CZ018L2,Chomutov-Jirkov,2005,217,45469,45686,0.4749813947379941
71.0,DE001L1,Berlin,2005,14381,1733884,1748265,0.822586964790807
72.0,DE002L1,Hamburg,2005,4397,729777,734174,0.5989043469259331
73.0,DE003L1,MÃ¼nchen,2005,1220,548721,549941,0.22184197941233696
74.0,DE004L1,KÃ¶ln,2005,638,161992,162630,0.3923015433806801
75.0,DE005L1,Frankfurt am Main,2005,655,429676,430331,0.15220841631209464
76.0,DE007L1,Stuttgart,2005,143,365027,365170,0.039159843360626556
77.0,DE008L2,Leipzig,2005,3622,394067,397689,0.9107619270334356
78.0,DE009L2,Dresden,2005,3781,579415,583196,0.6483240625793043
79.0,DE011L1,DÃ¼sseldorf,2005,225,120092,120317,0.18700599250313754
80.0,DE012L1,Bremen,2005,1021,588518,589539,0.17318616749697643
81.0,DE013L1,Hannover,2005,1811,295501,297312,0.6091244214831557
82.0,DE014L1,NÃ¼rnberg,2005,123,293378,293501,0.04190786402772052
83.0,DE017L0,Bielefeld,2005,0,25883,25883,0.0
84.0,DE018L1,Halle an der Saale,2005,1343,156243,157586,0.8522330663891462
85.0,DE019L2,Magdeburg,2005,950,416084,417034,0.22779917224974464
86.0,DE020L1,Wiesbaden,2005,905,100533,101438,0.8921705869595221
87.0,DE021L1,GÃ¶ttingen,2005,120,238837,238957,0.050218240101775634
88.0,DE025L1,Darmstadt,2005,22,78165,78187,0.028137669945131547
89.0,DE026L1,Trier,2005,35,121092,121127,0.028895291718609394
90.0,DE027L1,Freiburg im Breisgau,2005,265,220931,221196,0.11980325141503463
91.0,DE028L1,Regensburg,2005,148,253514,253662,0.05834535720762274
92.0,DE029L0,Frankfurt (Oder),2005,95,14749,14844,0.6399892212341687
93.0,DE030L1,Weimar,2005,43,88985,89028,0.04829941142112593
94.0,DE031L1,Schwerin,2005,6194,483809,490003,1.2640738934251423
95.0,DE032L1,Erfurt,2005,570,284942,285512,0.1996413460730197
96.0,DE033L1,Augsburg,2005,7,199927,199934,0.0035011553812758214
97.0,DE034L1,Bonn,2005,478,128859,129337,0.36957715116324025
98.0,DE035L1,Karlsruhe,2005,558,125254,125812,0.44351890121768994
99.0,DE036L0,MÃ¶nchengladbach,2005,1,17022,17023,0.005874405216471833
100.0,DE037L1,Mainz,2005,812,69493,70305,1.154967640992817
101.0,DE038L1,Ruhrgebiet,2005,634,443118,443752,0.1428725955037949
102.0,DE039L1,Kiel,2005,4884,334878,339762,1.4374768220107015
103.0,DE040L1,SaarbrÃ¼cken,2005,7,153675,153682,0.004554860035658048
104.0,DE042L1,Koblenz,2005,843,91333,92176,0.9145547647977781
105.0,DE043L2,Rostock,2005,3853,357951,361804,1.0649412389028314
106.0,DE044L1,Kaiserslautern,2005,14,135513,135527,0.010330044935695469
107.0,DE045L1,Iserlohn,2005,19,106088,106107,0.017906452920165492
108.0,DE048L1,Wilhelmshaven,2005,142,73905,74047,0.19177009196861453
109.0,DE050L1,TÃ¼bingen,2005,11,52014,52025,0.02114368092263335
110.0,DE051L1,Villingen-Schwenningen,2005,20,102540,102560,0.01950078003120125
111.0,DE052L1,Flensburg,2005,681,204794,205475,0.3314271809222533
112.0,DE053L1,Marburg,2005,35,126207,126242,0.027724529079070356
113.0,DE054L1,Konstanz,2005,117,81783,81900,0.14285714285714285
114.0,DE055L0,NeumÃ¼nster,2005,10,7166,7176,0.13935340022296544
115.0,DE056L0,Brandenburg an der Havel,2005,2208,20622,22830,9.671484888304862
116.0,DE057L1,GieÃen,2005,9,85519,85528,0.010522869703488915
117.0,DE058L1,LÃ¼neburg,2005,49,132453,132502,0.03698057387813014
118.0,DE059L1,Bayreuth,2005,17,199903,199920,0.008503401360544217
119.0,DE060L1,Celle,2005,30,155017,155047,0.019348971602159346
120.0,DE061L1,Aschaffenburg,2005,107,147509,147616,0.07248536743984392
121.0,DE062L1,Bamberg,2005,96,122059,122155,0.07858867831852974
122.0,DE063L1,Plauen,2005,406,140882,141288,0.28735632183908044
123.0,DE064L1,Neubrandenburg,2005,20671,563320,583991,3.5396093432946736
124.0,DE065L1,Fulda,2005,0,138225,138225,0.0
125.0,DE066L1,Kempten (AllgÃ¤u),2005,1034,158133,159167,0.6496321473672306
126.0,DE067L1,Landshut,2005,144,141309,141453,0.10180059807851372
127.0,DE069L1,Rosenheim,2005,97,147666,147763,0.06564566231059196
128.0,DE071L1,Stralsund,2005,17839,320409,338248,5.2739410136940945
129.0,DE072L1,Friedrichshafen,2005,103,66516,66619,0.15461054654077663
130.0,DE073L1,Offenburg,2005,572,185312,185884,0.30771879236513094
131.0,DE074L1,GÃ¶rlitz,2005,1578,209529,211107,0.747488240560474
132.0,DE077L1,Schweinfurt,2005,47,201293,201340,0.023343597894109464
133.0,DE078L1,Greifswald,2005,3267,346527,349794,0.9339782843616529
134.0,DE079L1,Wetzlar,2005,33,106457,106490,0.030988825241806742
135.0,DE081L1,Passau,2005,672,159394,160066,0.4198268214361576
136.0,DE082L0,Dessau-RoÃlau,2005,131,24517,24648,0.5314832846478417
137.0,DE083L1,Braunschweig-Salzgitter-Wolfsburg,2005,664,412180,412844,0.16083556985205066
138.0,DE084L1,Mannheim-Ludwigshafen,2005,553,203875,204428,0.2705108889193261
139.0,DE504L1,MÃ¼nster,2005,23,141740,141763,0.01622426161974563
140.0,DE505L0,Chemnitz,2005,5,22188,22193,0.022529626458793313
141.0,DE507L1,Aachen,2005,24,70496,70520,0.03403289846851957
142.0,DE508L0,Krefeld,2005,44,13636,13680,0.32163742690058483
143.0,DE510L1,LÃ¼beck,2005,4503,157646,162149,2.777075405953783
144.0,DE513L1,Kassel,2005,37,139824,139861,0.02645483730275059
145.0,DE516L0,Solingen,2005,0,8954,8954,0.0
146.0,DE517L1,OsnabrÃ¼ck,2005,5,224125,224130,0.002230848168473654
147.0,DE520L1,Oldenburg (Oldenburg),2005,6,189963,189969,0.003158410056377619
148.0,DE522L1,Heidelberg,2005,167,116938,117105,0.14260706203834164
149.0,DE523L1,Paderborn,2005,119,124564,124683,0.09544204101601662
150.0,DE524L2,WÃ¼rzburg,2005,242,305687,305929,0.07910332135887739
151.0,DE527L1,Bremerhaven,2005,73,214406,214479,0.0340359662251316
152.0,DE529L1,Heilbronn,2005,84,119900,119984,0.07000933457794373
153.0,DE530L0,Remscheid,2005,0,7369,7369,0.0
154.0,DE532L1,Ulm,2005,101,199207,199308,0.05067533666486041
155.0,DE533L1,Pforzheim,2005,4,67144,67148,0.00595699052838506
156.0,DE534L1,Ingolstadt,2005,100,284735,284835,0.0351080450085137
157.0,DE535L1,Gera,2005,106,99680,99786,0.10622732647866434
158.0,DE537L1,Reutlingen,2005,0,109282,109282,0.0
159.0,DE539L1,Cottbus,2005,1185,181095,182280,0.6500987491770902
160.0,DE540L2,Siegen,2005,11,177553,177564,0.006194949426685589
161.0,DE542L1,Hildesheim,2005,15,120795,120810,0.012416190712689347
162.0,DE544L1,Zwickau,2005,50,94754,94804,0.052740390700814314
163.0,DE546L0,Wuppertal,2005,0,16833,16833,0.0
164.0,DE547L2,Jena,2005,4,93064,93068,0.004297932694374006
165.0,DE548L1,DÃ¼ren,2005,11,94027,94038,0.0116973989238393
166.0,DE549L1,Bocholt,2005,40,142225,142265,0.02811654307102942
167.0,DK001L2,KÃ¸benhavn,2005,9938,281285,291223,3.412505193614515
168.0,DK002L3,Ãrhus,2005,3560,458964,462524,0.769689789070405
169.0,DK003L2,Odense,2005,6283,353556,359839,1.746058654009154
170.0,DK004L3,Aalborg,2005,3674,616785,620459,0.5921422688686924
171.0,EE001L1,Tallinn,2005,5123,433938,439061,1.166808256711482
172.0,EE002L1,Tartu,2005,697,298945,299642,0.23261091569272666
173.0,EE003L0,Narva,2005,283,6606,6889,4.1079982580926115
174.0,EL001L1,Athina,2005,5212,304175,309387,1.6846215257913226
175.0,EL002L1,Thessaloniki,2005,1549,140570,142119,1.0899316769749294
176.0,EL003L1,Patra,2005,685,50905,51590,1.3277767009110293
177.0,EL004L1,Irakleio,2005,1087,60297,61384,1.7708197575915547
178.0,EL005L1,Larisa,2005,100,155419,155519,0.06430082497958449
179.0,EL006L1,Volos,2005,278,30538,30816,0.902128764278297
180.0,EL007L1,Ioannina,2005,2026,130615,132641,1.5274311864355667
181.0,EL008L1,Kavala,2005,329,35239,35568,0.9249887539361225
182.0,EL009L1,Kalamata,2005,270,44182,44452,0.6073967425537659
183.0,ES001L3,Madrid,2005,2552,785051,787603,0.3240211121592985
184.0,ES002L2,Barcelona,2005,1554,263053,264607,0.5872860506335812
185.0,ES003L3,Valencia,2005,3254,171866,175120,1.8581544084056645
186.0,ES004L3,Sevilla,2005,4359,464067,468426,0.9305632052874947
187.0,ES005L2,Zaragoza,2005,200,275938,276138,0.07242755433877264
188.0,ES006L2,MÃ¡laga,2005,901,151841,152742,0.5898835945581438
189.0,ES007L2,Murcia,2005,104,120032,120136,0.0865685556369448
190.0,ES008L2,Las Palmas,2005,76596,0,76596,100.0
191.0,ES009L2,Valladolid,2005,161,115368,115529,0.13935894883535735
192.0,ES010L2,Palma de Mallorca,2005,2319,201915,204234,1.135462263873792
193.0,ES011L2,Santiago de Compostela,2005,5,126251,126256,0.003960207831707007
194.0,ES012L2,Vitoria/Gasteiz,2005,422,158899,159321,0.2648740592891081
195.0,ES013L2,Oviedo,2005,37,93450,93487,0.03957769529453293
196.0,ES014L3,Pamplona/IruÃ±a,2005,275,169239,169514,0.16222848850242458
197.0,ES015L2,Santander,2005,388,69095,69483,0.5584099707842206
198.0,ES016L2,Toledo,2005,464,92934,93398,0.49679864665196255
199.0,ES017L2,Badajoz,2005,709,218040,218749,0.3241157673863652
200.0,ES018L2,LogroÃ±o,2005,82,46056,46138,0.1777276865057003
201.0,ES019L3,Bilbao,2005,900,152421,153321,0.5870037372571272
202.0,ES020L2,CÃ³rdoba,2005,1199,185703,186902,0.6415126643909643
203.0,ES021L2,Alicante/Alacant,2005,437,35621,36058,1.2119363248100283
204.0,ES022L2,Vigo,2005,1142,135329,136471,0.8368078199764052
205.0,ES023L2,GijÃ³n,2005,806,52596,53402,1.5093067675367964
206.0,ES025L3,Santa Cruz de Tenerife,2005,66983,0,66983,100.0
207.0,ES026L2,CoruÃ±a (A),2005,726,75249,75975,0.9555774925962488
208.0,ES028L1,Reus,2005,0,11534,11534,0.0
209.0,ES031L1,Lugo,2005,5,134006,134011,0.00373103700442501
210.0,ES033L1,Girona,2005,2,39619,39621,0.005047828171929028
211.0,ES034L1,CÃ¡ceres,2005,1953,236320,238273,0.8196480507652987
212.0,ES035L1,Torrevieja,2005,1731,7107,8838,19.585879158180582
213.0,ES039L1,AvilÃ©s,2005,459,18683,19142,2.3978685612788633
214.0,ES040L1,Talavera de la Reina,2005,556,82710,83266,0.6677395335431029
215.0,ES041L1,Palencia,2005,7,28374,28381,0.02466438814699975
216.0,ES043L1,Ferrol,2005,803,46167,46970,1.7096018735362997
217.0,ES044L1,Pontevedra,2005,218,51398,51616,0.4223496590204588
218.0,ES046L1,Gandia,2005,250,17087,17337,1.442002653284882
219.0,ES048L1,Guadalajara,2005,31,45352,45383,0.06830751603023158
220.0,ES050L1,Manresa,2005,3,29600,29603,0.010134108029591596
221.0,ES053L1,Ciudad Real,2005,624,95721,96345,0.6476724272146972
222.0,ES054L1,Benidorm,2005,323,20350,20673,1.562424418323417
223.0,ES057L1,Ponferrada,2005,252,62091,62343,0.4042153890573119
224.0,ES059L1,Zamora,2005,320,33860,34180,0.9362200117027502
225.0,ES070L1,Irun,2005,113,7129,7242,1.5603424468378901
226.0,ES072L1,Arrecife,2005,58934,0,58934,100.0
227.0,ES501L3,Granada,2005,350,162274,162624,0.21522038567493113
228.0,ES505L1,Elche/Elx,2005,707,38111,38818,1.8213200061826986
229.0,ES506L1,Cartagena,2005,1549,59399,60948,2.5415107960884686
230.0,ES508L1,Jerez de la Frontera,2005,173,125933,126106,0.13718617670848335
231.0,ES510L1,Donostia-San SebastiÃ¡n,2005,341,32979,33320,1.0234093637454982
232.0,ES514L1,AlmerÃ­a,2005,743,39987,40730,1.824208200343727
233.0,ES515L1,Burgos,2005,1,149390,149391,0.0006693843671974885
234.0,ES516L1,Salamanca,2005,17,45627,45644,0.03724476382437999
235.0,ES519L1,Albacete,2005,13,245312,245325,0.005299093039845104
236.0,ES520L1,CastellÃ³n/CastellÃ³,2005,450,32344,32794,1.3722022321156309
237.0,ES521L1,Huelva,2005,3935,93485,97420,4.039211660849928
238.0,ES522L1,CÃ¡diz,2005,1108,23725,24833,4.461804856441026
239.0,ES523L1,LeÃ³n,2005,1,118886,118887,0.0008411348591519679
240.0,ES525L1,Tarragona,2005,503,21237,21740,2.313707451701932
241.0,ES527L1,JaÃ©n,2005,31,99900,99931,0.03102140476929081
242.0,ES528L1,Lleida,2005,111,70564,70675,0.1570569508312699
243.0,ES529L1,Ourense,2005,314,64854,65168,0.48183157377854163
244.0,ES532L1,Algeciras,2005,655,41639,42294,1.5486830283255308
245.0,ES533L1,Marbella,2005,588,68617,69205,0.8496495917925004
246.0,ES537L1,Alcoy,2005,0,20529,20529,0.0
247.0,ES538L1,Ãvila,2005,473,53173,53646,0.8817059985833055
248.0,ES542L1,Cuenca,2005,65,164517,164582,0.039493990837394126
249.0,ES543L1,Eivissa,2005,2106,57296,59402,3.545335173899869
250.0,ES544L1,Linares,2005,13,25763,25776,0.05043451272501552
251.0,ES545L1,Lorca,2005,108,182099,182207,0.059273244167348124
252.0,ES546L1,MÃ©rida,2005,969,127330,128299,0.7552669935073539
253.0,ES547L1,Sagunto,2005,282,15246,15528,1.8160741885625966
254.0,ES550L1,Puerto de la Cruz,2005,27472,0,27472,100.0
255.0,ES552L1,Igualada,2005,4,25422,25426,0.015731927947769998
256.0,FI001L3,Helsinki,2005,16027,475491,491518,3.260714765278179
257.0,FI002L3,Tampere,2005,65963,622680,688643,9.578693169029526
258.0,FI003L4,Turku,2005,20163,446281,466444,4.322705405150457
259.0,FI004L4,Oulu,2005,5174,718647,723821,0.7148176137470452
260.0,FI007L2,Lahti,2005,29634,305769,335403,8.835341365461847
261.0,FI008L2,Kuopio,2005,106747,813659,920406,11.597816615710894
262.0,FI009L2,JyvÃ¤skylÃ¤,2005,27000,449942,476942,5.661065706102629
263.0,FR001L1,Paris,2005,1117,1208835,1209952,0.09231771177699612
264.0,FR003L2,Lyon,2005,739,366492,367231,0.20123573445596912
265.0,FR004L2,Toulouse,2005,743,523929,524672,0.14161228348377652
266.0,FR006L2,Strasbourg,2005,1156,202727,203883,0.566991853170691
267.0,FR007L2,Bordeaux,2005,4762,550992,555754,0.8568539317755699
268.0,FR008L2,Nantes,2005,2831,313788,316619,0.894134590785771
269.0,FR009L2,Lille,2005,22,144431,144453,0.015229867154022416
270.0,FR010L2,Montpellier,2005,7296,216622,223918,3.258335640725623
271.0,FR011L2,Saint-Etienne,2005,187,180868,181055,0.1032835326282069
272.0,FR012L2,Le Havre,2005,997,75441,76438,1.304325073916115
273.0,FR013L2,Rennes,2005,465,381672,382137,0.12168410805548796
274.0,FR014L2,Amiens,2005,51,244744,244795,0.02083375885945383
275.0,FR016L2,Nancy,2005,142,283367,283509,0.05008659337093355
276.0,FR017L2,Metz,2005,63,176867,176930,0.03560730232295258
277.0,FR018L2,Reims,2005,38,243113,243151,0.015628148763525546
278.0,FR019L2,OrlÃ©ans,2005,224,291743,291967,0.07672099929101577
279.0,FR020L2,Dijon,2005,139,385622,385761,0.03603267307996402
280.0,FR021L2,Poitiers,2005,62,250380,250442,0.02475623098362096
281.0,FR022L2,Clermont-Ferrand,2005,71,266055,266126,0.026679091858743603
282.0,FR023L2,Caen,2005,48706,177567,226273,21.52532560225922
283.0,FR024L2,Limoges,2005,10,317824,317834,0.003146296494396446
284.0,FR025L2,BesanÃ§on,2005,35,239001,239036,0.01464214595291086
285.0,FR026L2,Grenoble,2005,1348,264500,265848,0.5070566639583521
286.0,FR027L2,Ajaccio,2005,1483,145526,147009,1.00878177526546
289.0,FR032L2,Toulon,2005,2197,104859,107056,2.0521969810192795
290.0,FR034L2,Valenciennes,2005,63,78383,78446,0.08031002218086328
291.0,FR035L2,Tours,2005,366,284482,284848,0.12848958040779646
292.0,FR036L2,Angers,2005,126,231125,231251,0.054486250870266505
293.0,FR037L2,Brest,2005,442,134552,134994,0.32742195949449604
294.0,FR038L2,Le Mans,2005,8,224103,224111,0.0035696596775704895
295.0,FR039L1,Avignon,2005,1472,85753,87225,1.6875895672112353
296.0,FR040L2,Mulhouse,2005,152,129614,129766,0.11713391797543271
297.0,FR042L2,Dunkerque,2005,1211,89914,91125,1.3289437585733883
298.0,FR043L2,Perpignan,2005,1509,181521,183030,0.82445500737584
299.0,FR044L2,NÃ®mes,2005,1348,149143,150491,0.8957346286488893
300.0,FR045L2,Pau,2005,51,201708,201759,0.02527768277995034
301.0,FR046L2,Bayonne,2005,1019,101611,102630,0.992887070057488
302.0,FR047L0,Annemasse,2005,7,7793,7800,0.08974358974358974
303.0,FR048L2,Annecy,2005,2342,116701,119043,1.967356333425737
304.0,FR049L2,Lorient,2005,433,112749,113182,0.3825696665547525
305.0,FR050L2,MontbÃ©liard,2005,33,123024,123057,0.026816840976133013
306.0,FR051L2,Troyes,2005,78,260872,260950,0.02989078367503353
307.0,FR052L2,Saint-Nazaire,2005,372,106763,107135,0.3472254632006347
308.0,FR053L2,La Rochelle,2005,124,111216,111340,0.1113705766121789
309.0,FR056L2,AngoulÃªme,2005,7,214285,214292,0.003266570847255147
310.0,FR057L2,Boulogne-sur-Mer,2005,7096,61442,68538,10.353380606378943
311.0,FR058L2,ChambÃ©ry,2005,2727,98962,101689,2.6817059858981795
312.0,FR059L2,Chalon-sur-SaÃ´ne,2005,139,156219,156358,0.08889855331994524
313.0,FR060L2,Chartres,2005,15,161345,161360,0.009295984134853743
314.0,FR061L2,Niort,2005,15,178904,178919,0.008383682001352567
315.0,FR062L2,Calais,2005,1492,48738,50230,2.970336452319331
316.0,FR063L2,BÃ©ziers,2005,435,84708,85143,0.5109051830449949
317.0,FR064L2,Arras,2005,3,107560,107563,0.0027890631536866767
318.0,FR065L2,Bourges,2005,14,250305,250319,0.0055928635061661324
319.0,FR066L2,Saint-Brieuc,2005,138,115043,115181,0.11981142723192194
320.0,FR067L2,Quimper,2005,743,121179,121922,0.609406013680878
321.0,FR068L2,Vannes,2005,793,120241,121034,0.6551877984698515
322.0,FR069L2,Cherbourg,2005,714,90004,90718,0.7870543883242576
323.0,FR073L2,Tarbes,2005,12,104317,104329,0.01150207516606121
324.0,FR074L2,CompiÃ¨gne,2005,50,98687,98737,0.05063957786847889
325.0,FR076L2,Belfort,2005,53,65566,65619,0.08076928938264831
326.0,FR077L2,Roanne,2005,166,123034,123200,0.13474025974025974
327.0,FR079L2,Saint-Quentin,2005,11,99363,99374,0.011069293779056896
328.0,FR082L2,Beauvais,2005,0,131142,131142,0.0
329.0,FR084L2,Creil,2005,16,29627,29643,0.05397564349087474
330.0,FR086L2,Evreux,2005,654,125916,126570,0.5167101208817255
331.0,FR090L2,ChÃ¢teauroux,2005,38,261139,261177,0.014549520057279162
332.0,FR093L2,Brive-la-Gaillarde,2005,0,132582,132582,0.0
333.0,FR096L2,Albi,2005,91,134147,134238,0.06779004454774355
334.0,FR099L2,FrÃ©jus,2005,425,43988,44413,0.9569270258708036
335.0,FR104L2,ChÃ¢lons-en-Champagne,2005,24,152785,152809,0.01570588119809697
336.0,FR203L2,Marseille,2005,2799,422977,425776,0.6573879222877758
337.0,FR205L2,Nice,2005,1073,306267,307340,0.3491247478362725
338.0,FR207L2,Lens - LiÃ©vin,2005,30,25278,25308,0.11853959222380275
339.0,FR208L1,HÃ©nin - Carvin,2005,4,11594,11598,0.03448870494912916
340.0,FR209L2,Douai,2005,64,45020,45084,0.1419572353828409
341.0,FR214L1,Valence,2005,471,90490,90961,0.5178043337254428
342.0,FR215L2,Rouen,2005,16821,270305,287126,5.858403627675655
343.0,FR304L1,Melun,2005,0,44836,44836,0.0
344.0,FR324L1,Martigues,2005,1712,18744,20456,8.369182635901447
345.0,FR505L1,Charleville-MÃ©ziÃ¨res,2005,0,135369,135369,0.0
346.0,FR506L1,Colmar,2005,142,101843,101985,0.13923616218071286
347.0,FR519L1,Cannes,2005,502,19634,20136,2.493047278506158
348.0,HR001L2,Grad Zagreb,2005,34,505834,505868,0.00672112092482624
349.0,HR002L2,Rijeka,2005,344,106890,107234,0.32079377809276904
350.0,HR003L2,Slavonski Brod,2005,292,97538,97830,0.29847694981089645
351.0,HR004L2,Osijek,2005,1265,171669,172934,0.7314929395029318
352.0,HR005L2,Split,2005,3377,335693,339070,0.9959595363789188
353.0,HR006L1,Pula - Pola,2005,1289,57608,58897,2.188566480465898
354.0,HR007L1,Zadar,2005,2440,154060,156500,1.5591054313099042
355.0,HU001L2,Budapest,2005,5671,633463,639134,0.8872943701946696
356.0,HU002L2,Miskolc,2005,83,164586,164669,0.050404144070833004
357.0,HU003L2,NyÃ­regyhÃ¡za,2005,192,168033,168225,0.11413285777975926
358.0,HU004L2,PÃ©cs,2005,22,185466,185488,0.01186060553782455
359.0,HU005L2,Debrecen,2005,346,201232,201578,0.17164571530623382
360.0,HU006L2,Szeged,2005,672,160261,160933,0.4175650736641957
361.0,HU007L2,GyÃµr,2005,423,204217,204640,0.206704456606724
362.0,HU008L2,KecskemÃ©t,2005,78,182061,182139,0.04282443628218009
363.0,HU009L2,SzÃ©kesfehÃ©rvÃ¡r,2005,981,300142,301123,0.3257804950136655
364.0,HU010L1,Szombathely,2005,1,134276,134277,0.0007447291792339716
365.0,HU011L1,Szolnok,2005,758,143217,143975,0.526480291717312
366.0,HU012L1,TatabÃ¡nya,2005,109,69721,69830,0.15609336961191464
367.0,HU013L1,VeszprÃ©m,2005,7150,124170,131320,5.4447151995126415
368.0,HU014L1,BÃ©kÃ©scsaba,2005,82,106081,106163,0.07723971628533483
369.0,HU015L1,KaposvÃ¡r,2005,1,145559,145560,0.0006870019236053861
370.0,HU016L1,Eger,2005,121,100457,100578,0.12030463918550777
371.0,HU017L1,DunaÃºjvÃ¡ros,2005,742,60928,61670,1.2031782065834278
372.0,HU018L1,Zalaegerszeg,2005,179,139800,139979,0.1278763243057887
373.0,HU019L1,Sopron,2005,43,80627,80670,0.053303582496591055
374.0,IE001L1,Dublin,2005,12421,691181,703602,1.765344612437145
375.0,IE002L1,Cork,2005,5178,324485,329663,1.5706949217837611
376.0,IE003L1,Limerick,2005,5062,151396,156458,3.2353730713673956
377.0,IE004L1,Galway,2005,2771,223512,226283,1.2245727694966038
378.0,IE005L1,Waterford,2005,1088,94769,95857,1.1350240462355383
379.0,IS001L1,ReykjavÃ­k,2005,1297230,0,1297230,100.0
380.0,IT001L3,Roma,2005,8966,608250,617216,1.4526519079220241
381.0,IT002L3,Milano,2005,23,384022,384045,0.005988881511281231
382.0,IT003L3,Napoli,2005,3806,149136,152942,2.488525061788129
383.0,IT004L2,Torino,2005,61,170118,170179,0.035844610674642584
384.0,IT005L3,Palermo,2005,1831,148242,150073,1.2200728978563766
385.0,IT006L3,Genova,2005,616,120148,120764,0.5100857871551124
386.0,IT007L3,Firenze,2005,89,163682,163771,0.05434417570876407
387.0,IT008L3,Bari,2005,779,112650,113429,0.6867732237787515
388.0,IT009L1,Bologna,2005,43,185214,185257,0.02321099877467518
389.0,IT010L2,Catania,2005,589,60836,61425,0.9588929588929589
390.0,IT011L2,Venezia,2005,1806,65231,67037,2.6940346375881976
391.0,IT012L3,Verona,2005,54,73107,73161,0.07380981670562184
392.0,IT013L3,Cremona,2005,128,60269,60397,0.211931056178287
393.0,IT014L3,Trento,2005,612,97575,98187,0.6233004369213847
394.0,IT015L1,Trieste,2005,325,21312,21637,1.502056662199011
395.0,IT016L3,Perugia,2005,5689,125339,131028,4.341820068992887
396.0,IT017L3,Ancona,2005,659,43584,44243,1.4895011640259475
397.0,IT019L2,Pescara,2005,276,16167,16443,1.6785258164568508
398.0,IT020L3,Campobasso,2005,498,102337,102835,0.4842709194340448
399.0,IT021L2,Caserta,2005,1,9341,9342,0.010704345964461572
400.0,IT022L2,Taranto,2005,3488,103440,106928,3.262008080203502
401.0,IT023L2,Potenza,2005,77,138378,138455,0.055613737315373224
402.0,IT024L3,Catanzaro,2005,276,89807,90083,0.30638411242964825
403.0,IT025L3,Reggio di Calabria,2005,592,47656,48248,1.2269938650306749
404.0,IT026L3,Sassari,2005,2354,150871,153225,1.536302822646435
405.0,IT027L2,Cagliari,2005,4963,190329,195292,2.5413227372345
406.0,IT028L3,Padova,2005,3,61442,61445,0.004882415168036456
407.0,IT029L3,Brescia,2005,77,60192,60269,0.12776054024457018
408.0,IT030L3,Modena,2005,127,69141,69268,0.18334584512328925
409.0,IT031L3,Foggia,2005,6,89705,89711,0.006688143037085753
410.0,IT032L3,Salerno,2005,838,37001,37839,2.2146462644361637
411.0,IT033L2,Piacenza,2005,179,93948,94127,0.19016860199517674
412.0,IT034L1,Bolzano,2005,901,105855,106756,0.8439806661920641
413.0,IT035L2,Udine,2005,0,71830,71830,0.0
414.0,IT036L2,La Spezia,2005,673,42246,42919,1.568070085509914
415.0,IT037L1,Lecce,2005,341,61169,61510,0.5543814013981466
416.0,IT038L1,Barletta,2005,231,14866,15097,1.5301053189375373
417.0,IT039L2,Pesaro,2005,154,25537,25691,0.5994317076018839
418.0,IT040L2,Como,2005,146,19595,19741,0.7395775290005572
419.0,IT041L2,Pisa,2005,466,47587,48053,0.9697625538467942
420.0,IT042L1,Treviso,2005,32,24013,24045,0.13308380120607194
421.0,IT043L2,Varese,2005,464,23200,23664,1.9607843137254901
422.0,IT045L2,Asti,2005,4,54832,54836,0.0072944780800933695
423.0,IT046L2,Pavia,2005,1,36203,36204,0.002762125731963319
424.0,IT047L1,Massa,2005,232,11011,11243,2.063506181624122
425.0,IT048L2,Cosenza,2005,97,92382,92479,0.10488867742947047
426.0,IT052L1,Savona,2005,181,28524,28705,0.6305521686117401
427.0,IT054L1,Matera,2005,638,77151,77789,0.8201673758500558
428.0,IT056L1,Acireale,2005,52,5936,5988,0.8684034736138945
429.0,IT057L2,Avellino,2005,956,38803,39759,2.4044870343821527
430.0,IT058L2,Pordenone,2005,10,37040,37050,0.026990553306342778
431.0,IT060L1,Lecco,2005,1210,29002,30212,4.005031113464849
432.0,IT061L0,Altamura,2005,0,42800,42800,0.0
433.0,IT064L1,Battipaglia,2005,74,6412,6486,1.1409189022510022
434.0,IT065L0,Bisceglie,2005,92,6852,6944,1.3248847926267282
435.0,IT066L1,Carpi,2005,3,20619,20622,0.014547570555717195
436.0,IT067L0,Cerignola,2005,143,58754,58897,0.2427967468631679
437.0,IT068L1,Gallarate,2005,0,5319,5319,0.0
438.0,IT069L1,Gela,2005,459,57436,57895,0.792814578115554
439.0,IT073L1,Sassuolo,2005,0,24062,24062,0.0
440.0,IT501L2,Messina,2005,770,33673,34443,2.2355776209970095
441.0,IT502L2,Prato,2005,8,40951,40959,0.01953172684880002
442.0,IT503L3,Parma,2005,26,113481,113507,0.022906076277234004
443.0,IT504L3,Livorno,2005,384,25430,25814,1.4875648872704734
444.0,IT505L3,Reggio nell'Emilia,2005,1,69033,69034,0.0014485615783526957
445.0,IT506L2,Ravenna,2005,3382,77807,81189,4.165588934461565
446.0,IT507L2,Ferrara,2005,77,91406,91483,0.08416864335450303
447.0,IT508L3,Rimini,2005,339,32240,32579,1.0405475920071212
448.0,IT509L3,Siracusa,2005,550,33592,34142,1.6109191025716125
449.0,IT511L2,Bergamo,2005,0,18556,18556,0.0
450.0,IT512L3,ForlÃ¬,2005,5,72746,72751,0.006872757762779892
451.0,IT513L3,Latina,2005,530,65963,66493,0.7970763839802686
452.0,IT514L2,Vicenza,2005,1,34981,34982,0.0028586130009719286
453.0,IT515L2,Terni,2005,145,102187,102332,0.14169565727240746
454.0,IT516L2,Novara,2005,0,54165,54165,0.0
455.0,IT518L1,Alessandria,2005,25,76889,76914,0.0325038354525834
456.0,IT519L1,Arezzo,2005,12,88615,88627,0.013539891906529612
457.0,IT520L1,Grosseto,2005,378,119221,119599,0.3160561543156715
458.0,IT521L1,Brindisi,2005,872,63115,63987,1.3627768140403518
459.0,IT522L1,Trapani,2005,1002,49788,50790,1.9728292971057295
460.0,IT523L1,Ragusa,2005,269,52581,52850,0.5089877010406813
461.0,IT524L0,Andria,2005,0,39880,39880,0.0
462.0,IT525L0,Trani,2005,116,10263,10379,1.1176413912708354
463.0,IT526L1,L'Aquila,2005,227,140042,140269,0.16183190868973188
464.0,LT001L1,Vilnius,2005,2442,422127,424569,0.5751715268896221
465.0,LT002L1,Kaunas,2005,926,161125,162051,0.5714250452018191
466.0,LT003L1,PanevÄÅ¾ys,2005,31,222777,222808,0.013913324476679471
467.0,LT004L0,Alytus,2005,5,3954,3959,0.1262945188178833
468.0,LT501L0,KlaipÄda,2005,84,8839,8923,0.9413874257536703
469.0,LT502L0,Å iauliai,2005,878,7167,8045,10.9136109384711
470.0,LU001L1,Luxembourg,2005,50,259665,259715,0.019251872244575783
471.0,LV001L1,RÄ«ga,2005,7290,608959,616249,1.18296338006228
472.0,LV002L2,LiepÄja,2005,3432,268625,272057,1.2615003473536797
473.0,LV003L1,Jelgava,2005,13,166446,166459,0.007809730924732216
474.0,LV501L1,Daugavpils,2005,1494,258181,259675,0.5753345528063926
475.0,ME001L1,Podgorica,2005,1296,183185,184481,0.7025113697345526
476.0,MK001L1,Skopje,2005,14,224339,224353,0.006240166166710496
477.0,MK003L1,Bitola,2005,575,119087,119662,0.4805201317043004
478.0,MK004L1,Tetovo,2005,2043,103578,105621,1.9342744340614084
479.0,MK005L1,Prilep,2005,97,86734,86831,0.11171125519687669
480.0,MT001L1,Valletta,2005,985,24971,25956,3.794883649252581
481.0,NL001L3,s' Gravenhage,2005,833,41874,42707,1.950499918046222
482.0,NL002L3,Amsterdam,2005,66378,266579,332957,19.93590763972525
483.0,NL003L3,Rotterdam,2005,22873,194298,217171,10.532253385580947
484.0,NL004L3,Utrecht,2005,110,97177,97287,0.11306752186828661
485.0,NL005L3,Eindhoven,2005,171,144235,144406,0.11841613229367201
486.0,NL006L3,Tilburg,2005,25,43209,43234,0.05782486006383864
487.0,NL007L3,Groningen,2005,1886,206274,208160,0.9060338201383552
488.0,NL008L3,Enschede,2005,94,84862,84956,0.1106455106172607
489.0,NL009L3,Arnhem,2005,690,55208,55898,1.2343912125657448
490.0,NL010L3,Heerlen,2005,7,33336,33343,0.02099391176558798
491.0,NL012L3,Breda,2005,940,72430,73370,1.2811775930216711
492.0,NL013L3,Nijmegen,2005,529,39307,39836,1.327944572748268
493.0,NL014L3,Apeldoorn,2005,40,71084,71124,0.05623980653506552
494.0,NL015L3,Leeuwarden,2005,626,110297,110923,0.564355453783255
495.0,NL016L3,Sittard-Geleen,2005,6,22906,22912,0.026187150837988827
496.0,NL020L3,Roosendaal,2005,0,24574,24574,0.0
497.0,NL026L0,Alphen aan den Rijn,2005,0,13210,13210,0.0
498.0,NL028L3,Bergen op Zoom,2005,1375,33406,34781,3.9533078404876223
499.0,NL030L0,Gouda,2005,0,1788,1788,0.0
500.0,NL032L3,MiddelburgÂ Â Â Â Â Â ,2005,699,22689,23388,2.9887121600820934
501.0,NL503L3,s-Hertogenbosch,2005,40,36819,36859,0.10852166363710354
502.0,NL504L3,Amersfoort,2005,1,12243,12244,0.008167265599477294
503.0,NL505L3,Maastricht,2005,12,20373,20385,0.05886681383370125
504.0,NL507L3,Leiden,2005,134,19647,19781,0.6774177240786613
505.0,NL511L3,Zwolle,2005,1082,121938,123020,0.8795317834498455
506.0,NL512L3,Ede,2005,10,35255,35265,0.02835672763363108
507.0,NL513L3,Deventer,2005,71,25174,25245,0.28124381065557535
508.0,NL514L3,Alkmaar,2005,256,47536,47792,0.5356545028456646
509.0,NL515L3,Venlo,2005,102,51134,51236,0.19907877273791863
510.0,NL519L3,Almelo,2005,1,42024,42025,0.002379535990481856
511.0,NL520L3,Lelystad,2005,56889,61953,118842,47.86944009693543
512.0,NL521L3,Oss,2005,30,33116,33146,0.09050865866167863
513.0,NL522L3,Assen,2005,70,70792,70862,0.09878355112754368
514.0,NL524L3,Veenendaal,2005,5,8180,8185,0.061087354917532075
515.0,NL529L3,Soest,2005,0,7942,7942,0.0
516.0,NO001L1,Oslo,2005,29920,716723,746643,4.0072698732861625
517.0,NO002L1,Bergen,2005,32110,325633,357743,8.975717204809039
518.0,NO003L1,Trondheim,2005,161784,511472,673256,24.03008662381026
519.0,NO004L1,Stavanger,2005,25673,263404,289077,8.881024778865147
520.0,NO005L1,Kristiansand,2005,6346,309116,315462,2.0116527505690067
521.0,NO006L1,TromsÃ¸,2005,78733,295880,374613,21.017156372042614
522.0,PL001L2,Warszawa,2005,422,860821,861243,0.048998946870976015
523.0,PL002L2,ÅÃ³dÅº,2005,36,169464,169500,0.021238938053097345
524.0,PL003L2,KrakÃ³w,2005,972,374776,375748,0.2586840116248124
525.0,PL004L2,WrocÅaw,2005,126,264574,264700,0.04760105780128447
526.0,PL005L2,PoznaÅ,2005,332,308996,309328,0.10732943671442612
527.0,PL006L2,GdaÅsk,2005,1848,261668,263516,0.7012856904324595
528.0,PL007L2,Szczecin,2005,2234,110826,113060,1.97594197771095
529.0,PL008L2,Bydgoszcz,2005,897,209239,210136,0.42686641032474204
530.0,PL009L2,Lublin,2005,51,322733,322784,0.01580003965500149
531.0,PL010L2,Katowice,2005,1981,392614,394595,0.5020337307872629
532.0,PL011L2,BiaÅystok,2005,24,223298,223322,0.010746814017427749
533.0,PL012L2,Kielce,2005,16,224213,224229,0.007135562304608235
534.0,PL013L2,ToruÅ,2005,1355,157578,158933,0.8525605129205388
535.0,PL014L2,Olsztyn,2005,2971,199573,202544,1.466841772651868
536.0,PL015L2,RzeszÃ³w,2005,39,229310,229349,0.017004652298462167
537.0,PL016L2,Opole,2005,867,175749,176616,0.4908955021062644
538.0,PL017L2,GorzÃ³w Wielkopolski,2005,252,97168,97420,0.258673783617327
539.0,PL018L2,Zielona GÃ³ra,2005,157,169127,169284,0.0927435552089979
540.0,PL019L2,Jelenia GÃ³ra,2005,0,83341,83341,0.0
541.0,PL020L2,Nowy SÄcz,2005,1023,129395,130418,0.7844009262525111
542.0,PL021L2,SuwaÅki,2005,1376,70757,72133,1.9075873733242759
543.0,PL022L2,Konin,2005,542,117621,118163,0.4586884219256451
544.0,PL024L2,CzÄstochowa,2005,5,193893,193898,0.0025786753860277054
545.0,PL025L2,Radom,2005,1,68021,68022,0.001470112610625974
546.0,PL026L2,PÅock,2005,605,170470,171075,0.3536460616688587
547.0,PL027L2,Kalisz,2005,4,149019,149023,0.0026841494265985788
548.0,PL028L2,Koszalin,2005,266,129405,129671,0.2051345327791102
549.0,PL029L1,SÅupsk,2005,7960,227044,235004,3.3871763884870045
550.0,PL030L1,JastrzÄbie-ZdrÃ³j,2005,2,29569,29571,0.006763383044198708
551.0,PL031L1,Siedlce,2005,7,126162,126169,0.005548114037521102
552.0,PL032L1,PiotrkÃ³w Trybunalski,2005,41,116881,116922,0.03506611245103573
553.0,PL033L1,Lubin,2005,280,93026,93306,0.3000878828799863
554.0,PL034L1,PiÅa,2005,135,52057,52192,0.2586603310852238
555.0,PL035L1,InowrocÅaw,2005,35,20093,20128,0.17388712241653417
556.0,PL036L1,Ostrowiec ÅwiÄtokrzyski,2005,1,61459,61460,0.0016270745200130164
557.0,PL037L1,Gniezno,2005,16,66555,66571,0.024034489492421623
558.0,PL038L1,Stargard SzczeciÅski,2005,1526,35138,36664,4.162120881518656
559.0,PL039L1,OstrÃ³w Wielkopolski,2005,1,84760,84761,0.0011797878741402297
560.0,PL040L1,PrzemyÅl,2005,437,84652,85089,0.5135798986943083
561.0,PL041L1,ZamoÅÄ,2005,22,112685,112707,0.019519639419024553
562.0,PL042L1,CheÅm,2005,12,46558,46570,0.02576766158471119
563.0,PL043L1,Pabianice,2005,2,32957,32959,0.006068145271397797
564.0,PL044L1,GÅogÃ³w,2005,28,64053,64081,0.04369469889670885
565.0,PL045L1,Stalowa Wola,2005,209,190104,190313,0.10981908750321838
566.0,PL046L1,TomaszÃ³w Mazowiecki,2005,52,19111,19163,0.27135625945833114
567.0,PL047L1,ÅomÅ¼a,2005,0,56002,56002,0.0
568.0,PL048L1,Leszno,2005,102,77470,77572,0.13149074408291653
569.0,PL049L1,Åwidnica,2005,1,47989,47990,0.002083767451552407
570.0,PL051L1,Tczew,2005,91,27033,27124,0.3354962394927002
571.0,PL052L1,EÅk,2005,452,39600,40052,1.1285329072206132
572.0,PL506L2,Bielsko-BiaÅa,2005,551,72884,73435,0.7503234152652005
573.0,PL508L1,Rybnik,2005,226,14655,14881,1.5187151401115517
574.0,PL511L2,WaÅbrzych,2005,1,51509,51510,0.0019413706076490003
575.0,PL512L2,ElblÄg,2005,2,96473,96475,0.0020730759264058047
576.0,PL513L2,WÅocÅawek,2005,1031,121448,122479,0.8417769576825415
577.0,PL514L2,TarnÃ³w,2005,158,125169,125327,0.12607020035586905
578.0,PL516L2,Legnica,2005,5,56495,56500,0.008849557522123894
579.0,PL517L2,GrudziÄdz,2005,342,54701,55043,0.6213324128408698
580.0,PT001L3,Lisboa,2005,7460,431821,439281,1.6982296070169207
581.0,PT002L2,Porto,2005,1185,94555,95740,1.2377271777731356
582.0,PT003L1,Braga,2005,44,49305,49349,0.08916087458712435
583.0,PT004L2,Funchal,2005,35962,0,35962,100.0
584.0,PT005L2,Coimbra,2005,441,162346,162787,0.270906153439771
585.0,PT007L1,Ponta Delgada,2005,55294,0,55294,100.0
586.0,PT008L2,Aveiro,2005,1809,41521,43330,4.174936533579507
587.0,PT009L1,Faro,2005,2546,46604,49150,5.180061037639878
588.0,PT014L1,Viseu,2005,6,70868,70874,0.008465727911504925
589.0,PT016L0,Viana do Castelo,2005,408,31844,32252,1.265037827111497
590.0,PT019L0,PÃ³voa de Varzim,2005,49,8357,8406,0.582916964073281
591.0,PT505L1,GuimarÃ£es,2005,0,26541,26541,0.0
592.0,RO001L1,BucureÅti,2005,229,107613,107842,0.21234769384840788
593.0,RO002L1,Cluj-Napoca,2005,43,59259,59302,0.07251020201679538
594.0,RO003L1,TimiÅoara,2005,12,23642,23654,0.05073137735689524
595.0,RO004L1,Craiova,2005,187,34209,34396,0.5436678683567856
596.0,RO005L1,BrÄila,2005,1348,22181,23529,5.729100259254537
597.0,RO006L1,Oradea,2005,36,20303,20339,0.17699985250012293
598.0,RO007L1,BacÄu,2005,282,21811,22093,1.2764223962341013
599.0,RO008L1,Arad,2005,7,51601,51608,0.013563788559913192
600.0,RO009L1,Sibiu,2005,955,55385,56340,1.6950656727014555
601.0,RO010L1,TÃ¢rgu MureÅ,2005,55,13685,13740,0.4002911208151383
602.0,RO011L1,Piatra NeamÅ£,2005,87,14912,14999,0.5800386692446163
603.0,RO012L1,CÇlÇraÅi,2005,660,23884,24544,2.6890482398956976
604.0,RO013L1,Giurgiu,2005,569,10381,10950,5.19634703196347
605.0,RO014L1,Alba Iulia,2005,0,26002,26002,0.0
606.0,RO015L1,FocÅani,2005,6,27096,27102,0.022138587558113793
607.0,RO016L1,TÃ¢rgu Jiu,2005,47,24475,24522,0.1916646276812658
608.0,RO017L1,Tulcea,2005,1602,39345,40947,3.9123745329328155
609.0,RO018L1,TÃ¢rgoviÅte,2005,40,20217,20257,0.19746260551907982
610.0,RO019L1,Slatina,2005,275,6848,7123,3.8607328372876593
611.0,RO020L1,BÃ¢rlad,2005,96,26223,26319,0.3647554998290209
612.0,RO021L1,Roman,2005,12,14378,14390,0.08339124391938846
613.0,RO022L1,BistriÅ£a,2005,75,42556,42631,0.17592831507588375
614.0,RO501L1,Constanta,2005,5871,53480,59351,9.891998449899749
615.0,RO502L1,Iasi,2005,239,79697,79936,0.29898919135308244
616.0,RO503L1,Galati,2005,1121,40111,41232,2.7187621265036865
617.0,RO504L1,Brasov,2005,17377,81126,98503,17.641087073490148
618.0,RO505L1,Ploiesti,2005,2,34335,34337,0.005824620671578763
619.0,RO506L1,Pitesti,2005,204,24680,24884,0.8198038900498312
620.0,RO507L1,Baia Mare,2005,90,52451,52541,0.17129479834795686
621.0,RO508L1,Buzau,2005,7,38533,38540,0.018162947586922676
622.0,RO509L1,Satu Mare,2005,0,70844,70844,0.0
623.0,RO510L1,Botosani,2005,157,37183,37340,0.4204606320299947
624.0,RO511L1,Ramnicu Valcea,2005,1111,28062,29173,3.8083159085455733
625.0,RO512L1,Suceava,2005,109,39569,39678,0.2747114269872474
626.0,RO513L1,Drobeta-Turnu Severin,2005,2231,30703,32934,6.77415436934475
627.0,RS001L1,Beograd,2005,6536,306488,313024,2.088018810059293
628.0,RS002L1,Novi Sad,2005,2371,187072,189443,1.2515637949145655
629.0,RS003L1,NiÅ¡,2005,74,341490,341564,0.021665046667681608
630.0,RS004L1,Kragujevac,2005,34,144041,144075,0.02359882005899705
631.0,RS005L1,Subotica,2005,87,160205,160292,0.05427594639782397
632.0,RS006L1,Novi Pazar,2005,12,140779,140791,0.008523272084153106
633.0,RS008L1,Zrenjanin,2005,749,184382,185131,0.4045783796338809
634.0,RS009L1,Kraljevo,2005,0,176512,176512,0.0
635.0,RS011L0,ÄaÄak,2005,1,63686,63687,0.0015701791574418641
636.0,RS012L1,KruÅ¡evac,2005,4,122645,122649,0.003261339268970803
637.0,RS013L1,Leskovac,2005,6,166276,166282,0.0036083280210726354
638.0,RS014L1,Valjevo,2005,3,141659,141662,0.0021177168189069756
639.0,RS015L1,Vranje,2005,6,195350,195356,0.003071315956510166
640.0,RS016L1,Smederevo,2005,2181,158043,160224,1.3612192929898144
641.0,SE001L1,Stockholm,2005,56880,698846,755726,7.5265373958286474
642.0,SE002L1,GÃ¶teborg,2005,22709,412550,435259,5.217353345938855
643.0,SE003L1,MalmÃ¶,2005,3006,185010,188016,1.5988001021189686
644.0,SE004L1,JÃ¶nkÃ¶ping,2005,24689,322502,347191,7.111071427542765
645.0,SE005L1,UmeÃ¥,2005,17788,970461,988249,1.7999512268669131
646.0,SE006L1,Uppsala,2005,12181,685346,697527,1.7463123291284781
647.0,SE007L1,LinkÃ¶ping,2005,13708,409488,423196,3.2391610506715565
648.0,SE008L1,Ãrebro,2005,21610,346987,368597,5.862771536393406
649.0,SE501L1,VÃ¤sterÃ¥s,2005,17342,273073,290415,5.971454642494361
650.0,SE502L1,NorrkÃ¶ping,2005,14074,297664,311738,4.514688616723017
651.0,SE503L1,Helsingborg,2005,730,113692,114422,0.6379891978815263
652.0,SE505L1,BorÃ¥s,2005,383,96979,97362,0.3933772929890512
653.0,SI001L2,Ljubljana,2005,142,233145,233287,0.06086922974704977
654.0,SI002L1,Maribor,2005,656,216329,216985,0.3023250455100583
655.0,SK001L1,Bratislava,2005,768,204173,204941,0.3747419989167614
656.0,SK002L1,KoÅ¡ice,2005,191,177443,177634,0.10752446040735444
657.0,SK003L1,BanskÃ¡ Bystrica,2005,0,80880,80880,0.0
658.0,SK004L1,Nitra,2005,1,87126,87127,0.0011477498364456482
659.0,SK005L1,PreÅ¡ov,2005,1,93298,93299,0.0010718228491194976
660.0,SK006L1,Å½ilina,2005,171,81277,81448,0.20994990668893035
661.0,SK007L1,Trnava,2005,78,74142,74220,0.10509296685529508
662.0,SK008L1,TrenÄÃ­n,2005,7,67416,67423,0.01038221378461356
739.0,UK001L3,London,2005,1644,696526,698170,0.23547273586662273
740.0,UK002L3,West Midlands urban area,2005,359,214950,215309,0.1667371080632951
741.0,UK003L2,Leeds,2005,1229,511198,512427,0.23983904048771823
742.0,UK004L1,Glasgow,2005,3824,333860,337684,1.1324196586157473
743.0,UK006L3,Liverpool,2005,623,99880,100503,0.6198819935723312
744.0,UK007L1,Edinburgh,2005,1450,173968,175418,0.8265970424927888
745.0,UK008L3,Greater Manchester,2005,948,311298,312246,0.3036067715839434
746.0,UK009L1,Cardiff,2005,128,84363,84491,0.15149542554828327
747.0,UK010L3,Sheffield,2005,189,125898,126087,0.14989650003568966
748.0,UK011L2,Bristol,2005,188,98197,98385,0.19108603953854753
749.0,UK012L2,Belfast,2005,21750,173395,195145,11.145558430910349
750.0,UK013L2,Newcastle upon Tyne,2005,5621,541087,546708,1.028153968846258
751.0,UK014L1,Leicester,2005,99,139682,139781,0.07082507636946365
752.0,UK016L1,Aberdeen,2005,23987,629961,653948,3.6680286505960717
753.0,UK017L2,Cambridge,2005,50,159569,159619,0.0313245916839474
754.0,UK018L3,Exeter,2005,6058,241668,247726,2.44544375640829
755.0,UK019L3,Lincoln,2005,4233,207310,211543,2.0010116146599035
756.0,UK023L1,Portsmouth,2005,318,20535,20853,1.5249604373471444
757.0,UK024L1,Worcester,2005,12,61190,61202,0.019607202379007222
758.0,UK025L3,Coventry,2005,58,81389,81447,0.07121195378589758
759.0,UK026L1,Kingston upon Hull,2005,7281,244417,251698,2.8927524255258286
760.0,UK027L1,Stoke-on-Trent,2005,58,88118,88176,0.06577753583741608
761.0,UK029L1,Nottingham,2005,136,90153,90289,0.15062742969796986
762.0,UK033L1,Guildford,2005,10,61681,61691,0.016209819908900813
763.0,UK050L1,Burnley,2005,63,27911,27974,0.22520912275684565
764.0,UK056L1,Hastings,2005,186,54564,54750,0.33972602739726027
765.0,UK515L1,Brighton and Hove,2005,234,42173,42407,0.5517956941071049
766.0,UK516L1,Plymouth,2005,5243,210532,215775,2.429845904298459
767.0,UK517L1,Swansea,2005,420,83622,84042,0.49975012493753124
768.0,UK518L1,Derby,2005,48,68054,68102,0.0704825115268274
769.0,UK520L2,Southampton,2005,1081,152271,153352,0.7049141843601648
770.0,UK528L1,Northampton,2005,112,154433,154545,0.07247080138470996
771.0,UK539L1,Bournemouth,2005,1109,92684,93793,1.1823910099900847
772.0,UK546L1,Colchester,2005,778,68717,69495,1.119505000359738
773.0,UK550L0,Dundee City,2005,951,225465,226416,0.42002331990672037
774.0,UK551L1,Falkirk,2005,123,29666,29789,0.41290409211453893
775.0,UK552L0,Reading,2005,2,21919,21921,0.00912367136535742
776.0,UK553L1,Blackpool,2005,100,48855,48955,0.2042692268409764
777.0,UK557L1,Blackburn with Darwen,2005,195,79359,79554,0.24511652462478314
778.0,UK558L1,Newport,2005,33,31667,31700,0.10410094637223975
779.0,UK559L2,Middlesbrough,2005,930,60839,61769,1.505609609998543
780.0,UK560L1,Oxford,2005,19,192904,192923,0.009848488775314503
781.0,UK562L2,Preston,2005,19,25743,25762,0.07375203788525735
782.0,UK566L1,Norwich,2005,9,150231,150240,0.0059904153354632585
783.0,UK568L1,Cheshire West and Chester,2005,532,135613,136145,0.39075985162877813
784.0,UK569L2,Ipswich,2005,1489,154157,155646,0.9566580573866338
785.0,UK571L1,Cheltenham,2005,17,46166,46183,0.03681008163176926
786.0,XK001L1,Pristina,2005,12,255795,255807,0.004691036601813086
787.0,XK002L1,Prizren,2005,1217,126416,127633,0.953515156738461
788.0,XK003L1,MitrovicÃ«,2005,0,117914,117914,0.0
1.0,AL001L1,Tirana,2006,1589,165532,167121,0.9508080971272311
2.0,AL003L1,Elbasan,2006,619,125385,126004,0.49125424589695565
3.0,AL004L1,ShkodÃ«r,2006,9953,175376,185329,5.370449309066578
4.0,AL005L0,VlorÃ«,2006,2252,61481,63733,3.5334912839502297
5.0,AT001L3,Wien,2006,3124,915366,918490,0.3401234635107622
6.0,AT002L3,Graz,2006,146,290986,291132,0.050149073272604865
7.0,AT003L3,Linz,2006,936,358294,359230,0.2605573031205634
8.0,AT004L3,Salzburg,2006,1306,136170,137476,0.9499839972067851
9.0,AT005L3,Innsbruck,2006,11272,201550,212822,5.296444916409017
10.0,AT006L2,Klagenfurt,2006,391,182869,183260,0.21335807050092767
11.0,BA001L1,Sarajevo,2006,9,263765,263774,0.0034120117979785725
12.0,BA002L1,Banja Luka,2006,2,275300,275302,0.0007264749257179389
13.0,BA003L1,Mostar,2006,1868,180479,182347,1.0244204730541222
14.0,BA004L1,Tuzla,2006,88,112173,112261,0.07838875477681474
15.0,BA005L1,Zenica,2006,17,86699,86716,0.019604225287144242
16.0,BE001L2,Bruxelles / Brussel,2006,331,326320,326651,0.10133139038300816
17.0,BE002L2,Antwerpen,2006,4192,115020,119212,3.516424521021374
18.0,BE003L2,Gent,2006,272,101569,101841,0.26708300193438794
19.0,BE004L2,Charleroi,2006,947,108818,109765,0.8627522434291441
20.0,BE005L2,LiÃ¨ge,2006,94,141304,141398,0.06647901667633206
21.0,BE006L2,Brugge,2006,858,55681,56539,1.5175365676789474
22.0,BE007L2,Namur,2006,68,84039,84107,0.08084939422402417
23.0,BE008L1,Leuven,2006,1,45075,45076,0.002218475463661372
24.0,BE009L1,Mons,2006,12,39188,39200,0.030612244897959183
25.0,BE010L1,Kortrijk,2006,0,22339,22339,0.0
26.0,BE011L1,Oostende,2006,170,20762,20932,0.8121536403592585
27.0,BG001L2,Sofia,2006,1021,570753,571774,0.17856705621451832
28.0,BG002L2,Plovdiv,2006,203,276883,277086,0.07326245281248421
29.0,BG003L2,Varna,2006,3855,200943,204798,1.8823426010019628
30.0,BG004L2,Burgas,2006,5388,290512,295900,1.820885434268334
31.0,BG005L1,Pleven,2006,1015,178061,179076,0.566798454287565
32.0,BG006L2,Ruse,2006,2451,131566,134017,1.8288724564794019
33.0,BG007L2,Vidin,2006,1758,59206,60964,2.883669050587232
34.0,BG008L2,Stara Zagora,2006,0,132068,132068,0.0
35.0,BG009L1,Sliven,2006,15,136759,136774,0.010966996651410356
36.0,BG010L1,Dobrich,2006,52,140286,140338,0.03705339964941783
37.0,BG011L1,Shumen,2006,69,94438,94507,0.07301046483329277
38.0,BG013L1,Yambol,2006,207,130599,130806,0.15824962157699188
39.0,BG014L1,Haskovo,2006,382,73586,73968,0.5164395414233182
40.0,BG015L1,Pazardzhik,2006,13,63809,63822,0.020369151703174455
41.0,BG016L1,Blagoevgrad,2006,55,135424,135479,0.04059669764317717
42.0,BG017L1,Veliko Tarnovo,2006,0,88539,88539,0.0
43.0,BG018L1,Vratsa,2006,86,70471,70557,0.12188726844962229
44.0,CH001L2,ZÃ¼rich,2006,6,127711,127717,0.004697886733950845
45.0,CH002L2,GenÃ¨ve,2006,170,53727,53897,0.31541644247360706
46.0,CH003L2,Basel,2006,78,69342,69420,0.11235955056179776
47.0,CH004L2,Bern,2006,76,78212,78288,0.09707745759247904
48.0,CH005L2,Lausanne,2006,6,77499,77505,0.0077414360363847485
49.0,CH006L1,Winterthur,2006,0,13291,13291,0.0
50.0,CH007L2,St. Gallen,2006,189,31720,31909,0.5923093797988029
51.0,CH008L2,Luzern,2006,36,29223,29259,0.12303906490310675
52.0,CH009L2,Lugano,2006,1137,29488,30625,3.71265306122449
53.0,CH010L1,Biel/Bienne,2006,6,9089,9095,0.06597031335898845
54.0,CY001L2,Lefkosia,2006,34,162594,162628,0.020906608948028628
55.0,CY501L2,Lemesos,2006,1109,124790,125899,0.8808648202130278
56.0,CZ001L2,Praha,2006,284,570278,570562,0.049775484522278035
57.0,CZ002L2,Brno,2006,621,267294,267915,0.23178993337439113
58.0,CZ003L2,Ostrava,2006,22,142644,142666,0.015420632806695358
59.0,CZ004L2,PlzeÅ,2006,145,195812,195957,0.07399582561480325
60.0,CZ005L2,ÃstÃ­ nad Labem,2006,51,35860,35911,0.14201776614407843
61.0,CZ006L2,Olomouc,2006,36,93528,93564,0.038476337052712584
62.0,CZ007L2,Liberec,2006,0,61316,61316,0.0
63.0,CZ008L2,ÄeskÃ© BudÄjovice,2006,1277,128127,129404,0.9868319371889586
64.0,CZ009L2,Hradec KrÃ¡lovÃ©,2006,24,79481,79505,0.030186780705616
65.0,CZ010L2,Pardubice,2006,158,86199,86357,0.18296142756232847
66.0,CZ011L2,ZlÃ­n,2006,11,57941,57952,0.0189812258420762
67.0,CZ013L2,Karlovy Vary,2006,12,46972,46984,0.02554060956921505
68.0,CZ014L2,Jihlava,2006,45,95982,96027,0.04686182011309319
69.0,CZ016L2,Most,2006,30,27748,27778,0.10799913600691195
70.0,CZ018L2,Chomutov-Jirkov,2006,549,45137,45686,1.201681040143589
71.0,DE001L1,Berlin,2006,8548,1739717,1748265,0.48894189382044484
72.0,DE002L1,Hamburg,2006,9856,724318,734174,1.3424610514673634
73.0,DE003L1,MÃ¼nchen,2006,5118,544823,549941,0.9306452874035578
74.0,DE004L1,KÃ¶ln,2006,839,161791,162630,0.515894976326631
75.0,DE005L1,Frankfurt am Main,2006,494,429837,430331,0.11479535520332024
76.0,DE007L1,Stuttgart,2006,51,365119,365170,0.013966097981761919
77.0,DE008L2,Leipzig,2006,1227,396462,397689,0.3085325467890739
78.0,DE009L2,Dresden,2006,3834,579362,583196,0.6574119164054623
79.0,DE011L1,DÃ¼sseldorf,2006,734,119583,120317,0.6100551044324576
80.0,DE012L1,Bremen,2006,799,588740,589539,0.13552962569058197
81.0,DE013L1,Hannover,2006,2097,295215,297312,0.7053196641911528
82.0,DE014L1,NÃ¼rnberg,2006,72,293429,293501,0.024531432601592497
83.0,DE017L0,Bielefeld,2006,0,25883,25883,0.0
84.0,DE018L1,Halle an der Saale,2006,662,156924,157586,0.42008807889025673
85.0,DE019L2,Magdeburg,2006,60,416974,417034,0.014387316142089135
86.0,DE020L1,Wiesbaden,2006,623,100815,101438,0.614168260415229
87.0,DE021L1,GÃ¶ttingen,2006,27,238930,238957,0.011299104022899518
88.0,DE025L1,Darmstadt,2006,39,78148,78187,0.049880414902733185
89.0,DE026L1,Trier,2006,129,120998,121127,0.10649978947716034
90.0,DE027L1,Freiburg im Breisgau,2006,336,220860,221196,0.15190148103944012
91.0,DE028L1,Regensburg,2006,22,253640,253662,0.008672958503835813
92.0,DE029L0,Frankfurt (Oder),2006,38,14806,14844,0.2559956884936675
93.0,DE030L1,Weimar,2006,10,89018,89028,0.011232421260726962
94.0,DE031L1,Schwerin,2006,5800,484203,490003,1.1836662224516994
95.0,DE032L1,Erfurt,2006,137,285375,285512,0.04798397265263807
96.0,DE033L1,Augsburg,2006,6,199928,199934,0.0030009903268078467
97.0,DE034L1,Bonn,2006,702,128635,129337,0.5427681173987335
98.0,DE035L1,Karlsruhe,2006,185,125627,125812,0.14704479699869646
99.0,DE036L0,MÃ¶nchengladbach,2006,0,17023,17023,0.0
100.0,DE037L1,Mainz,2006,631,69674,70305,0.897517957471019
101.0,DE038L1,Ruhrgebiet,2006,2650,441102,443752,0.5971804070742217
102.0,DE039L1,Kiel,2006,1860,337902,339762,0.5474420329524785
103.0,DE040L1,SaarbrÃ¼cken,2006,109,153573,153682,0.07092567769810387
104.0,DE042L1,Koblenz,2006,396,91780,92176,0.42961291442457905
105.0,DE043L2,Rostock,2006,3709,358095,361804,1.0251406839062032
106.0,DE044L1,Kaiserslautern,2006,3,135524,135527,0.0022135810576490297
107.0,DE045L1,Iserlohn,2006,10,106097,106107,0.00942444890535026
108.0,DE048L1,Wilhelmshaven,2006,799,73248,74047,1.07904439072481
109.0,DE050L1,TÃ¼bingen,2006,3,52022,52025,0.005766458433445459
110.0,DE051L1,Villingen-Schwenningen,2006,2,102558,102560,0.0019500780031201249
111.0,DE052L1,Flensburg,2006,887,204588,205475,0.43168268645820657
112.0,DE053L1,Marburg,2006,1,126241,126242,0.0007921294022591531
113.0,DE054L1,Konstanz,2006,95,81805,81900,0.115995115995116
114.0,DE055L0,NeumÃ¼nster,2006,2,7174,7176,0.027870680044593088
115.0,DE056L0,Brandenburg an der Havel,2006,1022,21808,22830,4.476565922032413
116.0,DE057L1,GieÃen,2006,0,85528,85528,0.0
117.0,DE058L1,LÃ¼neburg,2006,7,132495,132502,0.005282939125447163
118.0,DE059L1,Bayreuth,2006,2,199918,199920,0.0010004001600640256
119.0,DE060L1,Celle,2006,10,155037,155047,0.006449657200719782
120.0,DE061L1,Aschaffenburg,2006,81,147535,147616,0.05487210058530241
121.0,DE062L1,Bamberg,2006,23,122132,122155,0.018828537513814417
122.0,DE063L1,Plauen,2006,190,141098,141288,0.13447709642715588
123.0,DE064L1,Neubrandenburg,2006,21175,562816,583991,3.6259120431650484
124.0,DE065L1,Fulda,2006,0,138225,138225,0.0
125.0,DE066L1,Kempten (AllgÃ¤u),2006,217,158950,159167,0.13633479301614027
126.0,DE067L1,Landshut,2006,20,141433,141453,0.014138971955349126
127.0,DE069L1,Rosenheim,2006,1,147762,147763,0.0006767594052638346
128.0,DE071L1,Stralsund,2006,17968,320280,338248,5.312078711477969
129.0,DE072L1,Friedrichshafen,2006,68,66551,66619,0.10207298218226032
130.0,DE073L1,Offenburg,2006,170,185714,185884,0.09145488584278366
131.0,DE074L1,GÃ¶rlitz,2006,1877,209230,211107,0.8891225776501964
132.0,DE077L1,Schweinfurt,2006,35,201305,201340,0.017383530346677264
133.0,DE078L1,Greifswald,2006,1543,348251,349794,0.44111677158556173
134.0,DE079L1,Wetzlar,2006,1,106489,106490,0.00093905531035778
135.0,DE081L1,Passau,2006,534,159532,160066,0.33361238489123235
136.0,DE082L0,Dessau-RoÃlau,2006,0,24648,24648,0.0
137.0,DE083L1,Braunschweig-Salzgitter-Wolfsburg,2006,161,412683,412844,0.03899778124424722
138.0,DE084L1,Mannheim-Ludwigshafen,2006,521,203907,204428,0.2548574559258027
139.0,DE504L1,MÃ¼nster,2006,7,141756,141763,0.004937818753835627
140.0,DE505L0,Chemnitz,2006,1,22192,22193,0.004505925291758662
141.0,DE507L1,Aachen,2006,60,70460,70520,0.08508224617129892
142.0,DE508L0,Krefeld,2006,99,13581,13680,0.7236842105263158
143.0,DE510L1,LÃ¼beck,2006,3000,159149,162149,1.8501501705221741
144.0,DE513L1,Kassel,2006,0,139861,139861,0.0
145.0,DE516L0,Solingen,2006,0,8954,8954,0.0
146.0,DE517L1,OsnabrÃ¼ck,2006,11,224119,224130,0.004907865970642038
147.0,DE520L1,Oldenburg (Oldenburg),2006,29,189940,189969,0.01526564860582516
148.0,DE522L1,Heidelberg,2006,44,117061,117105,0.03757311814183852
149.0,DE523L1,Paderborn,2006,28,124655,124683,0.02245695082729803
150.0,DE524L2,WÃ¼rzburg,2006,34,305895,305929,0.011113689777693517
151.0,DE527L1,Bremerhaven,2006,869,213610,214479,0.4051678719128679
152.0,DE529L1,Heilbronn,2006,10,119974,119984,0.008334444592612348
153.0,DE530L0,Remscheid,2006,0,7369,7369,0.0
154.0,DE532L1,Ulm,2006,362,198946,199308,0.18162843438296505
155.0,DE533L1,Pforzheim,2006,0,67148,67148,0.0
156.0,DE534L1,Ingolstadt,2006,19,284816,284835,0.0066705285516176025
157.0,DE535L1,Gera,2006,35,99751,99786,0.03507506062974766
158.0,DE537L1,Reutlingen,2006,0,109282,109282,0.0
159.0,DE539L1,Cottbus,2006,1126,181154,182280,0.6177309633530832
160.0,DE540L2,Siegen,2006,3,177561,177564,0.0016895316618233424
161.0,DE542L1,Hildesheim,2006,4,120806,120810,0.003310984190050492
162.0,DE544L1,Zwickau,2006,23,94781,94804,0.02426057972237458
163.0,DE546L0,Wuppertal,2006,0,16833,16833,0.0
164.0,DE547L2,Jena,2006,0,93068,93068,0.0
165.0,DE548L1,DÃ¼ren,2006,31,94007,94038,0.03296539696718348
166.0,DE549L1,Bocholt,2006,32,142233,142265,0.022493234456823535
167.0,DK001L2,KÃ¸benhavn,2006,14033,277190,291223,4.818644131816511
168.0,DK002L3,Ãrhus,2006,3724,458800,462524,0.8051474085669068
169.0,DK003L2,Odense,2006,6246,353593,359839,1.7357762777242043
170.0,DK004L3,Aalborg,2006,2686,617773,620459,0.4329053168702525
171.0,EE001L1,Tallinn,2006,4810,434251,439061,1.0955197569358244
172.0,EE002L1,Tartu,2006,830,298812,299642,0.27699721667856975
173.0,EE003L0,Narva,2006,429,6460,6889,6.227318914211062
174.0,EL001L1,Athina,2006,5244,304143,309387,1.6949645589504407
175.0,EL002L1,Thessaloniki,2006,1554,140565,142119,1.0934498554028667
176.0,EL003L1,Patra,2006,674,50916,51590,1.30645473929056
177.0,EL004L1,Irakleio,2006,1061,60323,61384,1.7284634432425388
178.0,EL005L1,Larisa,2006,84,155435,155519,0.05401269298285097
179.0,EL006L1,Volos,2006,278,30538,30816,0.902128764278297
180.0,EL007L1,Ioannina,2006,1989,130652,132641,1.4995363424582142
181.0,EL008L1,Kavala,2006,334,35234,35568,0.9390463337831759
182.0,EL009L1,Kalamata,2006,271,44181,44452,0.6096463601187798
183.0,ES001L3,Madrid,2006,2456,785147,787603,0.31183223019719325
184.0,ES002L2,Barcelona,2006,1437,263170,264607,0.5430695333078868
185.0,ES003L3,Valencia,2006,3231,171889,175120,1.8450205573321152
186.0,ES004L3,Sevilla,2006,4499,463927,468426,0.9604505300730531
187.0,ES005L2,Zaragoza,2006,169,275969,276138,0.06120128341626288
188.0,ES006L2,MÃ¡laga,2006,902,151840,152742,0.5905382933312383
189.0,ES007L2,Murcia,2006,103,120033,120136,0.08573616567889725
190.0,ES008L2,Las Palmas,2006,14206,62390,76596,18.54666040002089
191.0,ES009L2,Valladolid,2006,164,115365,115529,0.14195569943477396
192.0,ES010L2,Palma de Mallorca,2006,2287,201947,204234,1.1197939618280992
193.0,ES011L2,Santiago de Compostela,2006,29,126227,126256,0.022969205423900647
194.0,ES012L2,Vitoria/Gasteiz,2006,1141,158180,159321,0.7161642219167592
195.0,ES013L2,Oviedo,2006,13,93474,93487,0.013905676725106165
196.0,ES014L3,Pamplona/IruÃ±a,2006,73,169441,169514,0.04306428967518907
197.0,ES015L2,Santander,2006,633,68850,69483,0.911014204913432
198.0,ES016L2,Toledo,2006,458,92940,93398,0.49037452622111827
199.0,ES017L2,Badajoz,2006,679,218070,218749,0.31040141897791534
200.0,ES018L2,LogroÃ±o,2006,56,46082,46138,0.12137500541852701
201.0,ES019L3,Bilbao,2006,1495,151826,153321,0.9750784302215614
202.0,ES020L2,CÃ³rdoba,2006,1214,185688,186902,0.6495382606927694
203.0,ES021L2,Alicante/Alacant,2006,426,35632,36058,1.1814299184646957
204.0,ES022L2,Vigo,2006,789,135682,136471,0.578144807321702
205.0,ES023L2,GijÃ³n,2006,849,52553,53402,1.5898280963259803
206.0,ES025L3,Santa Cruz de Tenerife,2006,3301,63682,66983,4.92811608915695
207.0,ES026L2,CoruÃ±a (A),2006,696,75279,75975,0.9160908193484699
208.0,ES028L1,Reus,2006,0,11534,11534,0.0
209.0,ES031L1,Lugo,2006,21,133990,134011,0.01567035541858504
210.0,ES033L1,Girona,2006,3,39618,39621,0.007571742257893541
211.0,ES034L1,CÃ¡ceres,2006,1952,236321,238273,0.8192283641033604
212.0,ES035L1,Torrevieja,2006,1725,7113,8838,19.517990495587238
213.0,ES039L1,AvilÃ©s,2006,322,18820,19142,1.6821648730540175
214.0,ES040L1,Talavera de la Reina,2006,551,82715,83266,0.6617346816227512
215.0,ES041L1,Palencia,2006,9,28372,28381,0.03171135618899968
216.0,ES043L1,Ferrol,2006,510,46460,46970,1.0857994464551843
217.0,ES044L1,Pontevedra,2006,81,51535,51616,0.15692808431494112
218.0,ES046L1,Gandia,2006,251,17086,17337,1.4477706638980217
219.0,ES048L1,Guadalajara,2006,15,45368,45383,0.03305202388559593
220.0,ES050L1,Manresa,2006,3,29600,29603,0.010134108029591596
221.0,ES053L1,Ciudad Real,2006,578,95767,96345,0.5999273444392548
222.0,ES054L1,Benidorm,2006,328,20345,20673,1.5866105548299714
223.0,ES057L1,Ponferrada,2006,273,62070,62343,0.43790000481208796
224.0,ES059L1,Zamora,2006,322,33858,34180,0.9420713867758923
225.0,ES070L1,Irun,2006,87,7155,7242,1.2013256006628004
226.0,ES072L1,Arrecife,2006,12599,46335,58934,21.37815183086164
227.0,ES501L3,Granada,2006,357,162267,162624,0.21952479338842976
228.0,ES505L1,Elche/Elx,2006,850,37968,38818,2.1897058065845743
229.0,ES506L1,Cartagena,2006,1551,59397,60948,2.544792281945265
230.0,ES508L1,Jerez de la Frontera,2006,172,125934,126106,0.13639319302808747
231.0,ES510L1,Donostia-San SebastiÃ¡n,2006,175,33145,33320,0.5252100840336135
232.0,ES514L1,AlmerÃ­a,2006,742,39988,40730,1.8217530076110975
233.0,ES515L1,Burgos,2006,3,149388,149391,0.0020081531015924657
234.0,ES516L1,Salamanca,2006,21,45623,45644,0.04600823766541057
235.0,ES519L1,Albacete,2006,75,245250,245325,0.03057169061449098
236.0,ES520L1,CastellÃ³n/CastellÃ³,2006,435,32359,32794,1.3264621577117766
237.0,ES521L1,Huelva,2006,3936,93484,97420,4.040238144118251
238.0,ES522L1,CÃ¡diz,2006,1050,23783,24833,4.22824467442516
239.0,ES523L1,LeÃ³n,2006,1,118886,118887,0.0008411348591519679
240.0,ES525L1,Tarragona,2006,485,21255,21740,2.230910763569457
241.0,ES527L1,JaÃ©n,2006,31,99900,99931,0.03102140476929081
242.0,ES528L1,Lleida,2006,108,70567,70675,0.1528121683763707
243.0,ES529L1,Ourense,2006,249,64919,65168,0.3820893690154677
244.0,ES532L1,Algeciras,2006,566,41728,42294,1.3382512885988556
245.0,ES533L1,Marbella,2006,573,68632,69205,0.8279748573079979
246.0,ES537L1,Alcoy,2006,0,20529,20529,0.0
247.0,ES538L1,Ãvila,2006,473,53173,53646,0.8817059985833055
248.0,ES542L1,Cuenca,2006,77,164505,164582,0.04678518914583612
249.0,ES543L1,Eivissa,2006,2105,57297,59402,3.5436517288980167
250.0,ES544L1,Linares,2006,13,25763,25776,0.05043451272501552
251.0,ES545L1,Lorca,2006,111,182096,182207,0.06091972317199668
252.0,ES546L1,MÃ©rida,2006,890,127409,128299,0.6936920786600052
253.0,ES547L1,Sagunto,2006,228,15300,15528,1.4683153013910355
254.0,ES550L1,Puerto de la Cruz,2006,3591,23881,27472,13.071490972626673
255.0,ES552L1,Igualada,2006,0,25426,25426,0.0
256.0,FI001L3,Helsinki,2006,17926,473592,491518,3.6470688764195818
257.0,FI002L3,Tampere,2006,80077,608566,688643,11.62823117348176
258.0,FI003L4,Turku,2006,20098,446346,466444,4.308770184630952
259.0,FI004L4,Oulu,2006,5907,717914,723821,0.8160857449562806
260.0,FI007L2,Lahti,2006,36995,298408,335403,11.030014639105792
261.0,FI008L2,Kuopio,2006,143494,776912,920406,15.59029384858421
262.0,FI009L2,JyvÃ¤skylÃ¤,2006,53359,423583,476942,11.187733518960377
263.0,FR001L1,Paris,2006,1876,1208076,1209952,0.15504747295760493
264.0,FR003L2,Lyon,2006,1153,366078,367231,0.3139713150578246
265.0,FR004L2,Toulouse,2006,652,524020,524672,0.12426811417418883
266.0,FR006L2,Strasbourg,2006,396,203487,203883,0.19422904312767617
267.0,FR007L2,Bordeaux,2006,4465,551289,555754,0.8034130208689457
268.0,FR008L2,Nantes,2006,1343,315276,316619,0.42416911177156136
269.0,FR009L2,Lille,2006,5,144448,144453,0.0034613334440960035
270.0,FR010L2,Montpellier,2006,7344,216574,223918,3.279772059414607
271.0,FR011L2,Saint-Etienne,2006,61,180994,181055,0.03369141973433487
272.0,FR012L2,Le Havre,2006,727,75711,76438,0.9510976216018211
273.0,FR013L2,Rennes,2006,15,382122,382137,0.0039252938082415464
274.0,FR014L2,Amiens,2006,15,244780,244795,0.006127576135133478
275.0,FR016L2,Nancy,2006,83,283426,283509,0.029275966547799192
276.0,FR017L2,Metz,2006,14,176916,176930,0.007912733849545018
277.0,FR018L2,Reims,2006,65,243086,243151,0.026732359727083172
278.0,FR019L2,OrlÃ©ans,2006,8065,283902,291967,2.762298478937688
279.0,FR020L2,Dijon,2006,166,385595,385761,0.043031825404849115
280.0,FR021L2,Poitiers,2006,59,250383,250442,0.023558348839252202
281.0,FR022L2,Clermont-Ferrand,2006,26,266100,266126,0.009769808286300474
282.0,FR023L2,Caen,2006,529,225744,226273,0.23378838836272997
283.0,FR024L2,Limoges,2006,71,317763,317834,0.022338705110214765
284.0,FR025L2,BesanÃ§on,2006,9,239027,239036,0.0037651232450342208
285.0,FR026L2,Grenoble,2006,7175,258673,265848,2.698910655713039
286.0,FR027L2,Ajaccio,2006,1511,145498,147009,1.0278282282037154
289.0,FR032L2,Toulon,2006,2224,104832,107056,2.077417426393663
290.0,FR034L2,Valenciennes,2006,3,78443,78446,0.0038242867705172985
291.0,FR035L2,Tours,2006,4020,280828,284848,1.4112789979216986
292.0,FR036L2,Angers,2006,304,230947,231251,0.13145889098857952
293.0,FR037L2,Brest,2006,1052,133942,134994,0.7792938945434612
294.0,FR038L2,Le Mans,2006,55,224056,224111,0.024541410283297115
295.0,FR039L1,Avignon,2006,1477,85748,87225,1.693321868730295
296.0,FR040L2,Mulhouse,2006,66,129700,129766,0.05086078017354315
297.0,FR042L2,Dunkerque,2006,718,90407,91125,0.7879286694101508
298.0,FR043L2,Perpignan,2006,1605,181425,183030,0.8769054253401082
299.0,FR044L2,NÃ®mes,2006,1354,149137,150491,0.8997215780345668
300.0,FR045L2,Pau,2006,34,201725,201759,0.016851788519966892
301.0,FR046L2,Bayonne,2006,1019,101611,102630,0.992887070057488
302.0,FR047L0,Annemasse,2006,2,7798,7800,0.02564102564102564
303.0,FR048L2,Annecy,2006,1531,117512,119043,1.2860899002881312
304.0,FR049L2,Lorient,2006,638,112544,113182,0.5636938735841388
305.0,FR050L2,MontbÃ©liard,2006,26,123031,123057,0.02112842016301389
306.0,FR051L2,Troyes,2006,170,260780,260950,0.06514657980456026
307.0,FR052L2,Saint-Nazaire,2006,464,106671,107135,0.43309842721799596
308.0,FR053L2,La Rochelle,2006,277,111063,111340,0.24878749775462547
309.0,FR056L2,AngoulÃªme,2006,3,214289,214292,0.0013999589345379203
310.0,FR057L2,Boulogne-sur-Mer,2006,179,68359,68538,0.2611689865476086
311.0,FR058L2,ChambÃ©ry,2006,3081,98608,101689,3.029826234892663
312.0,FR059L2,Chalon-sur-SaÃ´ne,2006,260,156098,156358,0.16628506376392638
313.0,FR060L2,Chartres,2006,57,161303,161360,0.03532473971244422
314.0,FR061L2,Niort,2006,13,178906,178919,0.0072658577345055585
315.0,FR062L2,Calais,2006,60,50170,50230,0.11945052757316346
316.0,FR063L2,BÃ©ziers,2006,514,84629,85143,0.6036902622646606
317.0,FR064L2,Arras,2006,1,107562,107563,0.000929687717895559
318.0,FR065L2,Bourges,2006,8,250311,250319,0.003195922003523504
319.0,FR066L2,Saint-Brieuc,2006,81,115100,115181,0.07032409859264982
320.0,FR067L2,Quimper,2006,1173,120749,121922,0.9620905168878464
321.0,FR068L2,Vannes,2006,563,120471,121034,0.46515855048994503
322.0,FR069L2,Cherbourg,2006,536,90182,90718,0.5908419497784343
323.0,FR073L2,Tarbes,2006,81,104248,104329,0.07763900737091316
324.0,FR074L2,CompiÃ¨gne,2006,87,98650,98737,0.08811286549115327
325.0,FR076L2,Belfort,2006,16,65603,65619,0.024383181700422134
326.0,FR077L2,Roanne,2006,1,123199,123200,0.0008116883116883117
327.0,FR079L2,Saint-Quentin,2006,1,99373,99374,0.0010062994344597178
328.0,FR082L2,Beauvais,2006,2,131140,131142,0.0015250644339723353
329.0,FR084L2,Creil,2006,36,29607,29643,0.12144519785446818
330.0,FR086L2,Evreux,2006,2648,123922,126570,2.0921229359247846
331.0,FR090L2,ChÃ¢teauroux,2006,3979,257198,261177,1.5234879028398365
332.0,FR093L2,Brive-la-Gaillarde,2006,3,132579,132582,0.002262750599628909
333.0,FR096L2,Albi,2006,31,134207,134238,0.02309331187890165
334.0,FR099L2,FrÃ©jus,2006,447,43966,44413,1.0064620719158806
335.0,FR104L2,ChÃ¢lons-en-Champagne,2006,61,152748,152809,0.039919114711829795
336.0,FR203L2,Marseille,2006,2956,422820,425776,0.6942617714478975
337.0,FR205L2,Nice,2006,851,306489,307340,0.27689204138738854
338.0,FR207L2,Lens - LiÃ©vin,2006,1,25307,25308,0.003951319740793425
339.0,FR208L1,HÃ©nin - Carvin,2006,4,11594,11598,0.03448870494912916
340.0,FR209L2,Douai,2006,2,45082,45084,0.0044361636057137785
341.0,FR214L1,Valence,2006,692,90269,90961,0.760765602840778
342.0,FR215L2,Rouen,2006,22376,264750,287126,7.793094320960137
343.0,FR304L1,Melun,2006,1,44835,44836,0.0022303506111160673
344.0,FR324L1,Martigues,2006,1701,18755,20456,8.315408682049275
345.0,FR505L1,Charleville-MÃ©ziÃ¨res,2006,4499,130870,135369,3.3235083364729
346.0,FR506L1,Colmar,2006,22,101963,101985,0.021571799774476638
347.0,FR519L1,Cannes,2006,505,19631,20136,2.5079459674215334
348.0,HR001L2,Grad Zagreb,2006,170,505698,505868,0.033605604624131195
349.0,HR002L2,Rijeka,2006,407,106827,107234,0.3795438014062704
350.0,HR003L2,Slavonski Brod,2006,24,97806,97830,0.024532352039251762
351.0,HR004L2,Osijek,2006,1259,171675,172934,0.7280234077740642
352.0,HR005L2,Split,2006,3048,336022,339070,0.8989294246025894
353.0,HR006L1,Pula - Pola,2006,1294,57603,58897,2.1970558772093653
354.0,HR007L1,Zadar,2006,2484,154016,156500,1.587220447284345
355.0,HU001L2,Budapest,2006,5223,633911,639134,0.8171995231047011
356.0,HU002L2,Miskolc,2006,48,164621,164669,0.029149384522891376
357.0,HU003L2,NyÃ­regyhÃ¡za,2006,140,168085,168225,0.08322187546440778
358.0,HU004L2,PÃ©cs,2006,4,185484,185488,0.002156473734149918
359.0,HU005L2,Debrecen,2006,461,201117,201578,0.22869559178084908
360.0,HU006L2,Szeged,2006,550,160383,160933,0.3417571287430173
361.0,HU007L2,GyÃµr,2006,409,204231,204640,0.19986317435496484
362.0,HU008L2,KecskemÃ©t,2006,66,182073,182139,0.036236061469537
363.0,HU009L2,SzÃ©kesfehÃ©rvÃ¡r,2006,984,300139,301123,0.32677676564061864
364.0,HU010L1,Szombathely,2006,13,134264,134277,0.009681479330041631
365.0,HU011L1,Szolnok,2006,592,143383,143975,0.411182496961278
366.0,HU012L1,TatabÃ¡nya,2006,21,69809,69830,0.03007303451238723
367.0,HU013L1,VeszprÃ©m,2006,7146,124174,131320,5.4416692049954305
368.0,HU014L1,BÃ©kÃ©scsaba,2006,43,106120,106163,0.04050375366182192
369.0,HU015L1,KaposvÃ¡r,2006,0,145560,145560,0.0
370.0,HU016L1,Eger,2006,19,100559,100578,0.018890811111773948
371.0,HU017L1,DunaÃºjvÃ¡ros,2006,700,60970,61670,1.1350737797956867
372.0,HU018L1,Zalaegerszeg,2006,41,139938,139979,0.029290107801884572
373.0,HU019L1,Sopron,2006,117,80553,80670,0.14503532911863146
374.0,IE001L1,Dublin,2006,3102,700500,703602,0.44087424424603683
375.0,IE002L1,Cork,2006,1718,327945,329663,0.5211382533071651
376.0,IE003L1,Limerick,2006,176,156282,156458,0.11249025297523935
377.0,IE004L1,Galway,2006,7213,219070,226283,3.187601366430531
378.0,IE005L1,Waterford,2006,604,95253,95857,0.6301052609616408
379.0,IS001L1,ReykjavÃ­k,2006,493994,803236,1297230,38.08067960192101
380.0,IT001L3,Roma,2006,9078,608138,617216,1.4707979054334301
381.0,IT002L3,Milano,2006,77,383968,384045,0.0200497337551589
382.0,IT003L3,Napoli,2006,3041,149901,152942,1.9883354474245138
383.0,IT004L2,Torino,2006,100,170079,170179,0.05876165684367636
384.0,IT005L3,Palermo,2006,1773,148300,150073,1.1814250398139572
385.0,IT006L3,Genova,2006,938,119826,120764,0.7767215395316486
386.0,IT007L3,Firenze,2006,146,163625,163771,0.08914887251100623
387.0,IT008L3,Bari,2006,775,112654,113429,0.6832467887400929
388.0,IT009L1,Bologna,2006,186,185071,185257,0.10040106446719962
389.0,IT010L2,Catania,2006,821,60604,61425,1.3365893365893367
390.0,IT011L2,Venezia,2006,1871,65166,67037,2.7909960171248716
391.0,IT012L3,Verona,2006,56,73105,73161,0.07654351362064488
392.0,IT013L3,Cremona,2006,209,60188,60397,0.3460436776661093
393.0,IT014L3,Trento,2006,619,97568,98187,0.6304296902848646
394.0,IT015L1,Trieste,2006,330,21307,21637,1.525165226232842
395.0,IT016L3,Perugia,2006,5872,125156,131028,4.481484873462161
396.0,IT017L3,Ancona,2006,460,43783,44243,1.0397124968921638
397.0,IT019L2,Pescara,2006,264,16179,16443,1.60554643313264
398.0,IT020L3,Campobasso,2006,419,102416,102835,0.40744882578888514
399.0,IT021L2,Caserta,2006,1,9341,9342,0.010704345964461572
400.0,IT022L2,Taranto,2006,3455,103473,106928,3.2311461918300166
401.0,IT023L2,Potenza,2006,125,138330,138455,0.09028204109638512
402.0,IT024L3,Catanzaro,2006,393,89690,90083,0.43626433400308606
403.0,IT025L3,Reggio di Calabria,2006,629,47619,48248,1.303680981595092
404.0,IT026L3,Sassari,2006,2307,150918,153225,1.5056289769946158
405.0,IT027L2,Cagliari,2006,4879,190413,195292,2.4983102226409684
406.0,IT028L3,Padova,2006,23,61422,61445,0.03743184962161283
407.0,IT029L3,Brescia,2006,75,60194,60269,0.12444208465380213
408.0,IT030L3,Modena,2006,129,69139,69268,0.18623318126696312
409.0,IT031L3,Foggia,2006,4,89707,89711,0.004458762024723836
410.0,IT032L3,Salerno,2006,369,37470,37839,0.9751843336240388
411.0,IT033L2,Piacenza,2006,184,93943,94127,0.19548057411794703
412.0,IT034L1,Bolzano,2006,521,106235,106756,0.48802877590018356
413.0,IT035L2,Udine,2006,1,71829,71830,0.0013921759710427398
414.0,IT036L2,La Spezia,2006,712,42207,42919,1.6589389314755705
415.0,IT037L1,Lecce,2006,341,61169,61510,0.5543814013981466
416.0,IT038L1,Barletta,2006,229,14868,15097,1.516857653838511
417.0,IT039L2,Pesaro,2006,159,25532,25691,0.6188937760305165
418.0,IT040L2,Como,2006,1159,18582,19741,5.871029836381136
419.0,IT041L2,Pisa,2006,547,47506,48053,1.1383264312321812
420.0,IT042L1,Treviso,2006,45,24000,24045,0.18714909544603867
421.0,IT043L2,Varese,2006,785,22879,23664,3.3172751859364435
422.0,IT045L2,Asti,2006,12,54824,54836,0.02188343424028011
423.0,IT046L2,Pavia,2006,16,36188,36204,0.04419401171141311
424.0,IT047L1,Massa,2006,254,10989,11243,2.259183491950547
425.0,IT048L2,Cosenza,2006,424,92055,92479,0.4584824662896441
426.0,IT052L1,Savona,2006,201,28504,28705,0.700226441386518
427.0,IT054L1,Matera,2006,699,77090,77789,0.8985846327886977
428.0,IT056L1,Acireale,2006,52,5936,5988,0.8684034736138945
429.0,IT057L2,Avellino,2006,0,39759,39759,0.0
430.0,IT058L2,Pordenone,2006,38,37012,37050,0.10256410256410256
431.0,IT060L1,Lecco,2006,1217,28995,30212,4.028200714947703
432.0,IT061L0,Altamura,2006,1,42799,42800,0.002336448598130841
433.0,IT064L1,Battipaglia,2006,56,6430,6486,0.8633980881899477
434.0,IT065L0,Bisceglie,2006,91,6853,6944,1.310483870967742
435.0,IT066L1,Carpi,2006,8,20614,20622,0.03879352148191252
436.0,IT067L0,Cerignola,2006,127,58770,58897,0.21563067728407218
437.0,IT068L1,Gallarate,2006,0,5319,5319,0.0
438.0,IT069L1,Gela,2006,434,57461,57895,0.7496329562138354
439.0,IT073L1,Sassuolo,2006,3,24059,24062,0.012467791538525475
440.0,IT501L2,Messina,2006,795,33648,34443,2.308161309990419
441.0,IT502L2,Prato,2006,13,40946,40959,0.03173905612930003
442.0,IT503L3,Parma,2006,116,113391,113507,0.10219634031381325
443.0,IT504L3,Livorno,2006,395,25419,25814,1.5301774231037422
444.0,IT505L3,Reggio nell'Emilia,2006,8,69026,69034,0.011588492626821566
445.0,IT506L2,Ravenna,2006,3400,77789,81189,4.1877594255379424
446.0,IT507L2,Ferrara,2006,767,90716,91483,0.8384071357519977
447.0,IT508L3,Rimini,2006,341,32238,32579,1.0466865158537708
448.0,IT509L3,Siracusa,2006,560,33582,34142,1.6402085408001876
449.0,IT511L2,Bergamo,2006,0,18556,18556,0.0
450.0,IT512L3,ForlÃ¬,2006,35,72716,72751,0.04810930433945925
451.0,IT513L3,Latina,2006,529,65964,66493,0.7955724662746454
452.0,IT514L2,Vicenza,2006,1,34981,34982,0.0028586130009719286
453.0,IT515L2,Terni,2006,148,102184,102332,0.1446272915608021
454.0,IT516L2,Novara,2006,5,54160,54165,0.009231053263177328
455.0,IT518L1,Alessandria,2006,9,76905,76914,0.011701380762930026
456.0,IT519L1,Arezzo,2006,17,88610,88627,0.019181513534250284
457.0,IT520L1,Grosseto,2006,399,119200,119599,0.3336148295554311
458.0,IT521L1,Brindisi,2006,900,63087,63987,1.4065357025645835
459.0,IT522L1,Trapani,2006,953,49837,50790,1.8763536129159284
460.0,IT523L1,Ragusa,2006,295,52555,52850,0.5581835383159887
461.0,IT524L0,Andria,2006,0,39880,39880,0.0
462.0,IT525L0,Trani,2006,118,10261,10379,1.1369110704306773
463.0,IT526L1,L'Aquila,2006,406,139863,140269,0.2894438543085072
464.0,LT001L1,Vilnius,2006,1870,422699,424569,0.4404466647352963
465.0,LT002L1,Kaunas,2006,724,161327,162051,0.4467729295098456
466.0,LT003L1,PanevÄÅ¾ys,2006,14,222794,222808,0.006283436860435891
467.0,LT004L0,Alytus,2006,6,3953,3959,0.15155342258145996
468.0,LT501L0,KlaipÄda,2006,97,8826,8923,1.0870783368822146
469.0,LT502L0,Å iauliai,2006,762,7283,8045,9.47172156619018
470.0,LU001L1,Luxembourg,2006,136,259579,259715,0.05236509250524614
471.0,LV001L1,RÄ«ga,2006,5696,610553,616249,0.9243017027208158
472.0,LV002L2,LiepÄja,2006,3334,268723,272057,1.2254784842882191
473.0,LV003L1,Jelgava,2006,23,166436,166459,0.013817216251449306
474.0,LV501L1,Daugavpils,2006,1188,258487,259675,0.45749494560508325
475.0,ME001L1,Podgorica,2006,1686,182795,184481,0.9139152541454134
476.0,MK001L1,Skopje,2006,2,224351,224353,0.0008914523095300709
477.0,MK003L1,Bitola,2006,64,119598,119662,0.05348397987665258
478.0,MK004L1,Tetovo,2006,86,105535,105621,0.08142320182539457
479.0,MK005L1,Prilep,2006,44,86787,86831,0.05067314668724303
480.0,MT001L1,Valletta,2006,1055,24901,25956,4.064570812143628
481.0,NL001L3,s' Gravenhage,2006,2656,40051,42707,6.219120987191795
482.0,NL002L3,Amsterdam,2006,70757,262200,332957,21.251092483413775
483.0,NL003L3,Rotterdam,2006,24401,192770,217171,11.2358464067486
484.0,NL004L3,Utrecht,2006,1599,95688,97287,1.6435906133399119
485.0,NL005L3,Eindhoven,2006,103,144303,144406,0.07132667617689016
486.0,NL006L3,Tilburg,2006,53,43181,43234,0.12258870333533792
487.0,NL007L3,Groningen,2006,2333,205827,208160,1.120772482705611
488.0,NL008L3,Enschede,2006,76,84880,84956,0.08945807241395545
489.0,NL009L3,Arnhem,2006,824,55074,55898,1.4741135639915561
490.0,NL010L3,Heerlen,2006,13,33330,33343,0.038988693278949105
491.0,NL012L3,Breda,2006,930,72440,73370,1.2675480441597382
492.0,NL013L3,Nijmegen,2006,740,39096,39836,1.8576162265287681
493.0,NL014L3,Apeldoorn,2006,6,71118,71124,0.008435970980259827
494.0,NL015L3,Leeuwarden,2006,534,110389,110923,0.4814150356553646
495.0,NL016L3,Sittard-Geleen,2006,32,22880,22912,0.13966480446927373
496.0,NL020L3,Roosendaal,2006,0,24574,24574,0.0
497.0,NL026L0,Alphen aan den Rijn,2006,37,13173,13210,0.2800908402725208
498.0,NL028L3,Bergen op Zoom,2006,1572,33209,34781,4.51970903654294
499.0,NL030L0,Gouda,2006,6,1782,1788,0.33557046979865773
500.0,NL032L3,MiddelburgÂ Â Â Â Â Â ,2006,1023,22365,23388,4.374037968188815
501.0,NL503L3,s-Hertogenbosch,2006,492,36367,36859,1.3348164627363739
502.0,NL504L3,Amersfoort,2006,782,11462,12244,6.386801698791245
503.0,NL505L3,Maastricht,2006,8,20377,20385,0.03924454255580083
504.0,NL507L3,Leiden,2006,159,19622,19781,0.8038016278246802
505.0,NL511L3,Zwolle,2006,854,122166,123020,0.6941960656803772
506.0,NL512L3,Ede,2006,58,35207,35265,0.16446902027506027
507.0,NL513L3,Deventer,2006,27,25218,25245,0.10695187165775401
508.0,NL514L3,Alkmaar,2006,444,47348,47792,0.9290257783729494
509.0,NL515L3,Venlo,2006,150,51086,51236,0.2927629010851745
510.0,NL519L3,Almelo,2006,5,42020,42025,0.01189767995240928
511.0,NL520L3,Lelystad,2006,59207,59635,118842,49.81992898133657
512.0,NL521L3,Oss,2006,13,33133,33146,0.039220418753394076
513.0,NL522L3,Assen,2006,119,70743,70862,0.16793203691682423
514.0,NL524L3,Veenendaal,2006,24,8161,8185,0.29321930360415394
515.0,NL529L3,Soest,2006,489,7453,7942,6.157139259632335
516.0,NO001L1,Oslo,2006,16269,730374,746643,2.1789529935993506
517.0,NO002L1,Bergen,2006,13677,344066,357743,3.823135602932832
518.0,NO003L1,Trondheim,2006,14616,658640,673256,2.1709424052663477
519.0,NO004L1,Stavanger,2006,12203,276874,289077,4.221366625501164
520.0,NO005L1,Kristiansand,2006,5590,309872,315462,1.7720042350584224
521.0,NO006L1,TromsÃ¸,2006,32532,342081,374613,8.684162055241009
522.0,PL001L2,Warszawa,2006,830,860413,861243,0.09637233626282013
523.0,PL002L2,ÅÃ³dÅº,2006,3,169497,169500,0.0017699115044247787
524.0,PL003L2,KrakÃ³w,2006,278,375470,375748,0.07398575641121177
525.0,PL004L2,WrocÅaw,2006,751,263949,264700,0.2837174159425765
526.0,PL005L2,PoznaÅ,2006,53,309275,309328,0.01713391610200176
527.0,PL006L2,GdaÅsk,2006,937,262579,263516,0.35557613199957494
528.0,PL007L2,Szczecin,2006,3099,109961,113060,2.7410224659472844
529.0,PL008L2,Bydgoszcz,2006,327,209809,210136,0.15561350744279895
530.0,PL009L2,Lublin,2006,22,322762,322784,0.0068157033805888775
531.0,PL010L2,Katowice,2006,1402,393193,394595,0.35530100482773475
532.0,PL011L2,BiaÅystok,2006,22,223300,223322,0.009851246182642104
533.0,PL012L2,Kielce,2006,83,224146,224229,0.03701572945515522
534.0,PL013L2,ToruÅ,2006,682,158251,158933,0.42911163823749626
535.0,PL014L2,Olsztyn,2006,1163,201381,202544,0.5741962240303341
536.0,PL015L2,RzeszÃ³w,2006,40,229309,229349,0.01744066902406376
537.0,PL016L2,Opole,2006,55,176561,176616,0.03114100647732935
538.0,PL017L2,GorzÃ³w Wielkopolski,2006,6,97414,97420,0.006158899609936357
539.0,PL018L2,Zielona GÃ³ra,2006,133,169151,169284,0.07856619645093452
540.0,PL019L2,Jelenia GÃ³ra,2006,130,83211,83341,0.15598564932026254
541.0,PL020L2,Nowy SÄcz,2006,287,130131,130418,0.22006164793203392
542.0,PL021L2,SuwaÅki,2006,1627,70506,72133,2.2555557095920036
543.0,PL022L2,Konin,2006,763,117400,118163,0.6457182028215263
544.0,PL024L2,CzÄstochowa,2006,8,193890,193898,0.004125880617644329
545.0,PL025L2,Radom,2006,12,68010,68022,0.017641351327511687
546.0,PL026L2,PÅock,2006,2653,168422,171075,1.5507818208388136
547.0,PL027L2,Kalisz,2006,31,148992,149023,0.020802158056138987
548.0,PL028L2,Koszalin,2006,16,129655,129671,0.012338919264908885
549.0,PL029L1,SÅupsk,2006,7862,227142,235004,3.3454749706387976
550.0,PL030L1,JastrzÄbie-ZdrÃ³j,2006,1,29570,29571,0.003381691522099354
551.0,PL031L1,Siedlce,2006,3,126166,126169,0.0023777631589376154
552.0,PL032L1,PiotrkÃ³w Trybunalski,2006,57,116865,116922,0.048750449017293584
553.0,PL033L1,Lubin,2006,327,92979,93306,0.3504597775062697
554.0,PL034L1,PiÅa,2006,12,52180,52192,0.02299202942979767
555.0,PL035L1,InowrocÅaw,2006,0,20128,20128,0.0
556.0,PL036L1,Ostrowiec ÅwiÄtokrzyski,2006,4,61456,61460,0.006508298080052066
557.0,PL037L1,Gniezno,2006,0,66571,66571,0.0
558.0,PL038L1,Stargard SzczeciÅski,2006,374,36290,36664,1.0200741872136156
559.0,PL039L1,OstrÃ³w Wielkopolski,2006,92,84669,84761,0.10854048442090111
560.0,PL040L1,PrzemyÅl,2006,96,84993,85089,0.11282304410675881
561.0,PL041L1,ZamoÅÄ,2006,37,112670,112707,0.03282848447745038
562.0,PL042L1,CheÅm,2006,134,46436,46570,0.2877388876959416
563.0,PL043L1,Pabianice,2006,0,32959,32959,0.0
564.0,PL044L1,GÅogÃ³w,2006,29,64052,64081,0.04525522385730559
565.0,PL045L1,Stalowa Wola,2006,244,190069,190313,0.12820984378366165
566.0,PL046L1,TomaszÃ³w Mazowiecki,2006,206,18957,19163,1.0749882586233888
567.0,PL047L1,ÅomÅ¼a,2006,0,56002,56002,0.0
568.0,PL048L1,Leszno,2006,58,77514,77572,0.0747692466353839
569.0,PL049L1,Åwidnica,2006,0,47990,47990,0.0
570.0,PL051L1,Tczew,2006,53,27071,27124,0.19539890871552867
571.0,PL052L1,EÅk,2006,1590,38462,40052,3.9698392090282635
572.0,PL506L2,Bielsko-BiaÅa,2006,52,73383,73435,0.07081092122285014
573.0,PL508L1,Rybnik,2006,6,14875,14881,0.040319870976412875
574.0,PL511L2,WaÅbrzych,2006,8,51502,51510,0.015530964861192003
575.0,PL512L2,ElblÄg,2006,9,96466,96475,0.00932884166882612
576.0,PL513L2,WÅocÅawek,2006,2121,120358,122479,1.7317254386466252
577.0,PL514L2,TarnÃ³w,2006,155,125172,125327,0.1236764623744285
578.0,PL516L2,Legnica,2006,22,56478,56500,0.03893805309734513
579.0,PL517L2,GrudziÄdz,2006,101,54942,55043,0.1834929055465727
580.0,PT001L3,Lisboa,2006,7510,431771,439281,1.709611842988884
581.0,PT002L2,Porto,2006,1170,94570,95740,1.222059745143096
582.0,PT003L1,Braga,2006,45,49304,49349,0.0911872581004681
583.0,PT004L2,Funchal,2006,7611,28351,35962,21.164006451254103
584.0,PT005L2,Coimbra,2006,443,162344,162787,0.27213475277509874
585.0,PT007L1,Ponta Delgada,2006,28501,26793,55294,51.544471371215685
586.0,PT008L2,Aveiro,2006,1984,41346,43330,4.578813754904224
587.0,PT009L1,Faro,2006,2546,46604,49150,5.180061037639878
588.0,PT014L1,Viseu,2006,6,70868,70874,0.008465727911504925
589.0,PT016L0,Viana do Castelo,2006,372,31880,32252,1.1534168423663649
590.0,PT019L0,PÃ³voa de Varzim,2006,28,8378,8406,0.3330954080418749
591.0,PT505L1,GuimarÃ£es,2006,0,26541,26541,0.0
592.0,RO001L1,BucureÅti,2006,485,107357,107842,0.4497320153557983
593.0,RO002L1,Cluj-Napoca,2006,0,59302,59302,0.0
594.0,RO003L1,TimiÅoara,2006,10,23644,23654,0.0422761477974127
595.0,RO004L1,Craiova,2006,105,34291,34396,0.3052680544249331
596.0,RO005L1,BrÄila,2006,1291,22238,23529,5.486846019805347
597.0,RO006L1,Oradea,2006,53,20286,20339,0.2605831161807365
598.0,RO007L1,BacÄu,2006,143,21950,22093,0.6472638392250939
599.0,RO008L1,Arad,2006,17,51591,51608,0.03294062935978918
600.0,RO009L1,Sibiu,2006,3,56337,56340,0.005324813631522897
601.0,RO010L1,TÃ¢rgu MureÅ,2006,23,13717,13740,0.16739446870451238
602.0,RO011L1,Piatra NeamÅ£,2006,73,14926,14999,0.4866991132742183
603.0,RO012L1,CÇlÇraÅi,2006,677,23867,24544,2.7583116036505864
604.0,RO013L1,Giurgiu,2006,538,10412,10950,4.9132420091324205
605.0,RO014L1,Alba Iulia,2006,0,26002,26002,0.0
606.0,RO015L1,FocÅani,2006,0,27102,27102,0.0
607.0,RO016L1,TÃ¢rgu Jiu,2006,35,24487,24522,0.14272897806051707
608.0,RO017L1,Tulcea,2006,1744,39203,40947,4.2591642855398435
609.0,RO018L1,TÃ¢rgoviÅte,2006,7,20250,20257,0.03455595596583897
610.0,RO019L1,Slatina,2006,103,7020,7123,1.446019935420469
611.0,RO020L1,BÃ¢rlad,2006,95,26224,26319,0.36095596337246855
612.0,RO021L1,Roman,2006,0,14390,14390,0.0
613.0,RO022L1,BistriÅ£a,2006,6,42625,42631,0.014074265206070698
614.0,RO501L1,Constanta,2006,5939,53412,59351,10.006571077151186
615.0,RO502L1,Iasi,2006,59,79877,79936,0.07380904723779023
616.0,RO503L1,Galati,2006,1179,40053,41232,2.8594295692665894
617.0,RO504L1,Brasov,2006,57,98446,98503,0.05786625788047065
618.0,RO505L1,Ploiesti,2006,0,34337,34337,0.0
619.0,RO506L1,Pitesti,2006,101,24783,24884,0.4058832985050635
620.0,RO507L1,Baia Mare,2006,16,52525,52541,0.03045240859519233
621.0,RO508L1,Buzau,2006,0,38540,38540,0.0
622.0,RO509L1,Satu Mare,2006,0,70844,70844,0.0
623.0,RO510L1,Botosani,2006,181,37159,37340,0.48473486877343336
624.0,RO511L1,Ramnicu Valcea,2006,440,28733,29173,1.5082439241764647
625.0,RO512L1,Suceava,2006,99,39579,39678,0.24950854377740814
626.0,RO513L1,Drobeta-Turnu Severin,2006,2103,30831,32934,6.385498269265804
627.0,RS001L1,Beograd,2006,5838,307186,313024,1.8650327131465958
628.0,RS002L1,Novi Sad,2006,2064,187379,189443,1.0895097733883015
629.0,RS003L1,NiÅ¡,2006,19,341545,341564,0.0055626471173777095
630.0,RS004L1,Kragujevac,2006,141,143934,144075,0.09786569495054659
631.0,RS005L1,Subotica,2006,24,160268,160292,0.014972674868365232
632.0,RS006L1,Novi Pazar,2006,45,140746,140791,0.03196227031557415
633.0,RS008L1,Zrenjanin,2006,684,184447,185131,0.36946810636792327
634.0,RS009L1,Kraljevo,2006,3,176509,176512,0.0016996011602610588
635.0,RS011L0,ÄaÄak,2006,0,63687,63687,0.0
636.0,RS012L1,KruÅ¡evac,2006,3,122646,122649,0.0024460044517281023
637.0,RS013L1,Leskovac,2006,0,166282,166282,0.0
638.0,RS014L1,Valjevo,2006,0,141662,141662,0.0
639.0,RS015L1,Vranje,2006,0,195356,195356,0.0
640.0,RS016L1,Smederevo,2006,2227,157997,160224,1.3899290992610347
641.0,SE001L1,Stockholm,2006,54358,701368,755726,7.192818561224571
642.0,SE002L1,GÃ¶teborg,2006,15742,419517,435259,3.6166971848945106
643.0,SE003L1,MalmÃ¶,2006,2744,185272,188016,1.4594502595523786
644.0,SE004L1,JÃ¶nkÃ¶ping,2006,42991,304200,347191,12.382521436327556
645.0,SE005L1,UmeÃ¥,2006,7795,980454,988249,0.7887688224324032
646.0,SE006L1,Uppsala,2006,14861,682666,697527,2.1305268469894356
647.0,SE007L1,LinkÃ¶ping,2006,8450,414746,423196,1.9967107439578822
648.0,SE008L1,Ãrebro,2006,25420,343177,368597,6.8964207522036265
649.0,SE501L1,VÃ¤sterÃ¥s,2006,16922,273493,290415,5.826834013394625
650.0,SE502L1,NorrkÃ¶ping,2006,13143,298595,311738,4.216040392894032
651.0,SE503L1,Helsingborg,2006,1061,113361,114422,0.9272692314415061
652.0,SE505L1,BorÃ¥s,2006,1653,95709,97362,1.6977876378874717
653.0,SI001L2,Ljubljana,2006,153,233134,233287,0.06558445176970855
654.0,SI002L1,Maribor,2006,528,216457,216985,0.2433347927276079
655.0,SK001L1,Bratislava,2006,687,204254,204941,0.3352184287185092
656.0,SK002L1,KoÅ¡ice,2006,129,177505,177634,0.07262123242172107
657.0,SK003L1,BanskÃ¡ Bystrica,2006,0,80880,80880,0.0
658.0,SK004L1,Nitra,2006,0,87127,87127,0.0
659.0,SK005L1,PreÅ¡ov,2006,5,93294,93299,0.0053591142455974876
660.0,SK006L1,Å½ilina,2006,184,81264,81448,0.22591101070621747
661.0,SK007L1,Trnava,2006,33,74187,74220,0.04446240905416329
662.0,SK008L1,TrenÄÃ­n,2006,17,67406,67423,0.02521394776263293
739.0,UK001L3,London,2006,3151,695019,698170,0.45132274374436027
740.0,UK002L3,West Midlands urban area,2006,95,215214,215309,0.04412263305296109
741.0,UK003L2,Leeds,2006,61,512366,512427,0.01190413463771425
742.0,UK004L1,Glasgow,2006,9073,328611,337684,2.6868314755807208
743.0,UK006L3,Liverpool,2006,508,99995,100503,0.5054575485308896
744.0,UK007L1,Edinburgh,2006,1283,174135,175418,0.7313958658746537
745.0,UK008L3,Greater Manchester,2006,126,312120,312246,0.040352798754827925
746.0,UK009L1,Cardiff,2006,131,84360,84491,0.15504609958457116
747.0,UK010L3,Sheffield,2006,57,126030,126087,0.0452068809631445
748.0,UK011L2,Bristol,2006,445,97940,98385,0.45230472124815774
749.0,UK012L2,Belfast,2006,22128,173017,195145,11.339260549847548
750.0,UK013L2,Newcastle upon Tyne,2006,2053,544655,546708,0.3755203874828977
751.0,UK014L1,Leicester,2006,11,139770,139781,0.007869452929940407
752.0,UK016L1,Aberdeen,2006,2750,651198,653948,0.4205227326943427
753.0,UK017L2,Cambridge,2006,23,159596,159619,0.014409312174615803
754.0,UK018L3,Exeter,2006,709,247017,247726,0.28620330526468757
755.0,UK019L3,Lincoln,2006,36,211507,211543,0.017017816708659705
756.0,UK023L1,Portsmouth,2006,367,20486,20853,1.75993861794466
757.0,UK024L1,Worcester,2006,17,61185,61202,0.0277768700369269
758.0,UK025L3,Coventry,2006,38,81409,81447,0.04665610765282945
759.0,UK026L1,Kingston upon Hull,2006,490,251208,251698,0.19467774873062163
760.0,UK027L1,Stoke-on-Trent,2006,0,88176,88176,0.0
761.0,UK029L1,Nottingham,2006,69,90220,90289,0.07642126947911705
762.0,UK033L1,Guildford,2006,4,61687,61691,0.006483927963560326
763.0,UK050L1,Burnley,2006,1,27973,27974,0.003574747980267391
764.0,UK056L1,Hastings,2006,103,54647,54750,0.18812785388127853
765.0,UK515L1,Brighton and Hove,2006,365,42042,42407,0.860706958756809
766.0,UK516L1,Plymouth,2006,1130,214645,215775,0.5236936623797938
767.0,UK517L1,Swansea,2006,691,83351,84042,0.822207943647224
768.0,UK518L1,Derby,2006,38,68064,68102,0.05579865495873836
769.0,UK520L2,Southampton,2006,970,152382,153352,0.6325316917940424
770.0,UK528L1,Northampton,2006,369,154176,154545,0.23876540813355332
771.0,UK539L1,Bournemouth,2006,345,93448,93793,0.3678312880492147
772.0,UK546L1,Colchester,2006,886,68609,69495,1.2749118641628894
773.0,UK550L0,Dundee City,2006,10427,215989,226416,4.605239912373684
774.0,UK551L1,Falkirk,2006,132,29657,29789,0.44311658665950515
775.0,UK552L0,Reading,2006,8,21913,21921,0.03649468546142968
776.0,UK553L1,Blackpool,2006,34,48921,48955,0.06945153712593198
777.0,UK557L1,Blackburn with Darwen,2006,5,79549,79554,0.006285039092943158
778.0,UK558L1,Newport,2006,55,31645,31700,0.17350157728706625
779.0,UK559L2,Middlesbrough,2006,918,60851,61769,1.4861823892243682
780.0,UK560L1,Oxford,2006,28,192895,192923,0.014513562405726637
781.0,UK562L2,Preston,2006,3,25759,25762,0.011645058613461687
782.0,UK566L1,Norwich,2006,46,150194,150240,0.030617678381256657
783.0,UK568L1,Cheshire West and Chester,2006,283,135862,136145,0.20786661280252672
784.0,UK569L2,Ipswich,2006,1591,154055,155646,1.022191383010164
785.0,UK571L1,Cheltenham,2006,14,46169,46183,0.030314184873221746
786.0,XK001L1,Pristina,2006,12,255795,255807,0.004691036601813086
787.0,XK002L1,Prizren,2006,468,127165,127633,0.3666763297893178
788.0,XK003L1,MitrovicÃ«,2006,0,117914,117914,0.0
1.0,AL001L1,Tirana,2007,1571,165550,167121,0.9400374578897924
2.0,AL003L1,Elbasan,2007,610,125394,126004,0.4841116155042697
3.0,AL004L1,ShkodÃ«r,2007,5830,179499,185329,3.145757005109832
4.0,AL005L0,VlorÃ«,2007,2300,61433,63733,3.608805485384338
5.0,AT001L3,Wien,2007,992,917498,918490,0.10800335332992195
6.0,AT002L3,Graz,2007,70,291062,291132,0.024044076226591375
7.0,AT003L3,Linz,2007,900,358330,359230,0.2505358683851571
8.0,AT004L3,Salzburg,2007,1710,135766,137476,1.2438534726061277
9.0,AT005L3,Innsbruck,2007,30850,181972,212822,14.495681837404028
10.0,AT006L2,Klagenfurt,2007,819,182441,183260,0.4469060351413293
11.0,BA001L1,Sarajevo,2007,9,263765,263774,0.0034120117979785725
12.0,BA002L1,Banja Luka,2007,2,275300,275302,0.0007264749257179389
13.0,BA003L1,Mostar,2007,1461,180886,182347,0.8012196526402957
14.0,BA004L1,Tuzla,2007,132,112129,112261,0.11758313216522212
15.0,BA005L1,Zenica,2007,29,86687,86716,0.033442501960422526
16.0,BE001L2,Bruxelles / Brussel,2007,6323,320328,326651,1.9357050797334159
17.0,BE002L2,Antwerpen,2007,4720,114492,119212,3.959332953058417
18.0,BE003L2,Gent,2007,433,101408,101841,0.42517257293231603
19.0,BE004L2,Charleroi,2007,15980,93785,109765,14.558374709606886
20.0,BE005L2,LiÃ¨ge,2007,531,140867,141398,0.3755357218631098
21.0,BE006L2,Brugge,2007,929,55610,56539,1.6431136029996993
22.0,BE007L2,Namur,2007,93,84014,84107,0.11057343621815069
23.0,BE008L1,Leuven,2007,1165,43911,45076,2.5845239151654984
24.0,BE009L1,Mons,2007,46,39154,39200,0.1173469387755102
25.0,BE010L1,Kortrijk,2007,13,22326,22339,0.05819418953399883
26.0,BE011L1,Oostende,2007,229,20703,20932,1.0940187273074717
27.0,BG001L2,Sofia,2007,1430,570344,571774,0.2500988152661716
28.0,BG002L2,Plovdiv,2007,219,276867,277086,0.07903683332972435
29.0,BG003L2,Varna,2007,3738,201060,204798,1.8252131368470395
30.0,BG004L2,Burgas,2007,5225,290675,295900,1.7657992565055762
31.0,BG005L1,Pleven,2007,1089,177987,179076,0.6081216913489245
32.0,BG006L2,Ruse,2007,2455,131562,134017,1.8318571524508085
33.0,BG007L2,Vidin,2007,1750,59214,60964,2.8705465520635127
34.0,BG008L2,Stara Zagora,2007,0,132068,132068,0.0
35.0,BG009L1,Sliven,2007,5,136769,136774,0.0036556655504701185
36.0,BG010L1,Dobrich,2007,9,140329,140338,0.006413088400860779
37.0,BG011L1,Shumen,2007,55,94452,94507,0.05819674733088554
38.0,BG013L1,Yambol,2007,144,130662,130806,0.11008669327095089
39.0,BG014L1,Haskovo,2007,371,73597,73968,0.5015682457278823
40.0,BG015L1,Pazardzhik,2007,11,63811,63822,0.01723543605653223
41.0,BG016L1,Blagoevgrad,2007,4,135475,135479,0.002952487101321976
42.0,BG017L1,Veliko Tarnovo,2007,0,88539,88539,0.0
43.0,BG018L1,Vratsa,2007,116,70441,70557,0.16440608302507193
44.0,CH001L2,ZÃ¼rich,2007,493,127224,127717,0.38600969330629437
45.0,CH002L2,GenÃ¨ve,2007,234,53663,53897,0.43416145611072976
46.0,CH003L2,Basel,2007,313,69107,69420,0.4508787093056756
47.0,CH004L2,Bern,2007,644,77644,78288,0.8226037195994278
48.0,CH005L2,Lausanne,2007,80,77425,77505,0.10321914715179666
49.0,CH006L1,Winterthur,2007,0,13291,13291,0.0
50.0,CH007L2,St. Gallen,2007,156,31753,31909,0.4888902817386944
51.0,CH008L2,Luzern,2007,52,29207,29259,0.17772309374893194
52.0,CH009L2,Lugano,2007,537,30088,30625,1.7534693877551022
53.0,CH010L1,Biel/Bienne,2007,18,9077,9095,0.19791094007696539
54.0,CY001L2,Lefkosia,2007,35,162593,162628,0.021521509211205943
55.0,CY501L2,Lemesos,2007,997,124902,125899,0.7919046219588718
56.0,CZ001L2,Praha,2007,237,570325,570562,0.04153799236542216
57.0,CZ002L2,Brno,2007,363,267552,267915,0.1354907340014557
58.0,CZ003L2,Ostrava,2007,130,142536,142666,0.09112192113047257
59.0,CZ004L2,PlzeÅ,2007,312,195645,195957,0.15921860408150768
60.0,CZ005L2,ÃstÃ­ nad Labem,2007,80,35831,35911,0.22277296650051515
61.0,CZ006L2,Olomouc,2007,43,93521,93564,0.045957847035184476
62.0,CZ007L2,Liberec,2007,2,61314,61316,0.0032617913758236023
63.0,CZ008L2,ÄeskÃ© BudÄjovice,2007,815,128589,129404,0.6298105159036815
64.0,CZ009L2,Hradec KrÃ¡lovÃ©,2007,9,79496,79505,0.011320042764605999
65.0,CZ010L2,Pardubice,2007,2,86355,86357,0.0023159674374978287
66.0,CZ011L2,ZlÃ­n,2007,4,57948,57952,0.006902263942573165
67.0,CZ013L2,Karlovy Vary,2007,706,46278,46984,1.5026391963221521
68.0,CZ014L2,Jihlava,2007,17,96010,96027,0.01770335426494632
69.0,CZ016L2,Most,2007,113,27665,27778,0.406796745626035
70.0,CZ018L2,Chomutov-Jirkov,2007,741,44945,45686,1.6219410760408004
71.0,DE001L1,Berlin,2007,9647,1738618,1748265,0.5518042173240326
72.0,DE002L1,Hamburg,2007,13167,721007,734174,1.793444060944681
73.0,DE003L1,MÃ¼nchen,2007,9967,539974,549941,1.8123762367235758
74.0,DE004L1,KÃ¶ln,2007,1120,161510,162630,0.6886798253704729
75.0,DE005L1,Frankfurt am Main,2007,1897,428434,430331,0.4408234591512115
76.0,DE007L1,Stuttgart,2007,60,365110,365170,0.0164307035079552
77.0,DE008L2,Leipzig,2007,844,396845,397689,0.21222613650364983
78.0,DE009L2,Dresden,2007,4342,578854,583196,0.7445181379844855
79.0,DE011L1,DÃ¼sseldorf,2007,834,119483,120317,0.6931688788782965
80.0,DE012L1,Bremen,2007,1592,587947,589539,0.2700415070080181
81.0,DE013L1,Hannover,2007,2826,294486,297312,0.9505166289958024
82.0,DE014L1,NÃ¼rnberg,2007,117,293384,293501,0.03986357797758781
83.0,DE017L0,Bielefeld,2007,1101,24782,25883,4.253757292431326
84.0,DE018L1,Halle an der Saale,2007,615,156971,157586,0.39026309443732315
85.0,DE019L2,Magdeburg,2007,227,416807,417034,0.05443201273757056
86.0,DE020L1,Wiesbaden,2007,932,100506,101438,0.9187878309903588
87.0,DE021L1,GÃ¶ttingen,2007,157,238800,238957,0.06570219746648978
88.0,DE025L1,Darmstadt,2007,182,78005,78187,0.23277526954608824
89.0,DE026L1,Trier,2007,67,121060,121127,0.05531384414705227
90.0,DE027L1,Freiburg im Breisgau,2007,47328,173868,221196,21.396408614983997
91.0,DE028L1,Regensburg,2007,260,253402,253662,0.1024986004998778
92.0,DE029L0,Frankfurt (Oder),2007,216,14628,14844,1.4551333872271623
93.0,DE030L1,Weimar,2007,0,89028,89028,0.0
94.0,DE031L1,Schwerin,2007,7915,482088,490003,1.615296232880207
95.0,DE032L1,Erfurt,2007,1524,283988,285512,0.5337779147636527
96.0,DE033L1,Augsburg,2007,131,199803,199934,0.06552162213530464
97.0,DE034L1,Bonn,2007,970,128367,129337,0.7499787377161987
98.0,DE035L1,Karlsruhe,2007,5487,120325,125812,4.361269195307284
99.0,DE036L0,MÃ¶nchengladbach,2007,0,17023,17023,0.0
100.0,DE037L1,Mainz,2007,858,69447,70305,1.2203968423298486
101.0,DE038L1,Ruhrgebiet,2007,2331,441421,443752,0.525293407128306
102.0,DE039L1,Kiel,2007,8786,330976,339762,2.585927796516385
103.0,DE040L1,SaarbrÃ¼cken,2007,142,153540,153682,0.09239858929477753
104.0,DE042L1,Koblenz,2007,14978,77198,92176,16.249349071341783
105.0,DE043L2,Rostock,2007,4893,356911,361804,1.3523896916562559
106.0,DE044L1,Kaiserslautern,2007,116,135411,135527,0.08559180089576247
107.0,DE045L1,Iserlohn,2007,8128,97979,106107,7.660192070268692
108.0,DE048L1,Wilhelmshaven,2007,971,73076,74047,1.3113292908558078
109.0,DE050L1,TÃ¼bingen,2007,3,52022,52025,0.005766458433445459
110.0,DE051L1,Villingen-Schwenningen,2007,25225,77335,102560,24.595358814352576
111.0,DE052L1,Flensburg,2007,1406,204069,205475,0.6842681591434481
112.0,DE053L1,Marburg,2007,1429,124813,126242,1.1319529158283297
113.0,DE054L1,Konstanz,2007,128,81772,81900,0.1562881562881563
114.0,DE055L0,NeumÃ¼nster,2007,28,7148,7176,0.39018952062430323
115.0,DE056L0,Brandenburg an der Havel,2007,556,22274,22830,2.4353920280332897
116.0,DE057L1,GieÃen,2007,106,85422,85528,0.12393602095220278
117.0,DE058L1,LÃ¼neburg,2007,76,132426,132502,0.057357624790569196
118.0,DE059L1,Bayreuth,2007,21,199899,199920,0.01050420168067227
119.0,DE060L1,Celle,2007,83,154964,155047,0.053532154765974185
120.0,DE061L1,Aschaffenburg,2007,1810,145806,147616,1.226154346412313
121.0,DE062L1,Bamberg,2007,34,122121,122155,0.027833490237812616
122.0,DE063L1,Plauen,2007,10898,130390,141288,7.713323141384973
123.0,DE064L1,Neubrandenburg,2007,24505,559486,583991,4.196126310165739
124.0,DE065L1,Fulda,2007,1,138224,138225,0.0007234581298607343
125.0,DE066L1,Kempten (AllgÃ¤u),2007,7626,151541,159167,4.791194154567215
126.0,DE067L1,Landshut,2007,112,141341,141453,0.07917824294995511
127.0,DE069L1,Rosenheim,2007,622,147141,147763,0.42094435007410513
128.0,DE071L1,Stralsund,2007,14804,323444,338248,4.37667037203472
129.0,DE072L1,Friedrichshafen,2007,108,66511,66619,0.16211591287770757
130.0,DE073L1,Offenburg,2007,16463,169421,185884,8.856598738998516
131.0,DE074L1,GÃ¶rlitz,2007,2140,208967,211107,1.0137039510769421
132.0,DE077L1,Schweinfurt,2007,25,201315,201340,0.01241680739048376
133.0,DE078L1,Greifswald,2007,1654,348140,349794,0.4728497344151129
134.0,DE079L1,Wetzlar,2007,8767,97723,106490,8.232697905906658
135.0,DE081L1,Passau,2007,298,159768,160066,0.18617320355353417
136.0,DE082L0,Dessau-RoÃlau,2007,0,24648,24648,0.0
137.0,DE083L1,Braunschweig-Salzgitter-Wolfsburg,2007,401,412443,412844,0.09713111974498842
138.0,DE084L1,Mannheim-Ludwigshafen,2007,2841,201587,204428,1.3897313479562488
139.0,DE504L1,MÃ¼nster,2007,41,141722,141763,0.028921509843894383
140.0,DE505L0,Chemnitz,2007,1,22192,22193,0.004505925291758662
141.0,DE507L1,Aachen,2007,6,70514,70520,0.008508224617129892
142.0,DE508L0,Krefeld,2007,117,13563,13680,0.855263157894737
143.0,DE510L1,LÃ¼beck,2007,5335,156814,162149,3.290183719911933
144.0,DE513L1,Kassel,2007,776,139085,139861,0.5548365877549852
145.0,DE516L0,Solingen,2007,2,8952,8954,0.02233638597274961
146.0,DE517L1,OsnabrÃ¼ck,2007,431,223699,224130,0.19229911212242895
147.0,DE520L1,Oldenburg (Oldenburg),2007,270,189699,189969,0.14212845253699288
148.0,DE522L1,Heidelberg,2007,14013,103092,117105,11.966184193672346
149.0,DE523L1,Paderborn,2007,10234,114449,124683,8.20801552737743
150.0,DE524L2,WÃ¼rzburg,2007,25,305904,305929,0.008171830718892293
151.0,DE527L1,Bremerhaven,2007,1015,213464,214479,0.47323980436313107
152.0,DE529L1,Heilbronn,2007,29,119955,119984,0.024169889318575808
153.0,DE530L0,Remscheid,2007,2,7367,7369,0.02714072465734835
154.0,DE532L1,Ulm,2007,151,199157,199308,0.07576213699399924
155.0,DE533L1,Pforzheim,2007,0,67148,67148,0.0
156.0,DE534L1,Ingolstadt,2007,346,284489,284835,0.12147383572945741
157.0,DE535L1,Gera,2007,39,99747,99786,0.039083638987433104
158.0,DE537L1,Reutlingen,2007,1,109281,109282,0.0009150637799454622
159.0,DE539L1,Cottbus,2007,1031,181249,182280,0.565613342111038
160.0,DE540L2,Siegen,2007,17367,160197,177564,9.78069879029533
161.0,DE542L1,Hildesheim,2007,143,120667,120810,0.11836768479430511
162.0,DE544L1,Zwickau,2007,63,94741,94804,0.06645289228302603
163.0,DE546L0,Wuppertal,2007,14,16819,16833,0.08316996376165865
164.0,DE547L2,Jena,2007,0,93068,93068,0.0
165.0,DE548L1,DÃ¼ren,2007,3,94035,94038,0.003190199706501627
166.0,DE549L1,Bocholt,2007,26,142239,142265,0.01827575299616912
167.0,DK001L2,KÃ¸benhavn,2007,13804,277419,291223,4.740010232708268
168.0,DK002L3,Ãrhus,2007,6804,455720,462524,1.471058799110965
169.0,DK003L2,Odense,2007,8824,351015,359839,2.4522077929296158
170.0,DK004L3,Aalborg,2007,4342,616117,620459,0.6998044995720909
171.0,EE001L1,Tallinn,2007,5533,433528,439061,1.2601893586540367
172.0,EE002L1,Tartu,2007,308,299334,299642,0.10278932859879455
173.0,EE003L0,Narva,2007,316,6573,6889,4.587022789955001
174.0,EL001L1,Athina,2007,5200,304187,309387,1.6807428883566535
175.0,EL002L1,Thessaloniki,2007,1526,140593,142119,1.0737480562064186
176.0,EL003L1,Patra,2007,672,50918,51590,1.3025780189959293
177.0,EL004L1,Irakleio,2007,1084,60300,61384,1.7659324905512839
178.0,EL005L1,Larisa,2007,66,155453,155519,0.042438544486525766
179.0,EL006L1,Volos,2007,273,30543,30816,0.8859034267912772
180.0,EL007L1,Ioannina,2007,2032,130609,132641,1.5319546746481103
181.0,EL008L1,Kavala,2007,322,35246,35568,0.9053081421502475
182.0,EL009L1,Kalamata,2007,269,44183,44452,0.6051471249887519
183.0,ES001L3,Madrid,2007,2850,784753,787603,0.3618574332500003
184.0,ES002L2,Barcelona,2007,1294,263313,264607,0.48902712324314923
185.0,ES003L3,Valencia,2007,3184,171936,175120,1.8181818181818181
186.0,ES004L3,Sevilla,2007,4228,464198,468426,0.9025972085238649
187.0,ES005L2,Zaragoza,2007,171,275967,276138,0.061925558959650615
188.0,ES006L2,MÃ¡laga,2007,881,151861,152742,0.5767896190962538
189.0,ES007L2,Murcia,2007,94,120042,120136,0.07824465605646932
190.0,ES008L2,Las Palmas,2007,1117,75479,76596,1.4583006945532404
191.0,ES009L2,Valladolid,2007,225,115304,115529,0.19475629495624475
192.0,ES010L2,Palma de Mallorca,2007,2281,201953,204234,1.1168561551945317
193.0,ES011L2,Santiago de Compostela,2007,1,126255,126256,0.0007920415663414017
194.0,ES012L2,Vitoria/Gasteiz,2007,1039,158282,159321,0.6521425298610981
195.0,ES013L2,Oviedo,2007,0,93487,93487,0.0
196.0,ES014L3,Pamplona/IruÃ±a,2007,166,169348,169514,0.0979270148778272
197.0,ES015L2,Santander,2007,319,69164,69483,0.4591051048457896
198.0,ES016L2,Toledo,2007,470,92928,93398,0.503222767082807
199.0,ES017L2,Badajoz,2007,675,218074,218749,0.308572839190122
200.0,ES018L2,LogroÃ±o,2007,89,46049,46138,0.19289956218301618
201.0,ES019L3,Bilbao,2007,1066,152255,153321,0.6952733154623306
202.0,ES020L2,CÃ³rdoba,2007,1202,185700,186902,0.6431177836513253
203.0,ES021L2,Alicante/Alacant,2007,418,35640,36058,1.1592434411226358
204.0,ES022L2,Vigo,2007,1089,135382,136471,0.7979717302577105
205.0,ES023L2,GijÃ³n,2007,695,52707,53402,1.3014493839182053
206.0,ES025L3,Santa Cruz de Tenerife,2007,1337,65646,66983,1.9960288431393038
207.0,ES026L2,CoruÃ±a (A),2007,829,75146,75975,1.0911484040802895
208.0,ES028L1,Reus,2007,0,11534,11534,0.0
209.0,ES031L1,Lugo,2007,35,133976,134011,0.026117259030975067
210.0,ES033L1,Girona,2007,2,39619,39621,0.005047828171929028
211.0,ES034L1,CÃ¡ceres,2007,2002,236271,238273,0.8402126972002704
212.0,ES035L1,Torrevieja,2007,1724,7114,8838,19.506675718488346
213.0,ES039L1,AvilÃ©s,2007,275,18867,19142,1.436631490962282
214.0,ES040L1,Talavera de la Reina,2007,557,82709,83266,0.6689405039271732
215.0,ES041L1,Palencia,2007,18,28363,28381,0.06342271237799936
216.0,ES043L1,Ferrol,2007,996,45974,46970,2.120502448371301
217.0,ES044L1,Pontevedra,2007,214,51402,51616,0.41460012399256047
218.0,ES046L1,Gandia,2007,243,17094,17337,1.4016265789929052
219.0,ES048L1,Guadalajara,2007,30,45353,45383,0.06610404777119186
220.0,ES050L1,Manresa,2007,4,29599,29603,0.01351214403945546
221.0,ES053L1,Ciudad Real,2007,596,95749,96345,0.6186102029166018
222.0,ES054L1,Benidorm,2007,334,20339,20673,1.6156339186378366
223.0,ES057L1,Ponferrada,2007,350,61993,62343,0.5614102625795999
224.0,ES059L1,Zamora,2007,338,33842,34180,0.9888823873610298
225.0,ES070L1,Irun,2007,78,7164,7242,1.0770505385252693
226.0,ES072L1,Arrecife,2007,8341,50593,58934,14.15312043981403
227.0,ES501L3,Granada,2007,347,162277,162624,0.21337563951200314
228.0,ES505L1,Elche/Elx,2007,667,38151,38818,1.718275027049307
229.0,ES506L1,Cartagena,2007,1534,59414,60948,2.516899652162499
230.0,ES508L1,Jerez de la Frontera,2007,175,125931,126106,0.13877214406927504
231.0,ES510L1,Donostia-San SebastiÃ¡n,2007,242,33078,33320,0.7262905162064826
232.0,ES514L1,AlmerÃ­a,2007,736,39994,40730,1.8070218512153204
233.0,ES515L1,Burgos,2007,10,149381,149391,0.006693843671974885
234.0,ES516L1,Salamanca,2007,19,45625,45644,0.04162650074489528
235.0,ES519L1,Albacete,2007,55,245270,245325,0.022419239783960054
236.0,ES520L1,CastellÃ³n/CastellÃ³,2007,386,32408,32794,1.1770445813258523
237.0,ES521L1,Huelva,2007,3889,93531,97420,3.9919934305070828
238.0,ES522L1,CÃ¡diz,2007,987,23846,24833,3.9745499939596503
239.0,ES523L1,LeÃ³n,2007,3,118884,118887,0.0025234045774559033
240.0,ES525L1,Tarragona,2007,484,21256,21740,2.2263109475620975
241.0,ES527L1,JaÃ©n,2007,32,99899,99931,0.03202209524571955
242.0,ES528L1,Lleida,2007,110,70565,70675,0.1556420233463035
243.0,ES529L1,Ourense,2007,346,64822,65168,0.5309354284311318
244.0,ES532L1,Algeciras,2007,548,41746,42294,1.295692060339528
245.0,ES533L1,Marbella,2007,581,68624,69205,0.8395347156997327
246.0,ES537L1,Alcoy,2007,0,20529,20529,0.0
247.0,ES538L1,Ãvila,2007,539,53107,53646,1.0047347425716735
248.0,ES542L1,Cuenca,2007,67,164515,164582,0.04070919055546779
249.0,ES543L1,Eivissa,2007,2114,57288,59402,3.558802733914683
250.0,ES544L1,Linares,2007,13,25763,25776,0.05043451272501552
251.0,ES545L1,Lorca,2007,108,182099,182207,0.059273244167348124
252.0,ES546L1,MÃ©rida,2007,919,127380,128299,0.7162955284140952
253.0,ES547L1,Sagunto,2007,218,15310,15528,1.4039155074703762
254.0,ES550L1,Puerto de la Cruz,2007,1375,26097,27472,5.005096097845079
255.0,ES552L1,Igualada,2007,0,25426,25426,0.0
256.0,FI001L3,Helsinki,2007,19896,471622,491518,4.047868033317193
257.0,FI002L3,Tampere,2007,94043,594600,688643,13.656277635872287
258.0,FI003L4,Turku,2007,17077,449367,466444,3.661104012485958
259.0,FI004L4,Oulu,2007,12360,711461,723821,1.7076045044285812
260.0,FI007L2,Lahti,2007,29063,306340,335403,8.665098404009505
261.0,FI008L2,Kuopio,2007,139664,780742,920406,15.174173136637528
262.0,FI009L2,JyvÃ¤skylÃ¤,2007,50719,426223,476942,10.634207094363674
263.0,FR001L1,Paris,2007,1207,1208745,1209952,0.09975602337943985
264.0,FR003L2,Lyon,2007,1360,365871,367231,0.3703391053587524
265.0,FR004L2,Toulouse,2007,319,524353,524672,0.06079989021712613
266.0,FR006L2,Strasbourg,2007,1761,202122,203883,0.8637306690601964
267.0,FR007L2,Bordeaux,2007,4438,551316,555754,0.7985547562410708
268.0,FR008L2,Nantes,2007,3895,312724,316619,1.230185175242168
269.0,FR009L2,Lille,2007,22,144431,144453,0.015229867154022416
270.0,FR010L2,Montpellier,2007,7264,216654,223918,3.244044694932967
271.0,FR011L2,Saint-Etienne,2007,6,181049,181055,0.00331391013780343
272.0,FR012L2,Le Havre,2007,1353,75085,76438,1.7700620110416283
273.0,FR013L2,Rennes,2007,368,381769,382137,0.09630054142885928
274.0,FR014L2,Amiens,2007,178,244617,244795,0.07271390347025061
275.0,FR016L2,Nancy,2007,78,283431,283509,0.027512354105160685
276.0,FR017L2,Metz,2007,51,176879,176930,0.028824959023342565
277.0,FR018L2,Reims,2007,25132,218019,243151,10.335964071708528
278.0,FR019L2,OrlÃ©ans,2007,685,291282,291967,0.23461555586761518
279.0,FR020L2,Dijon,2007,271,385490,385761,0.0702507511127356
280.0,FR021L2,Poitiers,2007,26,250416,250442,0.010381645251195887
281.0,FR022L2,Clermont-Ferrand,2007,2251,263875,266126,0.8458399404793218
282.0,FR023L2,Caen,2007,530,225743,226273,0.23423033238609997
283.0,FR024L2,Limoges,2007,420,317414,317834,0.13214445276465073
284.0,FR025L2,BesanÃ§on,2007,74,238962,239036,0.03095768001472582
285.0,FR026L2,Grenoble,2007,1356,264492,265848,0.5100659023201228
286.0,FR027L2,Ajaccio,2007,1479,145530,147009,1.0060608534171378
289.0,FR032L2,Toulon,2007,2257,104799,107056,2.1082424151845762
290.0,FR034L2,Valenciennes,2007,41,78405,78446,0.05226525253040308
291.0,FR035L2,Tours,2007,657,284191,284848,0.23064932876481495
292.0,FR036L2,Angers,2007,779,230472,231251,0.336863408158235
293.0,FR037L2,Brest,2007,783,134211,134994,0.5800257789235077
294.0,FR038L2,Le Mans,2007,79,224032,224111,0.03525038931600859
295.0,FR039L1,Avignon,2007,1493,85732,87225,1.711665233591287
296.0,FR040L2,Mulhouse,2007,238,129528,129766,0.18340705577732225
297.0,FR042L2,Dunkerque,2007,906,90219,91125,0.9942386831275719
298.0,FR043L2,Perpignan,2007,1493,181537,183030,0.815713271048462
299.0,FR044L2,NÃ®mes,2007,1364,149127,150491,0.9063664936773628
300.0,FR045L2,Pau,2007,19,201740,201759,0.009417175937628556
301.0,FR046L2,Bayonne,2007,1384,101246,102630,1.348533567183085
302.0,FR047L0,Annemasse,2007,4,7796,7800,0.05128205128205128
303.0,FR048L2,Annecy,2007,2474,116569,119043,2.078240635736667
304.0,FR049L2,Lorient,2007,350,112832,113182,0.3092364510257815
305.0,FR050L2,MontbÃ©liard,2007,100,122957,123057,0.08126315447313034
306.0,FR051L2,Troyes,2007,2220,258730,260950,0.8507376892124928
307.0,FR052L2,Saint-Nazaire,2007,375,106760,107135,0.35002566854902695
308.0,FR053L2,La Rochelle,2007,259,111081,111340,0.23262080114963174
309.0,FR056L2,AngoulÃªme,2007,8,214284,214292,0.003733223825434454
310.0,FR057L2,Boulogne-sur-Mer,2007,232,68306,68538,0.3384983512795821
311.0,FR058L2,ChambÃ©ry,2007,2831,98858,101689,2.7839786014219827
312.0,FR059L2,Chalon-sur-SaÃ´ne,2007,335,156023,156358,0.2142519090804436
313.0,FR060L2,Chartres,2007,68,161292,161360,0.0421417947446703
314.0,FR061L2,Niort,2007,11,178908,178919,0.006148033467658549
315.0,FR062L2,Calais,2007,114,50116,50230,0.22695600238901054
316.0,FR063L2,BÃ©ziers,2007,429,84714,85143,0.5038582150029949
317.0,FR064L2,Arras,2007,5,107558,107563,0.004648438589477794
318.0,FR065L2,Bourges,2007,7,250312,250319,0.0027964317530830662
319.0,FR066L2,Saint-Brieuc,2007,95,115086,115181,0.08247888106545351
320.0,FR067L2,Quimper,2007,426,121496,121922,0.3494037171306245
321.0,FR068L2,Vannes,2007,708,120326,121034,0.5849595981294513
322.0,FR069L2,Cherbourg,2007,528,90190,90718,0.5820234132145771
323.0,FR073L2,Tarbes,2007,11,104318,104329,0.010543568902222777
324.0,FR074L2,CompiÃ¨gne,2007,43,98694,98737,0.043550036966891845
325.0,FR076L2,Belfort,2007,152,65467,65619,0.23164022615401028
326.0,FR077L2,Roanne,2007,25,123175,123200,0.020292207792207792
327.0,FR079L2,Saint-Quentin,2007,18,99356,99374,0.01811338982027492
328.0,FR082L2,Beauvais,2007,4,131138,131142,0.0030501288679446706
329.0,FR084L2,Creil,2007,12,29631,29643,0.04048173261815606
330.0,FR086L2,Evreux,2007,14,126556,126570,0.011061072924073635
331.0,FR090L2,ChÃ¢teauroux,2007,346,260831,261177,0.1324772089425945
332.0,FR093L2,Brive-la-Gaillarde,2007,1,132581,132582,0.0007542501998763029
333.0,FR096L2,Albi,2007,20,134218,134238,0.01489891088961397
334.0,FR099L2,FrÃ©jus,2007,432,43981,44413,0.9726881768851463
335.0,FR104L2,ChÃ¢lons-en-Champagne,2007,58,152751,152809,0.03795587956206768
336.0,FR203L2,Marseille,2007,2961,422815,425776,0.6954360978542707
337.0,FR205L2,Nice,2007,846,306494,307340,0.2752651786295308
338.0,FR207L2,Lens - LiÃ©vin,2007,37,25271,25308,0.14619883040935672
339.0,FR208L1,HÃ©nin - Carvin,2007,7,11591,11598,0.06035523366097603
340.0,FR209L2,Douai,2007,141,44943,45084,0.3127495342028214
341.0,FR214L1,Valence,2007,708,90253,90961,0.7783555589758248
342.0,FR215L2,Rouen,2007,2229,284897,287126,0.7763142313827379
343.0,FR304L1,Melun,2007,9,44827,44836,0.02007315550004461
344.0,FR324L1,Martigues,2007,1732,18724,20456,8.466953461087211
345.0,FR505L1,Charleville-MÃ©ziÃ¨res,2007,461,134908,135369,0.34055064305712535
346.0,FR506L1,Colmar,2007,179,101806,101985,0.17551600725596903
347.0,FR519L1,Cannes,2007,505,19631,20136,2.5079459674215334
348.0,HR001L2,Grad Zagreb,2007,99,505769,505868,0.019570322692876403
349.0,HR002L2,Rijeka,2007,495,106739,107234,0.46160732603465315
350.0,HR003L2,Slavonski Brod,2007,8,97822,97830,0.008177450679750588
351.0,HR004L2,Osijek,2007,1230,171704,172934,0.7112540044178703
352.0,HR005L2,Split,2007,2916,336154,339070,0.8599994101512962
353.0,HR006L1,Pula - Pola,2007,1323,57574,58897,2.2462943783214766
354.0,HR007L1,Zadar,2007,2490,154010,156500,1.5910543130990416
355.0,HU001L2,Budapest,2007,4871,634263,639134,0.7621250003911543
356.0,HU002L2,Miskolc,2007,34,164635,164669,0.020647480703714725
357.0,HU003L2,NyÃ­regyhÃ¡za,2007,27,168198,168225,0.016049933125278644
358.0,HU004L2,PÃ©cs,2007,10,185478,185488,0.005391184335374795
359.0,HU005L2,Debrecen,2007,335,201243,201578,0.16618877059996628
360.0,HU006L2,Szeged,2007,508,160425,160933,0.31565931163900507
361.0,HU007L2,GyÃµr,2007,194,204446,204640,0.09480062548866301
362.0,HU008L2,KecskemÃ©t,2007,69,182070,182139,0.037883155172697774
363.0,HU009L2,SzÃ©kesfehÃ©rvÃ¡r,2007,888,300235,301123,0.29489610557811924
364.0,HU010L1,Szombathely,2007,15,134262,134277,0.011170937688509573
365.0,HU011L1,Szolnok,2007,609,143366,143975,0.42299010244834173
366.0,HU012L1,TatabÃ¡nya,2007,129,69701,69830,0.18473435486180723
367.0,HU013L1,VeszprÃ©m,2007,7143,124177,131320,5.439384709107523
368.0,HU014L1,BÃ©kÃ©scsaba,2007,11,106152,106163,0.010361425355349793
369.0,HU015L1,KaposvÃ¡r,2007,0,145560,145560,0.0
370.0,HU016L1,Eger,2007,6,100572,100578,0.005965519298454931
371.0,HU017L1,DunaÃºjvÃ¡ros,2007,710,60960,61670,1.1512891195070536
372.0,HU018L1,Zalaegerszeg,2007,19,139960,139979,0.013573464591117237
373.0,HU019L1,Sopron,2007,83,80587,80670,0.10288831040039668
374.0,IE001L1,Dublin,2007,13081,690521,703602,1.859147643127791
375.0,IE002L1,Cork,2007,3076,326587,329663,0.9330740786803493
376.0,IE003L1,Limerick,2007,239,156219,156458,0.15275665034705802
377.0,IE004L1,Galway,2007,9868,216415,226283,4.360910894764521
378.0,IE005L1,Waterford,2007,16049,79808,95857,16.742647902604922
379.0,IS001L1,ReykjavÃ­k,2007,1297230,0,1297230,100.0
380.0,IT001L3,Roma,2007,8882,608334,617216,1.4390424097884695
381.0,IT002L3,Milano,2007,32,384013,384045,0.008332356885260841
382.0,IT003L3,Napoli,2007,3050,149892,152942,1.9942200311229095
383.0,IT004L2,Torino,2007,73,170106,170179,0.04289600949588374
384.0,IT005L3,Palermo,2007,1653,148420,150073,1.1014639542089517
385.0,IT006L3,Genova,2007,636,120128,120764,0.5266470140107979
386.0,IT007L3,Firenze,2007,87,163684,163771,0.053122958277106454
387.0,IT008L3,Bari,2007,745,112684,113429,0.6567985259501539
388.0,IT009L1,Bologna,2007,63,185194,185257,0.03400681215824503
389.0,IT010L2,Catania,2007,866,60559,61425,1.4098494098494099
390.0,IT011L2,Venezia,2007,1847,65190,67037,2.755194892372869
391.0,IT012L3,Verona,2007,60,73101,73161,0.08201090745069094
392.0,IT013L3,Cremona,2007,235,60162,60397,0.38909217345232383
393.0,IT014L3,Trento,2007,611,97576,98187,0.6222819721551732
394.0,IT015L1,Trieste,2007,334,21303,21637,1.5436520774599065
395.0,IT016L3,Perugia,2007,5590,125438,131028,4.266263699361969
396.0,IT017L3,Ancona,2007,492,43751,44243,1.112040322762923
397.0,IT019L2,Pescara,2007,254,16189,16443,1.5447302803624643
398.0,IT020L3,Campobasso,2007,344,102491,102835,0.3345164584042398
399.0,IT021L2,Caserta,2007,1,9341,9342,0.010704345964461572
400.0,IT022L2,Taranto,2007,3465,103463,106928,3.240498279215921
401.0,IT023L2,Potenza,2007,1859,136596,138455,1.3426745151854393
402.0,IT024L3,Catanzaro,2007,406,89677,90083,0.450695469733468
403.0,IT025L3,Reggio di Calabria,2007,8778,39470,48248,18.193500248714972
404.0,IT026L3,Sassari,2007,2332,150893,153225,1.5219448523413281
405.0,IT027L2,Cagliari,2007,4911,190381,195292,2.5146959424861235
406.0,IT028L3,Padova,2007,19,61426,61445,0.030921962730897548
407.0,IT029L3,Brescia,2007,77,60192,60269,0.12776054024457018
408.0,IT030L3,Modena,2007,128,69140,69268,0.18478951319512618
409.0,IT031L3,Foggia,2007,4,89707,89711,0.004458762024723836
410.0,IT032L3,Salerno,2007,348,37491,37839,0.9196860382145405
411.0,IT033L2,Piacenza,2007,192,93935,94127,0.2039797295143795
412.0,IT034L1,Bolzano,2007,740,106016,106756,0.693169470568399
413.0,IT035L2,Udine,2007,1,71829,71830,0.0013921759710427398
414.0,IT036L2,La Spezia,2007,670,42249,42919,1.5610801742817866
415.0,IT037L1,Lecce,2007,331,61179,61510,0.5381238822955616
416.0,IT038L1,Barletta,2007,231,14866,15097,1.5301053189375373
417.0,IT039L2,Pesaro,2007,133,25558,25691,0.5176910202016269
418.0,IT040L2,Como,2007,652,19089,19741,3.3027708829339955
419.0,IT041L2,Pisa,2007,484,47569,48053,1.007221193265769
420.0,IT042L1,Treviso,2007,46,23999,24045,0.19130796423372842
421.0,IT043L2,Varese,2007,471,23193,23664,1.9903651115618661
422.0,IT045L2,Asti,2007,2,54834,54836,0.0036472390400466848
423.0,IT046L2,Pavia,2007,81,36123,36204,0.22373218428902883
424.0,IT047L1,Massa,2007,334,10909,11243,2.970737347683003
425.0,IT048L2,Cosenza,2007,669,91810,92479,0.7234074762919149
426.0,IT052L1,Savona,2007,220,28485,28705,0.766417000522557
427.0,IT054L1,Matera,2007,844,76945,77789,1.0849863091182557
428.0,IT056L1,Acireale,2007,53,5935,5988,0.8851035404141616
429.0,IT057L2,Avellino,2007,21,39738,39759,0.05281822983475439
430.0,IT058L2,Pordenone,2007,41,37009,37050,0.11066126855600539
431.0,IT060L1,Lecco,2007,1369,28843,30212,4.531312061432543
432.0,IT061L0,Altamura,2007,18,42782,42800,0.04205607476635514
433.0,IT064L1,Battipaglia,2007,62,6424,6486,0.9559050262102992
434.0,IT065L0,Bisceglie,2007,86,6858,6944,1.2384792626728112
435.0,IT066L1,Carpi,2007,4,20618,20622,0.01939676074095626
436.0,IT067L0,Cerignola,2007,132,58765,58897,0.2241200740275396
437.0,IT068L1,Gallarate,2007,0,5319,5319,0.0
438.0,IT069L1,Gela,2007,417,57478,57895,0.7202694533206667
439.0,IT073L1,Sassuolo,2007,0,24062,24062,0.0
440.0,IT501L2,Messina,2007,1189,33254,34443,3.452080248526551
441.0,IT502L2,Prato,2007,7,40952,40959,0.017090260992700015
442.0,IT503L3,Parma,2007,110,113397,113507,0.09691032271137463
443.0,IT504L3,Livorno,2007,382,25432,25814,1.4798171534826063
444.0,IT505L3,Reggio nell'Emilia,2007,7,69027,69034,0.010139931048468871
445.0,IT506L2,Ravenna,2007,3340,77849,81189,4.113857788616684
446.0,IT507L2,Ferrara,2007,267,91216,91483,0.2918575035799001
447.0,IT508L3,Rimini,2007,317,32262,32579,0.9730194296939746
448.0,IT509L3,Siracusa,2007,574,33568,34142,1.6812137543201922
449.0,IT511L2,Bergamo,2007,0,18556,18556,0.0
450.0,IT512L3,ForlÃ¬,2007,12,72739,72751,0.016494618630671743
451.0,IT513L3,Latina,2007,527,65966,66493,0.7925646308633991
452.0,IT514L2,Vicenza,2007,1,34981,34982,0.0028586130009719286
453.0,IT515L2,Terni,2007,135,102197,102332,0.13192354297775868
454.0,IT516L2,Novara,2007,0,54165,54165,0.0
455.0,IT518L1,Alessandria,2007,17,76897,76914,0.022102608107756713
456.0,IT519L1,Arezzo,2007,0,88627,88627,0.0
457.0,IT520L1,Grosseto,2007,394,119205,119599,0.32943419259358353
458.0,IT521L1,Brindisi,2007,830,63157,63987,1.2971384812540045
459.0,IT522L1,Trapani,2007,938,49852,50790,1.8468202402047649
460.0,IT523L1,Ragusa,2007,269,52581,52850,0.5089877010406813
461.0,IT524L0,Andria,2007,0,39880,39880,0.0
462.0,IT525L0,Trani,2007,119,10260,10379,1.1465459100105984
463.0,IT526L1,L'Aquila,2007,87,140182,140269,0.06202368306610869
464.0,LT001L1,Vilnius,2007,107,424462,424569,0.02520202840998754
465.0,LT002L1,Kaunas,2007,190,161861,162051,0.11724703951225231
466.0,LT003L1,PanevÄÅ¾ys,2007,2,222806,222808,0.0008976338372051273
467.0,LT004L0,Alytus,2007,1,3958,3959,0.025258903763576663
468.0,LT501L0,KlaipÄda,2007,102,8821,8923,1.1431133027008853
469.0,LT502L0,Å iauliai,2007,731,7314,8045,9.0863890615289
470.0,LU001L1,Luxembourg,2007,49,259666,259715,0.01886683479968427
471.0,LV001L1,RÄ«ga,2007,7818,608431,616249,1.2686430322807827
472.0,LV002L2,LiepÄja,2007,2820,269237,272057,1.0365474882101913
473.0,LV003L1,Jelgava,2007,12,166447,166459,0.007208982392060507
474.0,LV501L1,Daugavpils,2007,1582,258093,259675,0.609223067295658
475.0,ME001L1,Podgorica,2007,1011,183470,184481,0.5480239157420006
476.0,MK001L1,Skopje,2007,13,224340,224353,0.005794440011945461
477.0,MK003L1,Bitola,2007,60,119602,119662,0.05014123113436179
478.0,MK004L1,Tetovo,2007,0,105621,105621,0.0
479.0,MK005L1,Prilep,2007,7,86824,86831,0.008061636972970484
480.0,MT001L1,Valletta,2007,1074,24882,25956,4.137771613499769
481.0,NL001L3,s' Gravenhage,2007,5769,36938,42707,13.508324162315311
482.0,NL002L3,Amsterdam,2007,85835,247122,332957,25.77960517424172
483.0,NL003L3,Rotterdam,2007,29905,187266,217171,13.77025477619019
484.0,NL004L3,Utrecht,2007,2352,94935,97287,2.4175891948564554
485.0,NL005L3,Eindhoven,2007,353,144053,144406,0.2444496766062352
486.0,NL006L3,Tilburg,2007,490,42744,43234,1.1333672572512374
487.0,NL007L3,Groningen,2007,2238,205922,208160,1.0751345119139124
488.0,NL008L3,Enschede,2007,24,84932,84956,0.028249917604406986
489.0,NL009L3,Arnhem,2007,309,55589,55898,0.5527925864968335
490.0,NL010L3,Heerlen,2007,14,33329,33343,0.04198782353117596
491.0,NL012L3,Breda,2007,1503,71867,73370,2.0485211939484804
492.0,NL013L3,Nijmegen,2007,597,39239,39836,1.4986444422130736
493.0,NL014L3,Apeldoorn,2007,7,71117,71124,0.009841966143636466
494.0,NL015L3,Leeuwarden,2007,1346,109577,110923,1.2134543782623983
495.0,NL016L3,Sittard-Geleen,2007,51,22861,22912,0.222590782122905
496.0,NL020L3,Roosendaal,2007,0,24574,24574,0.0
497.0,NL026L0,Alphen aan den Rijn,2007,3,13207,13210,0.02271006813020439
498.0,NL028L3,Bergen op Zoom,2007,1577,33204,34781,4.534084701417441
499.0,NL030L0,Gouda,2007,1,1787,1788,0.05592841163310962
500.0,NL032L3,MiddelburgÂ Â Â Â Â Â ,2007,1200,22188,23388,5.130836326321191
501.0,NL503L3,s-Hertogenbosch,2007,210,36649,36859,0.5697387340947937
502.0,NL504L3,Amersfoort,2007,7,12237,12244,0.057170859196341066
503.0,NL505L3,Maastricht,2007,214,20171,20385,1.0497915133676723
504.0,NL507L3,Leiden,2007,195,19586,19781,0.9857944492189475
505.0,NL511L3,Zwolle,2007,580,122440,123020,0.47146805397496344
506.0,NL512L3,Ede,2007,5,35260,35265,0.01417836381681554
507.0,NL513L3,Deventer,2007,7,25238,25245,0.02772826302238067
508.0,NL514L3,Alkmaar,2007,1685,46107,47792,3.5256946769333783
509.0,NL515L3,Venlo,2007,368,50868,51236,0.7182449839956281
510.0,NL519L3,Almelo,2007,0,42025,42025,0.0
511.0,NL520L3,Lelystad,2007,57874,60968,118842,48.69827165480217
512.0,NL521L3,Oss,2007,14,33132,33146,0.04223737404211669
513.0,NL522L3,Assen,2007,106,70756,70862,0.14958652027885186
514.0,NL524L3,Veenendaal,2007,0,8185,8185,0.0
515.0,NL529L3,Soest,2007,134,7808,7942,1.6872324351548729
516.0,NO001L1,Oslo,2007,32367,714276,746643,4.335003475556591
517.0,NO002L1,Bergen,2007,39545,318198,357743,11.05402481669802
518.0,NO003L1,Trondheim,2007,41715,631541,673256,6.196008650498473
519.0,NO004L1,Stavanger,2007,91148,197929,289077,31.530699433023035
520.0,NO005L1,Kristiansand,2007,119550,195912,315462,37.896798980542826
521.0,NO006L1,TromsÃ¸,2007,38450,336163,374613,10.263925704660542
522.0,PL001L2,Warszawa,2007,361,860882,861243,0.04191616071190129
523.0,PL002L2,ÅÃ³dÅº,2007,44,169456,169500,0.025958702064896755
524.0,PL003L2,KrakÃ³w,2007,142,375606,375748,0.037791285648892343
525.0,PL004L2,WrocÅaw,2007,160,264540,264700,0.06044578768417076
526.0,PL005L2,PoznaÅ,2007,271,309057,309328,0.08760926912532975
527.0,PL006L2,GdaÅsk,2007,1561,261955,263516,0.5923738976001457
528.0,PL007L2,Szczecin,2007,4050,109010,113060,3.5821687599504686
529.0,PL008L2,Bydgoszcz,2007,337,209799,210136,0.1603723303003769
530.0,PL009L2,Lublin,2007,7,322777,322784,0.0021686328938237335
531.0,PL010L2,Katowice,2007,532,394063,394595,0.1348217792926925
532.0,PL011L2,BiaÅystok,2007,0,223322,223322,0.0
533.0,PL012L2,Kielce,2007,8,224221,224229,0.0035677811523041176
534.0,PL013L2,ToruÅ,2007,61,158872,158933,0.03838095298018662
535.0,PL014L2,Olsztyn,2007,1291,201253,202544,0.637392369065487
536.0,PL015L2,RzeszÃ³w,2007,62,229287,229349,0.027033036987298836
537.0,PL016L2,Opole,2007,1036,175580,176616,0.5865833220093309
538.0,PL017L2,GorzÃ³w Wielkopolski,2007,127,97293,97420,0.13036337507698625
539.0,PL018L2,Zielona GÃ³ra,2007,39,169245,169284,0.02303820798185298
540.0,PL019L2,Jelenia GÃ³ra,2007,871,82470,83341,1.045103850445759
541.0,PL020L2,Nowy SÄcz,2007,175,130243,130418,0.13418393166587433
542.0,PL021L2,SuwaÅki,2007,590,71543,72133,0.8179335394341009
543.0,PL022L2,Konin,2007,309,117854,118163,0.26150317781369803
544.0,PL024L2,CzÄstochowa,2007,0,193898,193898,0.0
545.0,PL025L2,Radom,2007,0,68022,68022,0.0
546.0,PL026L2,PÅock,2007,1072,170003,171075,0.6266257489405231
547.0,PL027L2,Kalisz,2007,39,148984,149023,0.026170456909336143
548.0,PL028L2,Koszalin,2007,125,129546,129671,0.09639780675710066
549.0,PL029L1,SÅupsk,2007,7439,227565,235004,3.1654780344164357
550.0,PL030L1,JastrzÄbie-ZdrÃ³j,2007,1,29570,29571,0.003381691522099354
551.0,PL031L1,Siedlce,2007,5,126164,126169,0.0039629385982293585
552.0,PL032L1,PiotrkÃ³w Trybunalski,2007,100,116822,116922,0.08552710353911155
553.0,PL033L1,Lubin,2007,315,92991,93306,0.3375988682399846
554.0,PL034L1,PiÅa,2007,42,52150,52192,0.08047210300429185
555.0,PL035L1,InowrocÅaw,2007,0,20128,20128,0.0
556.0,PL036L1,Ostrowiec ÅwiÄtokrzyski,2007,3,61457,61460,0.00488122356003905
557.0,PL037L1,Gniezno,2007,82,66489,66571,0.12317675864866083
558.0,PL038L1,Stargard SzczeciÅski,2007,2111,34553,36664,5.757691468470434
559.0,PL039L1,OstrÃ³w Wielkopolski,2007,10,84751,84761,0.011797878741402295
560.0,PL040L1,PrzemyÅl,2007,9,85080,85089,0.010577160385008638
561.0,PL041L1,ZamoÅÄ,2007,92,112615,112707,0.08162758302501176
562.0,PL042L1,CheÅm,2007,54,46516,46570,0.11595447713120034
563.0,PL043L1,Pabianice,2007,0,32959,32959,0.0
564.0,PL044L1,GÅogÃ³w,2007,0,64081,64081,0.0
565.0,PL045L1,Stalowa Wola,2007,80,190233,190313,0.042036014355298905
566.0,PL046L1,TomaszÃ³w Mazowiecki,2007,599,18564,19163,3.125815373375776
567.0,PL047L1,ÅomÅ¼a,2007,0,56002,56002,0.0
568.0,PL048L1,Leszno,2007,205,77367,77572,0.2642706131078224
569.0,PL049L1,Åwidnica,2007,7,47983,47990,0.014586372160866848
570.0,PL051L1,Tczew,2007,90,27034,27124,0.331809467630143
571.0,PL052L1,EÅk,2007,625,39427,40052,1.5604713871966445
572.0,PL506L2,Bielsko-BiaÅa,2007,42,73393,73435,0.05719343637230203
573.0,PL508L1,Rybnik,2007,147,14734,14881,0.9878368389221154
574.0,PL511L2,WaÅbrzych,2007,10,51500,51510,0.01941370607649
575.0,PL512L2,ElblÄg,2007,13,96462,96475,0.01347499352163773
576.0,PL513L2,WÅocÅawek,2007,1615,120864,122479,1.318593391520179
577.0,PL514L2,TarnÃ³w,2007,58,125269,125327,0.04627893430785066
578.0,PL516L2,Legnica,2007,29,56471,56500,0.05132743362831858
579.0,PL517L2,GrudziÄdz,2007,244,54799,55043,0.44328979161746274
580.0,PT001L3,Lisboa,2007,7521,431760,439281,1.7121159349027162
581.0,PT002L2,Porto,2007,1162,94578,95740,1.2137037810737414
582.0,PT003L1,Braga,2007,46,49303,49349,0.09321364161381183
583.0,PT004L2,Funchal,2007,1250,34712,35962,3.4758912185084254
584.0,PT005L2,Coimbra,2007,404,162383,162787,0.24817706573620743
585.0,PT007L1,Ponta Delgada,2007,2886,52408,55294,5.219372807176185
586.0,PT008L2,Aveiro,2007,1847,41483,43330,4.262635587352873
587.0,PT009L1,Faro,2007,2511,46639,49150,5.1088504577822995
588.0,PT014L1,Viseu,2007,5,70869,70874,0.007054773259587437
589.0,PT016L0,Viana do Castelo,2007,382,31870,32252,1.1844226714622348
590.0,PT019L0,PÃ³voa de Varzim,2007,24,8382,8406,0.28551034975017847
591.0,PT505L1,GuimarÃ£es,2007,0,26541,26541,0.0
592.0,RO001L1,BucureÅti,2007,217,107625,107842,0.2012203037777489
593.0,RO002L1,Cluj-Napoca,2007,5,59297,59302,0.008431418839162253
594.0,RO003L1,TimiÅoara,2007,0,23654,23654,0.0
595.0,RO004L1,Craiova,2007,77,34319,34396,0.22386323991161763
596.0,RO005L1,BrÄila,2007,1088,22441,23529,4.624080921416125
597.0,RO006L1,Oradea,2007,1,20338,20339,0.004916662569447858
598.0,RO007L1,BacÄu,2007,213,21880,22093,0.9641062780066083
599.0,RO008L1,Arad,2007,2,51606,51608,0.0038753681599751973
600.0,RO009L1,Sibiu,2007,7,56333,56340,0.012424565140220091
601.0,RO010L1,TÃ¢rgu MureÅ,2007,6,13734,13740,0.043668122270742356
602.0,RO011L1,Piatra NeamÅ£,2007,56,14943,14999,0.3733582238815921
603.0,RO012L1,CÇlÇraÅi,2007,519,24025,24544,2.1145697522816165
604.0,RO013L1,Giurgiu,2007,536,10414,10950,4.894977168949772
605.0,RO014L1,Alba Iulia,2007,0,26002,26002,0.0
606.0,RO015L1,FocÅani,2007,0,27102,27102,0.0
607.0,RO016L1,TÃ¢rgu Jiu,2007,29,24493,24522,0.11826115325014273
608.0,RO017L1,Tulcea,2007,1419,39528,40947,3.4654553447138983
609.0,RO018L1,TÃ¢rgoviÅte,2007,4,20253,20257,0.019746260551907983
610.0,RO019L1,Slatina,2007,123,7000,7123,1.726800505405026
611.0,RO020L1,BÃ¢rlad,2007,82,26237,26319,0.31156198943728863
612.0,RO021L1,Roman,2007,0,14390,14390,0.0
613.0,RO022L1,BistriÅ£a,2007,1,42630,42631,0.00234571086767845
614.0,RO501L1,Constanta,2007,4601,54750,59351,7.752186146821452
615.0,RO502L1,Iasi,2007,126,79810,79936,0.15762610088070456
616.0,RO503L1,Galati,2007,872,40360,41232,2.1148622429181216
617.0,RO504L1,Brasov,2007,230,98273,98503,0.23349542653523245
618.0,RO505L1,Ploiesti,2007,0,34337,34337,0.0
619.0,RO506L1,Pitesti,2007,137,24747,24884,0.5505545732197397
620.0,RO507L1,Baia Mare,2007,11,52530,52541,0.020936030909194724
621.0,RO508L1,Buzau,2007,0,38540,38540,0.0
622.0,RO509L1,Satu Mare,2007,2,70842,70844,0.0028231042854723054
623.0,RO510L1,Botosani,2007,116,37224,37340,0.31065881092662023
624.0,RO511L1,Ramnicu Valcea,2007,355,28818,29173,1.216878620642375
625.0,RO512L1,Suceava,2007,53,39625,39678,0.1335752810121478
626.0,RO513L1,Drobeta-Turnu Severin,2007,2127,30807,32934,6.458371288030607
627.0,RS001L1,Beograd,2007,5744,307280,313024,1.8350030668574935
628.0,RS002L1,Novi Sad,2007,2044,187399,189443,1.0789525081422908
629.0,RS003L1,NiÅ¡,2007,24,341540,341564,0.0070265016219507904
630.0,RS004L1,Kragujevac,2007,245,143830,144075,0.1700503210133611
631.0,RS005L1,Subotica,2007,71,160221,160292,0.04429416315224715
632.0,RS006L1,Novi Pazar,2007,0,140791,140791,0.0
633.0,RS008L1,Zrenjanin,2007,689,184442,185131,0.37216889661915076
634.0,RS009L1,Kraljevo,2007,1,176511,176512,0.0005665337200870196
635.0,RS011L0,ÄaÄak,2007,0,63687,63687,0.0
636.0,RS012L1,KruÅ¡evac,2007,0,122649,122649,0.0
637.0,RS013L1,Leskovac,2007,12,166270,166282,0.007216656042145271
638.0,RS014L1,Valjevo,2007,0,141662,141662,0.0
639.0,RS015L1,Vranje,2007,0,195356,195356,0.0
640.0,RS016L1,Smederevo,2007,1315,158909,160224,0.8207259836229278
641.0,SE001L1,Stockholm,2007,73218,682508,755726,9.688432050769723
642.0,SE002L1,GÃ¶teborg,2007,47784,387475,435259,10.978291086456569
643.0,SE003L1,MalmÃ¶,2007,2006,186010,188016,1.0669304740022125
644.0,SE004L1,JÃ¶nkÃ¶ping,2007,54174,293017,347191,15.603515068074922
645.0,SE005L1,UmeÃ¥,2007,20798,967451,988249,2.1045303359780783
646.0,SE006L1,Uppsala,2007,15350,682177,697527,2.2006316601364535
647.0,SE007L1,LinkÃ¶ping,2007,24262,398934,423196,5.733040955018478
648.0,SE008L1,Ãrebro,2007,29331,339266,368597,7.9574711676980545
649.0,SE501L1,VÃ¤sterÃ¥s,2007,19834,270581,290415,6.829537041819465
650.0,SE502L1,NorrkÃ¶ping,2007,15385,296353,311738,4.935234074767914
651.0,SE503L1,Helsingborg,2007,599,113823,114422,0.5235007253849784
652.0,SE505L1,BorÃ¥s,2007,2662,94700,97362,2.73412625048787
653.0,SI001L2,Ljubljana,2007,537,232750,233287,0.23018856601525162
654.0,SI002L1,Maribor,2007,480,216505,216985,0.221213447934189
655.0,SK001L1,Bratislava,2007,955,203986,204941,0.4659877720905041
656.0,SK002L1,KoÅ¡ice,2007,82,177552,177634,0.046162333787450605
657.0,SK003L1,BanskÃ¡ Bystrica,2007,0,80880,80880,0.0
658.0,SK004L1,Nitra,2007,7,87120,87127,0.008034248855119538
659.0,SK005L1,PreÅ¡ov,2007,8,93291,93299,0.008574582792955981
660.0,SK006L1,Å½ilina,2007,52,81396,81448,0.06384441606914841
661.0,SK007L1,Trnava,2007,18,74202,74220,0.024252223120452707
662.0,SK008L1,TrenÄÃ­n,2007,1,67422,67423,0.001483173397801937
739.0,UK001L3,London,2007,2619,695551,698170,0.3751235372473753
740.0,UK002L3,West Midlands urban area,2007,666,214643,215309,0.3093228801397062
741.0,UK003L2,Leeds,2007,689,511738,512427,0.13445817648172323
742.0,UK004L1,Glasgow,2007,70991,266693,337684,21.022908991838523
743.0,UK006L3,Liverpool,2007,624,99879,100503,0.6208769887466046
744.0,UK007L1,Edinburgh,2007,2771,172647,175418,1.5796554515500119
745.0,UK008L3,Greater Manchester,2007,1828,310418,312246,0.5854358422525829
746.0,UK009L1,Cardiff,2007,146,84345,84491,0.17279946976601057
747.0,UK010L3,Sheffield,2007,729,125358,126087,0.5781722144233743
748.0,UK011L2,Bristol,2007,213,98172,98385,0.21649641713675866
749.0,UK012L2,Belfast,2007,36177,158968,195145,18.538522637013504
750.0,UK013L2,Newcastle upon Tyne,2007,8315,538393,546708,1.5209215888554768
751.0,UK014L1,Leicester,2007,167,139614,139781,0.11947260357273164
752.0,UK016L1,Aberdeen,2007,66441,587507,653948,10.159982139252662
753.0,UK017L2,Cambridge,2007,492,159127,159619,0.30823398217004244
754.0,UK018L3,Exeter,2007,1296,246430,247726,0.5231586510903176
755.0,UK019L3,Lincoln,2007,6975,204568,211543,3.2972019873028175
756.0,UK023L1,Portsmouth,2007,356,20497,20853,1.7071884141370546
757.0,UK024L1,Worcester,2007,336,60866,61202,0.5490016666122023
758.0,UK025L3,Coventry,2007,179,81268,81447,0.21977482289095976
759.0,UK026L1,Kingston upon Hull,2007,693,251005,251698,0.275329958919022
760.0,UK027L1,Stoke-on-Trent,2007,118,88058,88176,0.13382326256577753
761.0,UK029L1,Nottingham,2007,111,90178,90289,0.12293856394466657
762.0,UK033L1,Guildford,2007,12,61679,61691,0.019451783890680974
763.0,UK050L1,Burnley,2007,44,27930,27974,0.1572889111317652
764.0,UK056L1,Hastings,2007,78,54672,54750,0.14246575342465753
765.0,UK515L1,Brighton and Hove,2007,378,42029,42407,0.8913622750960927
766.0,UK516L1,Plymouth,2007,561,215214,215775,0.2599930483142162
767.0,UK517L1,Swansea,2007,415,83627,84042,0.4938007186882749
768.0,UK518L1,Derby,2007,68,68034,68102,0.0998502246630055
769.0,UK520L2,Southampton,2007,927,152425,153352,0.6044916271062654
770.0,UK528L1,Northampton,2007,382,154163,154545,0.2471771975799929
771.0,UK539L1,Bournemouth,2007,1077,92716,93793,1.1482733253014619
772.0,UK546L1,Colchester,2007,961,68534,69495,1.3828332973595223
773.0,UK550L0,Dundee City,2007,1775,224641,226416,0.7839551975125434
774.0,UK551L1,Falkirk,2007,3979,25810,29789,13.357279532713417
775.0,UK552L0,Reading,2007,22,21899,21921,0.10036038501893162
776.0,UK553L1,Blackpool,2007,94,48861,48955,0.19201307323051783
777.0,UK557L1,Blackburn with Darwen,2007,19,79535,79554,0.023883148553184
778.0,UK558L1,Newport,2007,68,31632,31700,0.2145110410094637
779.0,UK559L2,Middlesbrough,2007,634,61135,61769,1.0264048309022324
780.0,UK560L1,Oxford,2007,219,192704,192923,0.11351679167336193
781.0,UK562L2,Preston,2007,2,25760,25762,0.0077633724089744595
782.0,UK566L1,Norwich,2007,96,150144,150240,0.06389776357827476
783.0,UK568L1,Cheshire West and Chester,2007,400,135745,136145,0.2938043997208858
784.0,UK569L2,Ipswich,2007,1702,153944,155646,1.0935070608945943
785.0,UK571L1,Cheltenham,2007,14,46169,46183,0.030314184873221746
786.0,XK001L1,Pristina,2007,3,255804,255807,0.0011727591504532716
787.0,XK002L1,Prizren,2007,1,127632,127633,0.0007834964311737559
788.0,XK003L1,MitrovicÃ«,2007,1,117913,117914,0.0008480757161999422
1.0,AL001L1,Tirana,2008,1623,165498,167121,0.9711526379090599
2.0,AL003L1,Elbasan,2008,810,125194,126004,0.6428367353417351
3.0,AL004L1,ShkodÃ«r,2008,9944,175385,185329,5.365593080413751
4.0,AL005L0,VlorÃ«,2008,2288,61445,63733,3.5899769350258106
5.0,AT001L3,Wien,2008,13460,905030,918490,1.4654487256257553
6.0,AT002L3,Graz,2008,13200,277932,291132,4.534025802728659
7.0,AT003L3,Linz,2008,8873,350357,359230,2.4700052890905546
8.0,AT004L3,Salzburg,2008,1726,135750,137476,1.2554918676714482
9.0,AT005L3,Innsbruck,2008,22122,190700,212822,10.394602061816917
10.0,AT006L2,Klagenfurt,2008,5853,177407,183260,3.1938229837389502
11.0,BA001L1,Sarajevo,2008,72,263702,263774,0.02729609438382858
12.0,BA002L1,Banja Luka,2008,35,275267,275302,0.012713311200063929
13.0,BA003L1,Mostar,2008,799,181548,182347,0.4381755663652267
14.0,BA004L1,Tuzla,2008,1028,111233,112261,0.9157231808018813
15.0,BA005L1,Zenica,2008,15,86701,86716,0.01729784584159786
16.0,BE001L2,Bruxelles / Brussel,2008,90,326561,326651,0.027552341795984096
17.0,BE002L2,Antwerpen,2008,6615,112597,119212,5.548938026373184
18.0,BE003L2,Gent,2008,152,101689,101841,0.14925226578686382
19.0,BE004L2,Charleroi,2008,84,109681,109765,0.07652712613310254
20.0,BE005L2,LiÃ¨ge,2008,69,141329,141398,0.04879842713475439
21.0,BE006L2,Brugge,2008,6247,50292,56539,11.04901041758786
22.0,BE007L2,Namur,2008,6,84101,84107,0.007133770078590367
23.0,BE008L1,Leuven,2008,29,45047,45076,0.06433578844617979
24.0,BE009L1,Mons,2008,55,39145,39200,0.14030612244897958
25.0,BE010L1,Kortrijk,2008,623,21716,22339,2.788844621513944
26.0,BE011L1,Oostende,2008,166,20766,20932,0.7930441429390407
27.0,BG001L2,Sofia,2008,729,571045,571774,0.12749792750282454
28.0,BG002L2,Plovdiv,2008,190,276896,277086,0.06857076864222661
29.0,BG003L2,Varna,2008,3677,201121,204798,1.7954276897235326
30.0,BG004L2,Burgas,2008,5170,290730,295900,1.7472118959107805
31.0,BG005L1,Pleven,2008,1012,178064,179076,0.5651231879202127
32.0,BG006L2,Ruse,2008,2420,131597,134017,1.8057410627010007
33.0,BG007L2,Vidin,2008,1739,59225,60964,2.8525031165933994
34.0,BG008L2,Stara Zagora,2008,1,132067,132068,0.0007571856922191599
35.0,BG009L1,Sliven,2008,42,136732,136774,0.030707590623948993
36.0,BG010L1,Dobrich,2008,8,140330,140338,0.005700523022987359
37.0,BG011L1,Shumen,2008,44,94463,94507,0.04655739786470843
38.0,BG013L1,Yambol,2008,87,130719,130806,0.06651071051786615
39.0,BG014L1,Haskovo,2008,372,73596,73968,0.5029201817001947
40.0,BG015L1,Pazardzhik,2008,7,63815,63822,0.010968004763247783
41.0,BG016L1,Blagoevgrad,2008,313,135166,135479,0.23103211567844462
42.0,BG017L1,Veliko Tarnovo,2008,0,88539,88539,0.0
43.0,BG018L1,Vratsa,2008,43,70514,70557,0.060943634224811145
44.0,CH001L2,ZÃ¼rich,2008,133,127584,127717,0.10413648926924372
45.0,CH002L2,GenÃ¨ve,2008,129,53768,53897,0.23934541811232538
46.0,CH003L2,Basel,2008,92,69328,69420,0.13252664938058198
47.0,CH004L2,Bern,2008,2,78286,78288,0.0025546699366441857
48.0,CH005L2,Lausanne,2008,1,77504,77505,0.0012902393393974584
49.0,CH006L1,Winterthur,2008,0,13291,13291,0.0
50.0,CH007L2,St. Gallen,2008,836,31073,31909,2.6199504841894137
51.0,CH008L2,Luzern,2008,40,29219,29259,0.13671007211456304
52.0,CH009L2,Lugano,2008,5994,24631,30625,19.572244897959184
53.0,CH010L1,Biel/Bienne,2008,3,9092,9095,0.032985156679494226
54.0,CY001L2,Lefkosia,2008,34,162594,162628,0.020906608948028628
55.0,CY501L2,Lemesos,2008,1000,124899,125899,0.7942874844121082
56.0,CZ001L2,Praha,2008,44696,525866,570562,7.8336797753793626
57.0,CZ002L2,Brno,2008,17083,250832,267915,6.376276057704869
58.0,CZ003L2,Ostrava,2008,1137,141529,142666,0.7969663409642102
59.0,CZ004L2,PlzeÅ,2008,23799,172158,195957,12.145011405563466
60.0,CZ005L2,ÃstÃ­ nad Labem,2008,1014,34897,35911,2.8236473503940296
61.0,CZ006L2,Olomouc,2008,4,93560,93564,0.004275148561412509
62.0,CZ007L2,Liberec,2008,1648,59668,61316,2.6877160936786484
63.0,CZ008L2,ÄeskÃ© BudÄjovice,2008,968,128436,129404,0.7480448826929615
64.0,CZ009L2,Hradec KrÃ¡lovÃ©,2008,435,79070,79505,0.54713540028929
65.0,CZ010L2,Pardubice,2008,399,85958,86357,0.46203550378081687
66.0,CZ011L2,ZlÃ­n,2008,3,57949,57952,0.005176697956929873
67.0,CZ013L2,Karlovy Vary,2008,1810,45174,46984,3.852375276689937
68.0,CZ014L2,Jihlava,2008,1867,94160,96027,1.944244847803222
69.0,CZ016L2,Most,2008,4443,23335,27778,15.994672042623659
70.0,CZ018L2,Chomutov-Jirkov,2008,6270,39416,45686,13.72411679726831
71.0,DE001L1,Berlin,2008,47740,1700525,1748265,2.7307073012386565
72.0,DE002L1,Hamburg,2008,10199,723975,734174,1.3891802215823497
73.0,DE003L1,MÃ¼nchen,2008,4708,545233,549941,0.8560918353059691
74.0,DE004L1,KÃ¶ln,2008,1328,161302,162630,0.8165775072249892
75.0,DE005L1,Frankfurt am Main,2008,1166,429165,430331,0.270954218961683
76.0,DE007L1,Stuttgart,2008,306,364864,365170,0.08379658789057151
77.0,DE008L2,Leipzig,2008,8751,388938,397689,2.200463175999336
78.0,DE009L2,Dresden,2008,54027,529169,583196,9.263952427657255
79.0,DE011L1,DÃ¼sseldorf,2008,814,119503,120317,0.6765461239891287
80.0,DE012L1,Bremen,2008,25182,564357,589539,4.2714731340929095
81.0,DE013L1,Hannover,2008,2681,294631,297312,0.9017463136368529
82.0,DE014L1,NÃ¼rnberg,2008,208,293293,293501,0.07086858307126721
83.0,DE017L0,Bielefeld,2008,0,25883,25883,0.0
84.0,DE018L1,Halle an der Saale,2008,1640,155946,157586,1.040701585166195
85.0,DE019L2,Magdeburg,2008,416,416618,417034,0.09975205858515133
86.0,DE020L1,Wiesbaden,2008,1046,100392,101438,1.0311717502316686
87.0,DE021L1,GÃ¶ttingen,2008,8,238949,238957,0.003347882673451709
88.0,DE025L1,Darmstadt,2008,78,78109,78187,0.09976082980546637
89.0,DE026L1,Trier,2008,56,121071,121127,0.04623246674977503
90.0,DE027L1,Freiburg im Breisgau,2008,143,221053,221196,0.06464854698999982
91.0,DE028L1,Regensburg,2008,200,253462,253662,0.0788450773075983
92.0,DE029L0,Frankfurt (Oder),2008,1059,13785,14844,7.134195634599838
93.0,DE030L1,Weimar,2008,253,88775,89028,0.2841802578963922
94.0,DE031L1,Schwerin,2008,1824,488179,490003,0.3722426189227413
95.0,DE032L1,Erfurt,2008,10955,274557,285512,3.8369665723332123
96.0,DE033L1,Augsburg,2008,94,199840,199934,0.047015515119989595
97.0,DE034L1,Bonn,2008,5047,124290,129337,3.902208957993459
98.0,DE035L1,Karlsruhe,2008,670,125142,125812,0.5325406161574412
99.0,DE036L0,MÃ¶nchengladbach,2008,0,17023,17023,0.0
100.0,DE037L1,Mainz,2008,1262,69043,70305,1.795035914942038
101.0,DE038L1,Ruhrgebiet,2008,2063,441689,443752,0.4648993131298563
102.0,DE039L1,Kiel,2008,7084,332678,339762,2.084988903997504
103.0,DE040L1,SaarbrÃ¼cken,2008,1452,152230,153682,0.9448081102536408
104.0,DE042L1,Koblenz,2008,936,91240,92176,1.0154487068217322
105.0,DE043L2,Rostock,2008,416,361388,361804,0.11497938110136981
106.0,DE044L1,Kaiserslautern,2008,21,135506,135527,0.015495067403543204
107.0,DE045L1,Iserlohn,2008,353,105754,106107,0.33268304635886414
108.0,DE048L1,Wilhelmshaven,2008,1110,72937,74047,1.499047902008184
109.0,DE050L1,TÃ¼bingen,2008,3,52022,52025,0.005766458433445459
110.0,DE051L1,Villingen-Schwenningen,2008,6,102554,102560,0.005850234009360375
111.0,DE052L1,Flensburg,2008,1204,204271,205475,0.5859593624528531
112.0,DE053L1,Marburg,2008,19,126223,126242,0.015050458642923908
113.0,DE054L1,Konstanz,2008,58,81842,81900,0.07081807081807082
114.0,DE055L0,NeumÃ¼nster,2008,12,7164,7176,0.16722408026755853
115.0,DE056L0,Brandenburg an der Havel,2008,219,22611,22830,0.9592641261498028
116.0,DE057L1,GieÃen,2008,20,85508,85528,0.023384154896642036
117.0,DE058L1,LÃ¼neburg,2008,6,132496,132502,0.004528233536097568
118.0,DE059L1,Bayreuth,2008,156,199764,199920,0.07803121248499399
119.0,DE060L1,Celle,2008,86,154961,155047,0.05546705192619012
120.0,DE061L1,Aschaffenburg,2008,219,147397,147616,0.14835790158248427
121.0,DE062L1,Bamberg,2008,577,121578,122155,0.4723507019769964
122.0,DE063L1,Plauen,2008,17894,123394,141288,12.664911386671196
123.0,DE064L1,Neubrandenburg,2008,19472,564519,583991,3.3342979600713023
124.0,DE065L1,Fulda,2008,5,138220,138225,0.003617290649303671
125.0,DE066L1,Kempten (AllgÃ¤u),2008,1464,157703,159167,0.9197886496572781
126.0,DE067L1,Landshut,2008,91,141362,141453,0.06433232239683853
127.0,DE069L1,Rosenheim,2008,2,147761,147763,0.0013535188105276692
128.0,DE071L1,Stralsund,2008,12119,326129,338248,3.582874104207564
129.0,DE072L1,Friedrichshafen,2008,83,66536,66619,0.12458908119305304
130.0,DE073L1,Offenburg,2008,440,185444,185884,0.236706763357793
131.0,DE074L1,GÃ¶rlitz,2008,2959,208148,211107,1.4016588744096594
132.0,DE077L1,Schweinfurt,2008,100,201240,201340,0.04966722956193504
133.0,DE078L1,Greifswald,2008,2670,347124,349794,0.7633064031973104
134.0,DE079L1,Wetzlar,2008,14,106476,106490,0.013146774345008922
135.0,DE081L1,Passau,2008,399,159667,160066,0.24927217522771858
136.0,DE082L0,Dessau-RoÃlau,2008,20,24628,24648,0.08114248620577734
137.0,DE083L1,Braunschweig-Salzgitter-Wolfsburg,2008,365,412479,412844,0.08841111896987724
138.0,DE084L1,Mannheim-Ludwigshafen,2008,1395,203033,204428,0.6823918445614103
139.0,DE504L1,MÃ¼nster,2008,56,141707,141763,0.039502550030685014
140.0,DE505L0,Chemnitz,2008,102,22091,22193,0.45960437975938356
141.0,DE507L1,Aachen,2008,53,70467,70520,0.07515598411798072
142.0,DE508L0,Krefeld,2008,91,13589,13680,0.6652046783625731
143.0,DE510L1,LÃ¼beck,2008,1775,160374,162149,1.0946721842256197
144.0,DE513L1,Kassel,2008,15,139846,139861,0.010724934041655644
145.0,DE516L0,Solingen,2008,6,8948,8954,0.06700915791824882
146.0,DE517L1,OsnabrÃ¼ck,2008,143,223987,224130,0.0638022576183465
147.0,DE520L1,Oldenburg (Oldenburg),2008,1514,188455,189969,0.796972137559286
148.0,DE522L1,Heidelberg,2008,286,116819,117105,0.24422526792195037
149.0,DE523L1,Paderborn,2008,194,124489,124683,0.15559458787485062
150.0,DE524L2,WÃ¼rzburg,2008,3685,302244,305929,1.204527847964724
151.0,DE527L1,Bremerhaven,2008,8213,206266,214479,3.8292793233836413
152.0,DE529L1,Heilbronn,2008,42,119942,119984,0.035004667288971864
153.0,DE530L0,Remscheid,2008,17,7352,7369,0.23069615958746098
154.0,DE532L1,Ulm,2008,13595,185713,199308,6.821101009492845
155.0,DE533L1,Pforzheim,2008,2,67146,67148,0.00297849526419253
156.0,DE534L1,Ingolstadt,2008,522,284313,284835,0.18326399494444154
157.0,DE535L1,Gera,2008,297,99489,99786,0.2976369430581444
158.0,DE537L1,Reutlingen,2008,730,108552,109282,0.6679965593601874
159.0,DE539L1,Cottbus,2008,7296,174984,182280,4.002633311389072
160.0,DE540L2,Siegen,2008,1878,175686,177564,1.0576468203014124
161.0,DE542L1,Hildesheim,2008,80,120730,120810,0.06621968380100984
162.0,DE544L1,Zwickau,2008,1917,92887,94804,2.0220665794692207
163.0,DE546L0,Wuppertal,2008,13,16820,16833,0.07722925206439732
164.0,DE547L2,Jena,2008,152,92916,93068,0.16332144238621224
165.0,DE548L1,DÃ¼ren,2008,20,94018,94038,0.02126799804334418
166.0,DE549L1,Bocholt,2008,44,142221,142265,0.03092819737813236
167.0,DK001L2,KÃ¸benhavn,2008,5159,286064,291223,1.7714946965040537
168.0,DK002L3,Ãrhus,2008,5175,457349,462524,1.1188608591121758
169.0,DK003L2,Odense,2008,8177,351662,359839,2.2724051589738745
170.0,DK004L3,Aalborg,2008,3956,616503,620459,0.6375924920099475
171.0,EE001L1,Tallinn,2008,7169,431892,439061,1.6328027312833524
172.0,EE002L1,Tartu,2008,79313,220329,299642,26.46925330894868
173.0,EE003L0,Narva,2008,267,6622,6889,3.8757439396138773
174.0,EL001L1,Athina,2008,5167,304220,309387,1.6700766354113132
175.0,EL002L1,Thessaloniki,2008,1538,140581,142119,1.0821916844334678
176.0,EL003L1,Patra,2008,671,50919,51590,1.300639658848614
177.0,EL004L1,Irakleio,2008,1090,60294,61384,1.7757070246318256
178.0,EL005L1,Larisa,2008,61,155458,155519,0.03922350323754654
179.0,EL006L1,Volos,2008,281,30535,30816,0.9118639667705088
180.0,EL007L1,Ioannina,2008,4676,127965,132641,3.525305146975671
181.0,EL008L1,Kavala,2008,332,35236,35568,0.9334233018443544
182.0,EL009L1,Kalamata,2008,271,44181,44452,0.6096463601187798
183.0,ES001L3,Madrid,2008,3190,784413,787603,0.4050263901991232
184.0,ES002L2,Barcelona,2008,1519,263088,264607,0.5740588873310231
185.0,ES003L3,Valencia,2008,3218,171902,175120,1.8375970762905436
186.0,ES004L3,Sevilla,2008,4191,464235,468426,0.8946984155448247
187.0,ES005L2,Zaragoza,2008,210,275928,276138,0.07604893205571128
188.0,ES006L2,MÃ¡laga,2008,937,151805,152742,0.6134527503895457
189.0,ES007L2,Murcia,2008,178,119958,120136,0.1481654125324632
190.0,ES008L2,Las Palmas,2008,76596,0,76596,100.0
191.0,ES009L2,Valladolid,2008,181,115348,115529,0.15667061949813468
192.0,ES010L2,Palma de Mallorca,2008,2275,201959,204234,1.1139183485609643
193.0,ES011L2,Santiago de Compostela,2008,2,126254,126256,0.0015840831326828033
194.0,ES012L2,Vitoria/Gasteiz,2008,867,158454,159321,0.5441843824731203
195.0,ES013L2,Oviedo,2008,29,93458,93487,0.031020355771390673
196.0,ES014L3,Pamplona/IruÃ±a,2008,31340,138174,169514,18.488148471512677
197.0,ES015L2,Santander,2008,517,68966,69483,0.7440668940604176
198.0,ES016L2,Toledo,2008,506,92892,93398,0.5417674896678729
199.0,ES017L2,Badajoz,2008,820,217929,218749,0.3748588564976297
200.0,ES018L2,LogroÃ±o,2008,65,46073,46138,0.14088170271793315
201.0,ES019L3,Bilbao,2008,5375,147946,153321,3.5057167641745095
202.0,ES020L2,CÃ³rdoba,2008,1199,185703,186902,0.6415126643909643
203.0,ES021L2,Alicante/Alacant,2008,490,35568,36058,1.358921737201176
204.0,ES022L2,Vigo,2008,1119,135352,136471,0.8199544225513113
205.0,ES023L2,GijÃ³n,2008,865,52537,53402,1.6197895209917232
206.0,ES025L3,Santa Cruz de Tenerife,2008,66983,0,66983,100.0
207.0,ES026L2,CoruÃ±a (A),2008,659,75316,75975,0.8673905890095426
208.0,ES028L1,Reus,2008,0,11534,11534,0.0
209.0,ES031L1,Lugo,2008,0,134011,134011,0.0
210.0,ES033L1,Girona,2008,2,39619,39621,0.005047828171929028
211.0,ES034L1,CÃ¡ceres,2008,1948,236325,238273,0.8175496174556077
212.0,ES035L1,Torrevieja,2008,1726,7112,8838,19.52930527268613
213.0,ES039L1,AvilÃ©s,2008,1050,18092,19142,5.485320238219622
214.0,ES040L1,Talavera de la Reina,2008,561,82705,83266,0.6737443854634545
215.0,ES041L1,Palencia,2008,13,28368,28381,0.045805292272999544
216.0,ES043L1,Ferrol,2008,401,46569,46970,0.8537364275069194
217.0,ES044L1,Pontevedra,2008,198,51418,51616,0.38360198388096717
218.0,ES046L1,Gandia,2008,261,17076,17337,1.5054507700294169
219.0,ES048L1,Guadalajara,2008,15,45368,45383,0.03305202388559593
220.0,ES050L1,Manresa,2008,3,29600,29603,0.010134108029591596
221.0,ES053L1,Ciudad Real,2008,622,95723,96345,0.6455965540505475
222.0,ES054L1,Benidorm,2008,361,20312,20673,1.746239055773231
223.0,ES057L1,Ponferrada,2008,271,62072,62343,0.43469194616877593
224.0,ES059L1,Zamora,2008,334,33846,34180,0.9771796372147454
225.0,ES070L1,Irun,2008,724,6518,7242,9.997238331952499
226.0,ES072L1,Arrecife,2008,58934,0,58934,100.0
227.0,ES501L3,Granada,2008,4936,157688,162624,3.0352223534041713
228.0,ES505L1,Elche/Elx,2008,927,37891,38818,2.388067391416353
229.0,ES506L1,Cartagena,2008,1580,59368,60948,2.592373826868806
230.0,ES508L1,Jerez de la Frontera,2008,182,125924,126106,0.14432302983204606
231.0,ES510L1,Donostia-San SebastiÃ¡n,2008,1787,31533,33320,5.363145258103241
232.0,ES514L1,AlmerÃ­a,2008,746,39984,40730,1.8315737785416155
233.0,ES515L1,Burgos,2008,6,149385,149391,0.004016306203184931
234.0,ES516L1,Salamanca,2008,25,45619,45644,0.054771711506441154
235.0,ES519L1,Albacete,2008,343,244982,245325,0.13981453174360542
236.0,ES520L1,CastellÃ³n/CastellÃ³,2008,413,32381,32794,1.2593767152527902
237.0,ES521L1,Huelva,2008,3890,93530,97420,3.993019913775406
238.0,ES522L1,CÃ¡diz,2008,1045,23788,24833,4.208110175975516
239.0,ES523L1,LeÃ³n,2008,3,118884,118887,0.0025234045774559033
240.0,ES525L1,Tarragona,2008,489,21251,21740,2.249310027598896
241.0,ES527L1,JaÃ©n,2008,40,99891,99931,0.04002761905714943
242.0,ES528L1,Lleida,2008,132,70543,70675,0.1867704280155642
243.0,ES529L1,Ourense,2008,307,64861,65168,0.4710901055732875
244.0,ES532L1,Algeciras,2008,520,41774,42294,1.229488816380574
245.0,ES533L1,Marbella,2008,613,68592,69205,0.8857741492666715
246.0,ES537L1,Alcoy,2008,0,20529,20529,0.0
247.0,ES538L1,Ãvila,2008,505,53141,53646,0.9413562986988777
248.0,ES542L1,Cuenca,2008,79,164503,164582,0.04800038886390979
249.0,ES543L1,Eivissa,2008,2142,57260,59402,3.605939193966533
250.0,ES544L1,Linares,2008,13,25763,25776,0.05043451272501552
251.0,ES545L1,Lorca,2008,146,182061,182207,0.08012864489289655
252.0,ES546L1,MÃ©rida,2008,876,127423,128299,0.6827800684338927
253.0,ES547L1,Sagunto,2008,221,15307,15528,1.423235445646574
254.0,ES550L1,Puerto de la Cruz,2008,27472,0,27472,100.0
255.0,ES552L1,Igualada,2008,1,25425,25426,0.003932981986942499
256.0,FI001L3,Helsinki,2008,31808,459710,491518,6.471380498781326
257.0,FI002L3,Tampere,2008,75962,612681,688643,11.030679176293086
258.0,FI003L4,Turku,2008,21301,445143,466444,4.566678958245792
259.0,FI004L4,Oulu,2008,723821,0,723821,100.0
260.0,FI007L2,Lahti,2008,53638,281765,335403,15.992105019931246
261.0,FI008L2,Kuopio,2008,418179,502227,920406,45.43418882536619
262.0,FI009L2,JyvÃ¤skylÃ¤,2008,257372,219570,476942,53.96295566337207
263.0,FR001L1,Paris,2008,14642,1195310,1209952,1.2101306498109017
264.0,FR003L2,Lyon,2008,39,367192,367231,0.010620018462493634
265.0,FR004L2,Toulouse,2008,856,523816,524672,0.1631495486704074
266.0,FR006L2,Strasbourg,2008,916,202967,203883,0.44927728157816
267.0,FR007L2,Bordeaux,2008,26050,529704,555754,4.687325687264509
268.0,FR008L2,Nantes,2008,36823,279796,316619,11.630066420524352
269.0,FR009L2,Lille,2008,2161,142292,144453,1.4959883145382928
270.0,FR010L2,Montpellier,2008,7312,216606,223918,3.265481113621951
271.0,FR011L2,Saint-Etienne,2008,52,181003,181055,0.028720554527629727
272.0,FR012L2,Le Havre,2008,3180,73258,76438,4.1602344383683505
273.0,FR013L2,Rennes,2008,1948,380189,382137,0.5097648225636355
274.0,FR014L2,Amiens,2008,8351,236444,244795,3.411425886966646
275.0,FR016L2,Nancy,2008,1939,281570,283509,0.6839289052552123
276.0,FR017L2,Metz,2008,290,176640,176930,0.16390662974057538
277.0,FR018L2,Reims,2008,62,243089,243151,0.025498558508910103
278.0,FR019L2,OrlÃ©ans,2008,1503,290464,291967,0.5147842050642709
279.0,FR020L2,Dijon,2008,51,385710,385761,0.013220621058116295
280.0,FR021L2,Poitiers,2008,83,250359,250442,0.033141405994202254
281.0,FR022L2,Clermont-Ferrand,2008,23994,242132,266126,9.016030000826676
282.0,FR023L2,Caen,2008,45750,180523,226273,20.218939069177498
283.0,FR024L2,Limoges,2008,1098,316736,317834,0.3454633550847298
284.0,FR025L2,BesanÃ§on,2008,7,239029,239036,0.0029284291905821718
285.0,FR026L2,Grenoble,2008,326,265522,265848,0.12262646324215341
286.0,FR027L2,Ajaccio,2008,1503,145506,147009,1.0223863845070709
289.0,FR032L2,Toulon,2008,2332,104724,107056,2.178299207891197
290.0,FR034L2,Valenciennes,2008,61,78385,78446,0.07776049766718507
291.0,FR035L2,Tours,2008,671,284177,284848,0.23556423074762683
292.0,FR036L2,Angers,2008,1151,230100,231251,0.4977275773942599
293.0,FR037L2,Brest,2008,12882,122112,134994,9.542646339837328
294.0,FR038L2,Le Mans,2008,63,224048,224111,0.028111069960867607
295.0,FR039L1,Avignon,2008,1476,85749,87225,1.6921754084264833
296.0,FR040L2,Mulhouse,2008,0,129766,129766,0.0
297.0,FR042L2,Dunkerque,2008,905,90220,91125,0.9931412894375857
298.0,FR043L2,Perpignan,2008,1632,181398,183030,0.8916571053925586
299.0,FR044L2,NÃ®mes,2008,1373,149118,150491,0.9123469177558791
300.0,FR045L2,Pau,2008,33,201726,201759,0.016356147681144337
301.0,FR046L2,Bayonne,2008,81667,20963,102630,79.57419857741401
302.0,FR047L0,Annemasse,2008,0,7800,7800,0.0
303.0,FR048L2,Annecy,2008,1490,117553,119043,1.2516485639642818
304.0,FR049L2,Lorient,2008,653,112529,113182,0.5769468643423866
305.0,FR050L2,MontbÃ©liard,2008,6,123051,123057,0.00487578926838782
306.0,FR051L2,Troyes,2008,595,260355,260950,0.2280130293159609
307.0,FR052L2,Saint-Nazaire,2008,403,106732,107135,0.3761609184673543
308.0,FR053L2,La Rochelle,2008,322,111018,111340,0.28920423926710975
309.0,FR056L2,AngoulÃªme,2008,192,214100,214292,0.0895973718104269
310.0,FR057L2,Boulogne-sur-Mer,2008,129,68409,68538,0.18821675566838833
311.0,FR058L2,ChambÃ©ry,2008,288,101401,101689,0.2832164737582236
312.0,FR059L2,Chalon-sur-SaÃ´ne,2008,17,156341,156358,0.01087248493841057
313.0,FR060L2,Chartres,2008,463,160897,161360,0.2869360436291522
314.0,FR061L2,Niort,2008,9999,168920,178919,5.588562422101622
315.0,FR062L2,Calais,2008,49,50181,50230,0.09755126418475014
316.0,FR063L2,BÃ©ziers,2008,507,84636,85143,0.595468799548994
317.0,FR064L2,Arras,2008,15749,91814,107563,14.641651869137156
318.0,FR065L2,Bourges,2008,123,250196,250319,0.049137300804173875
319.0,FR066L2,Saint-Brieuc,2008,171,115010,115181,0.1484619859178163
320.0,FR067L2,Quimper,2008,1285,120637,121922,1.0539525270254753
321.0,FR068L2,Vannes,2008,1006,120028,121034,0.831171406381678
322.0,FR069L2,Cherbourg,2008,1561,89157,90718,1.7207169470226416
323.0,FR073L2,Tarbes,2008,26,104303,104329,0.024921162859799287
324.0,FR074L2,CompiÃ¨gne,2008,142,98595,98737,0.14381640114648006
325.0,FR076L2,Belfort,2008,10,65609,65619,0.015239488562763834
326.0,FR077L2,Roanne,2008,84,123116,123200,0.06818181818181819
327.0,FR079L2,Saint-Quentin,2008,45,99329,99374,0.045283474550687305
328.0,FR082L2,Beauvais,2008,0,131142,131142,0.0
329.0,FR084L2,Creil,2008,1628,28015,29643,5.492021725196505
330.0,FR086L2,Evreux,2008,3331,123239,126570,2.6317452792920912
331.0,FR090L2,ChÃ¢teauroux,2008,399,260778,261177,0.15276996060143122
332.0,FR093L2,Brive-la-Gaillarde,2008,0,132582,132582,0.0
333.0,FR096L2,Albi,2008,153,134085,134238,0.11397666830554687
334.0,FR099L2,FrÃ©jus,2008,431,43982,44413,0.9704365838830973
335.0,FR104L2,ChÃ¢lons-en-Champagne,2008,25,152784,152809,0.016360292914684344
336.0,FR203L2,Marseille,2008,3052,422724,425776,0.7168088384502649
337.0,FR205L2,Nice,2008,1737,305603,307340,0.5651721220797813
338.0,FR207L2,Lens - LiÃ©vin,2008,3707,21601,25308,14.647542279121225
339.0,FR208L1,HÃ©nin - Carvin,2008,919,10679,11598,7.923779962062424
340.0,FR209L2,Douai,2008,43,45041,45084,0.09537751752284623
341.0,FR214L1,Valence,2008,657,90304,90961,0.7222875737953629
342.0,FR215L2,Rouen,2008,8193,278933,287126,2.8534510981241685
343.0,FR304L1,Melun,2008,76,44760,44836,0.16950664644482114
344.0,FR324L1,Martigues,2008,1921,18535,20456,9.390887759092687
345.0,FR505L1,Charleville-MÃ©ziÃ¨res,2008,0,135369,135369,0.0
346.0,FR506L1,Colmar,2008,19,101966,101985,0.018630190714320732
347.0,FR519L1,Cannes,2008,508,19628,20136,2.522844656336909
348.0,HR001L2,Grad Zagreb,2008,389,505479,505868,0.0768975305811002
349.0,HR002L2,Rijeka,2008,893,106341,107234,0.8327582669675662
350.0,HR003L2,Slavonski Brod,2008,600,97230,97830,0.613308800981294
351.0,HR004L2,Osijek,2008,1548,171386,172934,0.8951391860478565
352.0,HR005L2,Split,2008,3423,335647,339070,1.0095260565664907
353.0,HR006L1,Pula - Pola,2008,1333,57564,58897,2.2632731718084114
354.0,HR007L1,Zadar,2008,2454,154046,156500,1.5680511182108627
355.0,HU001L2,Budapest,2008,21065,618069,639134,3.295865968638814
356.0,HU002L2,Miskolc,2008,271,164398,164669,0.1645725667854909
357.0,HU003L2,NyÃ­regyhÃ¡za,2008,239,167986,168225,0.14207163025709615
358.0,HU004L2,PÃ©cs,2008,265,185223,185488,0.14286638488743209
359.0,HU005L2,Debrecen,2008,625,200953,201578,0.3100536764924744
360.0,HU006L2,Szeged,2008,731,160202,160933,0.4542262929293557
361.0,HU007L2,GyÃµr,2008,50,204590,204640,0.02443315089913995
362.0,HU008L2,KecskemÃ©t,2008,105,182034,182139,0.057648279610627046
363.0,HU009L2,SzÃ©kesfehÃ©rvÃ¡r,2008,4422,296701,301123,1.4685029041288775
364.0,HU010L1,Szombathely,2008,25,134252,134277,0.01861822948084929
365.0,HU011L1,Szolnok,2008,614,143361,143975,0.42646292759159576
366.0,HU012L1,TatabÃ¡nya,2008,4,69826,69830,0.0057281970499785196
367.0,HU013L1,VeszprÃ©m,2008,7143,124177,131320,5.439384709107523
368.0,HU014L1,BÃ©kÃ©scsaba,2008,92,106071,106163,0.08665919388110736
369.0,HU015L1,KaposvÃ¡r,2008,37,145523,145560,0.025419071173399286
370.0,HU016L1,Eger,2008,137,100441,100578,0.13621269064805425
371.0,HU017L1,DunaÃºjvÃ¡ros,2008,773,60897,61670,1.2534457596886655
372.0,HU018L1,Zalaegerszeg,2008,77,139902,139979,0.05500825123768566
373.0,HU019L1,Sopron,2008,88,80582,80670,0.10908640138837238
374.0,IE001L1,Dublin,2008,206097,497505,703602,29.291701842803175
375.0,IE002L1,Cork,2008,35784,293879,329663,10.854721336637718
376.0,IE003L1,Limerick,2008,21652,134806,156458,13.83885771261297
377.0,IE004L1,Galway,2008,21962,204321,226283,9.70554571045991
378.0,IE005L1,Waterford,2008,19965,75892,95857,20.827899892548274
379.0,IS001L1,ReykjavÃ­k,2008,1297230,0,1297230,100.0
380.0,IT001L3,Roma,2008,8918,608298,617216,1.4448750518457072
381.0,IT002L3,Milano,2008,265,383780,384045,0.06900233045606635
382.0,IT003L3,Napoli,2008,3016,149926,152942,1.9719893815956375
383.0,IT004L2,Torino,2008,76,170103,170179,0.044658859201194036
384.0,IT005L3,Palermo,2008,1585,148488,150073,1.0561526723661152
385.0,IT006L3,Genova,2008,714,120050,120764,0.5912357987479713
386.0,IT007L3,Firenze,2008,162,163609,163771,0.09891861196426718
387.0,IT008L3,Bari,2008,780,112649,113429,0.6876548325384161
388.0,IT009L1,Bologna,2008,94,185163,185257,0.0507403229027783
389.0,IT010L2,Catania,2008,691,60734,61425,1.124949124949125
390.0,IT011L2,Venezia,2008,1799,65238,67037,2.6835926428688635
391.0,IT012L3,Verona,2008,79,73082,73161,0.10798102814340975
392.0,IT013L3,Cremona,2008,178,60219,60397,0.29471662499793033
393.0,IT014L3,Trento,2008,659,97528,98187,0.671168280933321
394.0,IT015L1,Trieste,2008,341,21296,21637,1.5760040671072701
395.0,IT016L3,Perugia,2008,5551,125477,131028,4.236499068901304
396.0,IT017L3,Ancona,2008,577,43666,44243,1.304161110232127
397.0,IT019L2,Pescara,2008,234,16209,16443,1.4230979748221126
398.0,IT020L3,Campobasso,2008,367,102468,102835,0.3568823844021977
399.0,IT021L2,Caserta,2008,1,9341,9342,0.010704345964461572
400.0,IT022L2,Taranto,2008,6543,100385,106928,6.1190707765973364
401.0,IT023L2,Potenza,2008,166,138289,138455,0.11989455057599943
402.0,IT024L3,Catanzaro,2008,473,89610,90083,0.525071323113129
403.0,IT025L3,Reggio di Calabria,2008,566,47682,48248,1.1731056209583817
404.0,IT026L3,Sassari,2008,2245,150980,153225,1.465165606134769
405.0,IT027L2,Cagliari,2008,4980,190312,195292,2.5500276509022384
406.0,IT028L3,Padova,2008,7,61438,61445,0.01139230205875173
407.0,IT029L3,Brescia,2008,84,60185,60269,0.13937513481225836
408.0,IT030L3,Modena,2008,118,69150,69268,0.17035283247675692
409.0,IT031L3,Foggia,2008,4,89707,89711,0.004458762024723836
410.0,IT032L3,Salerno,2008,464,37375,37839,1.2262480509527207
411.0,IT033L2,Piacenza,2008,190,93937,94127,0.20185494066527138
412.0,IT034L1,Bolzano,2008,2003,104753,106756,1.8762411480385175
413.0,IT035L2,Udine,2008,1,71829,71830,0.0013921759710427398
414.0,IT036L2,La Spezia,2008,627,42292,42919,1.4608914466786271
415.0,IT037L1,Lecce,2008,2245,59265,61510,3.6498130385303202
416.0,IT038L1,Barletta,2008,230,14867,15097,1.5234814863880242
417.0,IT039L2,Pesaro,2008,133,25558,25691,0.5176910202016269
418.0,IT040L2,Como,2008,2119,17622,19741,10.734005369535485
419.0,IT041L2,Pisa,2008,528,47525,48053,1.0987867562899298
420.0,IT042L1,Treviso,2008,31,24014,24045,0.1289249324183822
421.0,IT043L2,Varese,2008,913,22751,23664,3.858181203515889
422.0,IT045L2,Asti,2008,32,54804,54836,0.058355824640746956
423.0,IT046L2,Pavia,2008,10,36194,36204,0.027621257319633188
424.0,IT047L1,Massa,2008,411,10832,11243,3.6556079338254914
425.0,IT048L2,Cosenza,2008,753,91726,92479,0.8142389082926934
426.0,IT052L1,Savona,2008,444,28261,28705,1.5467688556000696
427.0,IT054L1,Matera,2008,590,77199,77789,0.7584619933409609
428.0,IT056L1,Acireale,2008,52,5936,5988,0.8684034736138945
429.0,IT057L2,Avellino,2008,28,39731,39759,0.0704243064463392
430.0,IT058L2,Pordenone,2008,22,37028,37050,0.05937921727395412
431.0,IT060L1,Lecco,2008,2773,27439,30212,9.17847213027936
432.0,IT061L0,Altamura,2008,1,42799,42800,0.002336448598130841
433.0,IT064L1,Battipaglia,2008,56,6430,6486,0.8633980881899477
434.0,IT065L0,Bisceglie,2008,91,6853,6944,1.310483870967742
435.0,IT066L1,Carpi,2008,3,20619,20622,0.014547570555717195
436.0,IT067L0,Cerignola,2008,135,58762,58897,0.22921371207362007
437.0,IT068L1,Gallarate,2008,5,5314,5319,0.09400263207369806
438.0,IT069L1,Gela,2008,413,57482,57895,0.7133603938163918
439.0,IT073L1,Sassuolo,2008,0,24062,24062,0.0
440.0,IT501L2,Messina,2008,750,33693,34443,2.177510669802282
441.0,IT502L2,Prato,2008,14,40945,40959,0.03418052198540003
442.0,IT503L3,Parma,2008,80,113427,113507,0.07048023469918155
443.0,IT504L3,Livorno,2008,385,25429,25814,1.491438754164407
444.0,IT505L3,Reggio nell'Emilia,2008,9,69025,69034,0.013037054205174262
445.0,IT506L2,Ravenna,2008,3556,77633,81189,4.379903681533213
446.0,IT507L2,Ferrara,2008,848,90635,91483,0.9269481761638774
447.0,IT508L3,Rimini,2008,385,32194,32579,1.1817428404800638
448.0,IT509L3,Siracusa,2008,549,33593,34142,1.6079901587487553
449.0,IT511L2,Bergamo,2008,3,18553,18556,0.016167277430480707
450.0,IT512L3,ForlÃ¬,2008,14,72737,72751,0.0192437217357837
451.0,IT513L3,Latina,2008,2527,63966,66493,3.800400042109696
452.0,IT514L2,Vicenza,2008,19,34963,34982,0.054313647018466645
453.0,IT515L2,Terni,2008,129,102203,102332,0.1260602744009694
454.0,IT516L2,Novara,2008,99,54066,54165,0.18277485461091109
455.0,IT518L1,Alessandria,2008,202,76712,76914,0.26263099045687394
456.0,IT519L1,Arezzo,2008,26,88601,88627,0.029336432464147494
457.0,IT520L1,Grosseto,2008,454,119145,119599,0.37960183613575366
458.0,IT521L1,Brindisi,2008,5628,58359,63987,8.795536593370528
459.0,IT522L1,Trapani,2008,901,49889,50790,1.7739712541838943
460.0,IT523L1,Ragusa,2008,267,52583,52850,0.5052034058656576
461.0,IT524L0,Andria,2008,0,39880,39880,0.0
462.0,IT525L0,Trani,2008,124,10255,10379,1.1947201079102032
463.0,IT526L1,L'Aquila,2008,1693,138576,140269,1.206966614148529
464.0,LT001L1,Vilnius,2008,4816,419753,424569,1.1343268114252336
465.0,LT002L1,Kaunas,2008,1212,160839,162051,0.7479126941518411
466.0,LT003L1,PanevÄÅ¾ys,2008,44,222764,222808,0.0197479444185128
467.0,LT004L0,Alytus,2008,24,3935,3959,0.6062136903258398
468.0,LT501L0,KlaipÄda,2008,83,8840,8923,0.9301804325899362
469.0,LT502L0,Å iauliai,2008,1191,6854,8045,14.80422622747048
470.0,LU001L1,Luxembourg,2008,3628,256087,259715,1.396915850066419
471.0,LV001L1,RÄ«ga,2008,14488,601761,616249,2.35099772981376
472.0,LV002L2,LiepÄja,2008,3370,268687,272057,1.2387110054143065
473.0,LV003L1,Jelgava,2008,561,165898,166459,0.33701992682882875
474.0,LV501L1,Daugavpils,2008,1042,258633,259675,0.4012708192933474
475.0,ME001L1,Podgorica,2008,1043,183438,184481,0.5653698754885327
476.0,MK001L1,Skopje,2008,2,224351,224353,0.0008914523095300709
477.0,MK003L1,Bitola,2008,1669,117993,119662,1.3947619127208302
478.0,MK004L1,Tetovo,2008,22,105599,105621,0.020829191164635823
479.0,MK005L1,Prilep,2008,17,86814,86831,0.019578261220071173
480.0,MT001L1,Valletta,2008,1054,24902,25956,4.060718138388041
481.0,NL001L3,s' Gravenhage,2008,3924,38783,42707,9.188189289811975
482.0,NL002L3,Amsterdam,2008,89798,243159,332957,26.969848959475247
483.0,NL003L3,Rotterdam,2008,59797,157374,217171,27.534523486100817
484.0,NL004L3,Utrecht,2008,16164,81123,97287,16.6147583952635
485.0,NL005L3,Eindhoven,2008,149,144257,144406,0.10318130825588964
486.0,NL006L3,Tilburg,2008,1691,41543,43234,3.9112735347180463
487.0,NL007L3,Groningen,2008,3602,204558,208160,1.730399692544197
488.0,NL008L3,Enschede,2008,137,84819,84956,0.16125994632515656
489.0,NL009L3,Arnhem,2008,1150,54748,55898,2.0573186876095746
490.0,NL010L3,Heerlen,2008,17,33326,33343,0.05098521428785652
491.0,NL012L3,Breda,2008,8244,65126,73370,11.236200081777294
492.0,NL013L3,Nijmegen,2008,924,38912,39836,2.319509990962948
493.0,NL014L3,Apeldoorn,2008,49,71075,71124,0.06889376300545526
494.0,NL015L3,Leeuwarden,2008,1122,109801,110923,1.0115124906466648
495.0,NL016L3,Sittard-Geleen,2008,9,22903,22912,0.03928072625698324
496.0,NL020L3,Roosendaal,2008,601,23973,24574,2.445674289899894
497.0,NL026L0,Alphen aan den Rijn,2008,2119,11091,13210,16.040878122634368
498.0,NL028L3,Bergen op Zoom,2008,2140,32641,34781,6.152784566286191
499.0,NL030L0,Gouda,2008,157,1631,1788,8.780760626398209
500.0,NL032L3,MiddelburgÂ Â Â Â Â Â ,2008,1066,22322,23388,4.557892936548658
501.0,NL503L3,s-Hertogenbosch,2008,401,36458,36859,1.0879296779619632
502.0,NL504L3,Amersfoort,2008,0,12244,12244,0.0
503.0,NL505L3,Maastricht,2008,1,20384,20385,0.004905567819475104
504.0,NL507L3,Leiden,2008,557,19224,19781,2.815833375461301
505.0,NL511L3,Zwolle,2008,1211,121809,123020,0.9843927816615184
506.0,NL512L3,Ede,2008,73,35192,35265,0.2070041117255069
507.0,NL513L3,Deventer,2008,51,25194,25245,0.20202020202020202
508.0,NL514L3,Alkmaar,2008,688,47104,47792,1.4395714763977234
509.0,NL515L3,Venlo,2008,326,50910,51236,0.6362713716917793
510.0,NL519L3,Almelo,2008,14,42011,42025,0.03331350386674598
511.0,NL520L3,Lelystad,2008,59158,59684,118842,49.778697766782784
512.0,NL521L3,Oss,2008,54,33092,33146,0.16291558559102154
513.0,NL522L3,Assen,2008,181,70681,70862,0.2554260393440772
514.0,NL524L3,Veenendaal,2008,16,8169,8185,0.19547953573610263
515.0,NL529L3,Soest,2008,1688,6254,7942,21.254092168219593
516.0,NO001L1,Oslo,2008,26923,719720,746643,3.6058732218744436
517.0,NO002L1,Bergen,2008,24645,333098,357743,6.889023684600397
518.0,NO003L1,Trondheim,2008,167159,506097,673256,24.828445643261997
519.0,NO004L1,Stavanger,2008,19110,269967,289077,6.610695420251352
520.0,NO005L1,Kristiansand,2008,5953,309509,315462,1.8870735619504093
521.0,NO006L1,TromsÃ¸,2008,374613,0,374613,100.0
522.0,PL001L2,Warszawa,2008,2177,859066,861243,0.25277418800501134
523.0,PL002L2,ÅÃ³dÅº,2008,0,169500,169500,0.0
524.0,PL003L2,KrakÃ³w,2008,942,374806,375748,0.25069993719194783
525.0,PL004L2,WrocÅaw,2008,1351,263349,264700,0.5103891197582169
526.0,PL005L2,PoznaÅ,2008,1588,307740,309328,0.5133709201882791
527.0,PL006L2,GdaÅsk,2008,10937,252579,263516,4.150412119188209
528.0,PL007L2,Szczecin,2008,3228,109832,113060,2.8551211745975587
529.0,PL008L2,Bydgoszcz,2008,1507,208629,210136,0.717154604636997
530.0,PL009L2,Lublin,2008,266,322518,322784,0.08240804996530188
531.0,PL010L2,Katowice,2008,1143,393452,394595,0.2896640859615555
532.0,PL011L2,BiaÅystok,2008,15,223307,223322,0.006716758760892344
533.0,PL012L2,Kielce,2008,138,224091,224229,0.061544224877246034
534.0,PL013L2,ToruÅ,2008,700,158233,158933,0.4404371653464038
535.0,PL014L2,Olsztyn,2008,2720,199824,202544,1.3429180819969981
536.0,PL015L2,RzeszÃ³w,2008,102,229247,229349,0.04447370601136259
537.0,PL016L2,Opole,2008,21,176595,176616,0.011890202473162114
538.0,PL017L2,GorzÃ³w Wielkopolski,2008,215,97205,97420,0.22069390268938616
539.0,PL018L2,Zielona GÃ³ra,2008,393,168891,169284,0.23215424966328774
540.0,PL019L2,Jelenia GÃ³ra,2008,8855,74486,83341,10.62502249793019
541.0,PL020L2,Nowy SÄcz,2008,1063,129355,130418,0.815071539204711
542.0,PL021L2,SuwaÅki,2008,1945,70188,72133,2.696408024066655
543.0,PL022L2,Konin,2008,625,117538,118163,0.5289303758367679
544.0,PL024L2,CzÄstochowa,2008,0,193898,193898,0.0
545.0,PL025L2,Radom,2008,0,68022,68022,0.0
546.0,PL026L2,PÅock,2008,2640,168435,171075,1.5431828145550197
547.0,PL027L2,Kalisz,2008,0,149023,149023,0.0
548.0,PL028L2,Koszalin,2008,566,129105,129671,0.4364892689961518
549.0,PL029L1,SÅupsk,2008,6514,228490,235004,2.771867712889993
550.0,PL030L1,JastrzÄbie-ZdrÃ³j,2008,3,29568,29571,0.010145074566298063
551.0,PL031L1,Siedlce,2008,40,126129,126169,0.03170350878583487
552.0,PL032L1,PiotrkÃ³w Trybunalski,2008,112,116810,116922,0.09579035596380493
553.0,PL033L1,Lubin,2008,497,92809,93306,0.5326559921119757
554.0,PL034L1,PiÅa,2008,149,52043,52192,0.2854843654199878
555.0,PL035L1,InowrocÅaw,2008,2,20126,20128,0.009936406995230525
556.0,PL036L1,Ostrowiec ÅwiÄtokrzyski,2008,6,61454,61460,0.0097624471200781
557.0,PL037L1,Gniezno,2008,462,66109,66571,0.6939958840936744
558.0,PL038L1,Stargard SzczeciÅski,2008,1155,35509,36664,3.1502291075714597
559.0,PL039L1,OstrÃ³w Wielkopolski,2008,130,84631,84761,0.15337242363822984
560.0,PL040L1,PrzemyÅl,2008,242,84847,85089,0.28440809035245446
561.0,PL041L1,ZamoÅÄ,2008,12,112695,112707,0.010647076046740664
562.0,PL042L1,CheÅm,2008,48,46522,46570,0.10307064633884476
563.0,PL043L1,Pabianice,2008,0,32959,32959,0.0
564.0,PL044L1,GÅogÃ³w,2008,224,63857,64081,0.3495575911736708
565.0,PL045L1,Stalowa Wola,2008,66,190247,190313,0.034679711843121595
566.0,PL046L1,TomaszÃ³w Mazowiecki,2008,142,19021,19163,0.7410113239054428
567.0,PL047L1,ÅomÅ¼a,2008,2,56000,56002,0.003571301024963394
568.0,PL048L1,Leszno,2008,614,76958,77572,0.7915227143814778
569.0,PL049L1,Åwidnica,2008,17,47973,47990,0.03542404667639091
570.0,PL051L1,Tczew,2008,13,27111,27124,0.04792803421324288
571.0,PL052L1,EÅk,2008,972,39080,40052,2.426845101368221
572.0,PL506L2,Bielsko-BiaÅa,2008,698,72737,73435,0.9505004425682577
573.0,PL508L1,Rybnik,2008,259,14622,14881,1.7404744304818225
574.0,PL511L2,WaÅbrzych,2008,1723,49787,51510,3.344981556979228
575.0,PL512L2,ElblÄg,2008,29,96446,96475,0.030059600932884165
576.0,PL513L2,WÅocÅawek,2008,2115,120364,122479,1.7268266396688412
577.0,PL514L2,TarnÃ³w,2008,166,125161,125327,0.1324535016397105
578.0,PL516L2,Legnica,2008,277,56223,56500,0.4902654867256637
579.0,PL517L2,GrudziÄdz,2008,264,54779,55043,0.4796250204385662
580.0,PT001L3,Lisboa,2008,7942,431339,439281,1.807954361786647
581.0,PT002L2,Porto,2008,1322,94418,95740,1.3808230624608315
582.0,PT003L1,Braga,2008,46,49303,49349,0.09321364161381183
583.0,PT004L2,Funchal,2008,35962,0,35962,100.0
584.0,PT005L2,Coimbra,2008,460,162327,162787,0.2825778471253847
585.0,PT007L1,Ponta Delgada,2008,55294,0,55294,100.0
586.0,PT008L2,Aveiro,2008,2944,40386,43330,6.794368797599816
587.0,PT009L1,Faro,2008,2532,46618,49150,5.1515768056968465
588.0,PT014L1,Viseu,2008,9,70865,70874,0.012698591867257386
589.0,PT016L0,Viana do Castelo,2008,376,31876,32252,1.165819174004713
590.0,PT019L0,PÃ³voa de Varzim,2008,81,8325,8406,0.9635974304068522
591.0,PT505L1,GuimarÃ£es,2008,0,26541,26541,0.0
592.0,RO001L1,BucureÅti,2008,192,107650,107842,0.17803824113054284
593.0,RO002L1,Cluj-Napoca,2008,26,59276,59302,0.04384337796364372
594.0,RO003L1,TimiÅoara,2008,44,23610,23654,0.18601505030861587
595.0,RO004L1,Craiova,2008,5,34391,34396,0.014536574020234913
596.0,RO005L1,BrÄila,2008,1095,22434,23529,4.653831442050236
597.0,RO006L1,Oradea,2008,49,20290,20339,0.24091646590294508
598.0,RO007L1,BacÄu,2008,185,21908,22093,0.8373693024940025
599.0,RO008L1,Arad,2008,184,51424,51608,0.3565338707177182
600.0,RO009L1,Sibiu,2008,7,56333,56340,0.012424565140220091
601.0,RO010L1,TÃ¢rgu MureÅ,2008,32,13708,13740,0.23289665211062593
602.0,RO011L1,Piatra NeamÅ£,2008,86,14913,14999,0.5733715581038735
603.0,RO012L1,CÇlÇraÅi,2008,591,23953,24544,2.4079204693611476
604.0,RO013L1,Giurgiu,2008,532,10418,10950,4.858447488584475
605.0,RO014L1,Alba Iulia,2008,7,25995,26002,0.026921006076455655
606.0,RO015L1,FocÅani,2008,4,27098,27102,0.014759058372075862
607.0,RO016L1,TÃ¢rgu Jiu,2008,9,24513,24522,0.03670173721556154
608.0,RO017L1,Tulcea,2008,1396,39551,40947,3.409285173516986
609.0,RO018L1,TÃ¢rgoviÅte,2008,8,20249,20257,0.039492521103815965
610.0,RO019L1,Slatina,2008,101,7022,7123,1.4179418784220132
611.0,RO020L1,BÃ¢rlad,2008,10,26309,26319,0.03799536456552301
612.0,RO021L1,Roman,2008,1,14389,14390,0.006949270326615705
613.0,RO022L1,BistriÅ£a,2008,1,42630,42631,0.00234571086767845
614.0,RO501L1,Constanta,2008,4953,54398,59351,8.345267982005359
615.0,RO502L1,Iasi,2008,142,79794,79936,0.17764211369095276
616.0,RO503L1,Galati,2008,883,40349,41232,2.1415405510283274
617.0,RO504L1,Brasov,2008,620,97883,98503,0.6294224541384527
618.0,RO505L1,Ploiesti,2008,2,34335,34337,0.005824620671578763
619.0,RO506L1,Pitesti,2008,14,24870,24884,0.056261051277929595
620.0,RO507L1,Baia Mare,2008,2003,50538,52541,3.8122609010106387
621.0,RO508L1,Buzau,2008,42,38498,38540,0.10897768552153607
622.0,RO509L1,Satu Mare,2008,45,70799,70844,0.06351984642312687
623.0,RO510L1,Botosani,2008,1,37339,37340,0.002678093197643278
624.0,RO511L1,Ramnicu Valcea,2008,124,29049,29173,0.4250505604497309
625.0,RO512L1,Suceava,2008,76,39602,39678,0.19154191239477797
626.0,RO513L1,Drobeta-Turnu Severin,2008,2230,30704,32934,6.771117993562884
627.0,RS001L1,Beograd,2008,6640,306384,313024,2.12124309957064
628.0,RS002L1,Novi Sad,2008,2745,186698,189443,1.4489846550149648
629.0,RS003L1,NiÅ¡,2008,20,341544,341564,0.005855418018292325
630.0,RS004L1,Kragujevac,2008,13,144062,144075,0.009023078257851813
631.0,RS005L1,Subotica,2008,176,160116,160292,0.10979961570134504
632.0,RS006L1,Novi Pazar,2008,5,140786,140791,0.003551363368397127
633.0,RS008L1,Zrenjanin,2008,987,184144,185131,0.5331359955923103
634.0,RS009L1,Kraljevo,2008,3,176509,176512,0.0016996011602610588
635.0,RS011L0,ÄaÄak,2008,2,63685,63687,0.0031403583148837282
636.0,RS012L1,KruÅ¡evac,2008,2,122647,122649,0.0016306696344854015
637.0,RS013L1,Leskovac,2008,1,166281,166282,0.000601388003512106
638.0,RS014L1,Valjevo,2008,6,141656,141662,0.004235433637813951
639.0,RS015L1,Vranje,2008,0,195356,195356,0.0
640.0,RS016L1,Smederevo,2008,2888,157336,160224,1.8024765328540044
641.0,SE001L1,Stockholm,2008,72633,683093,755726,9.611023042743003
642.0,SE002L1,GÃ¶teborg,2008,53341,381918,435259,12.25500219409593
643.0,SE003L1,MalmÃ¶,2008,1833,186183,188016,0.9749170283380139
644.0,SE004L1,JÃ¶nkÃ¶ping,2008,52746,294445,347191,15.192214083890423
645.0,SE005L1,UmeÃ¥,2008,727974,260275,988249,73.6630140784357
646.0,SE006L1,Uppsala,2008,8141,689386,697527,1.1671232798156916
647.0,SE007L1,LinkÃ¶ping,2008,25922,397274,423196,6.125294189926181
648.0,SE008L1,Ãrebro,2008,20823,347774,368597,5.649259218062003
649.0,SE501L1,VÃ¤sterÃ¥s,2008,17881,272534,290415,6.15705111650569
650.0,SE502L1,NorrkÃ¶ping,2008,17993,293745,311738,5.771834040123437
651.0,SE503L1,Helsingborg,2008,752,113670,114422,0.6572162695985038
652.0,SE505L1,BorÃ¥s,2008,85,97277,97362,0.08730305457981553
653.0,SI001L2,Ljubljana,2008,1986,231301,233287,0.851311903363668
654.0,SI002L1,Maribor,2008,768,216217,216985,0.3539415166947024
655.0,SK001L1,Bratislava,2008,463,204478,204941,0.22591867903445384
656.0,SK002L1,KoÅ¡ice,2008,295,177339,177634,0.166071810576804
657.0,SK003L1,BanskÃ¡ Bystrica,2008,14105,66775,80880,17.439416419386745
658.0,SK004L1,Nitra,2008,0,87127,87127,0.0
659.0,SK005L1,PreÅ¡ov,2008,22,93277,93299,0.023580102680628944
660.0,SK006L1,Å½ilina,2008,553,80895,81448,0.6789608093507514
661.0,SK007L1,Trnava,2008,0,74220,74220,0.0
662.0,SK008L1,TrenÄÃ­n,2008,0,67423,67423,0.0
739.0,UK001L3,London,2008,27129,671041,698170,3.8857298365727546
740.0,UK002L3,West Midlands urban area,2008,1612,213697,215309,0.7486914155934029
741.0,UK003L2,Leeds,2008,3966,508461,512427,0.7739639011995856
742.0,UK004L1,Glasgow,2008,60921,276763,337684,18.040831072837328
743.0,UK006L3,Liverpool,2008,13180,87323,100503,13.114036396923476
744.0,UK007L1,Edinburgh,2008,25646,149772,175418,14.619936380531072
745.0,UK008L3,Greater Manchester,2008,10629,301617,312246,3.4040468092465552
746.0,UK009L1,Cardiff,2008,172,84319,84491,0.20357197808050562
747.0,UK010L3,Sheffield,2008,772,125315,126087,0.6122756509394307
748.0,UK011L2,Bristol,2008,421,97964,98385,0.4279107587538751
749.0,UK012L2,Belfast,2008,64049,131096,195145,32.82123549155756
750.0,UK013L2,Newcastle upon Tyne,2008,2277,544431,546708,0.41649289931736866
751.0,UK014L1,Leicester,2008,6082,133699,139781,4.351092065445232
752.0,UK016L1,Aberdeen,2008,40394,613554,653948,6.1769437325291925
753.0,UK017L2,Cambridge,2008,962,158657,159619,0.602685143999148
754.0,UK018L3,Exeter,2008,1316,246410,247726,0.5312320870639335
755.0,UK019L3,Lincoln,2008,3350,208193,211543,1.5836023881669448
756.0,UK023L1,Portsmouth,2008,3223,17630,20853,15.455809715628446
757.0,UK024L1,Worcester,2008,1130,60072,61202,1.8463448906898465
758.0,UK025L3,Coventry,2008,132,81315,81447,0.16206858447824965
759.0,UK026L1,Kingston upon Hull,2008,3649,248049,251698,1.4497532757510985
760.0,UK027L1,Stoke-on-Trent,2008,1110,87066,88176,1.258845944474687
761.0,UK029L1,Nottingham,2008,5741,84548,90289,6.358471131588566
762.0,UK033L1,Guildford,2008,95,61596,61691,0.1539932891345577
763.0,UK050L1,Burnley,2008,21,27953,27974,0.07506970758561521
764.0,UK056L1,Hastings,2008,270,54480,54750,0.4931506849315068
765.0,UK515L1,Brighton and Hove,2008,5657,36750,42407,13.339778810102107
766.0,UK516L1,Plymouth,2008,1268,214507,215775,0.5876491715907775
767.0,UK517L1,Swansea,2008,482,83560,84042,0.5735227624283097
768.0,UK518L1,Derby,2008,206,67896,68102,0.3024874453026343
769.0,UK520L2,Southampton,2008,19388,133964,153352,12.642808701549377
770.0,UK528L1,Northampton,2008,95,154450,154545,0.061470769031673624
771.0,UK539L1,Bournemouth,2008,1811,91982,93793,1.9308477178467478
772.0,UK546L1,Colchester,2008,1242,68253,69495,1.78717893373624
773.0,UK550L0,Dundee City,2008,13484,212932,226416,5.9554095116952865
774.0,UK551L1,Falkirk,2008,1520,28269,29789,5.102554634260969
775.0,UK552L0,Reading,2008,26,21895,21921,0.11860772774964647
776.0,UK553L1,Blackpool,2008,158,48797,48955,0.32274537840874273
777.0,UK557L1,Blackburn with Darwen,2008,372,79182,79554,0.467606908514971
778.0,UK558L1,Newport,2008,97,31603,31700,0.305993690851735
779.0,UK559L2,Middlesbrough,2008,1018,60751,61769,1.6480758956758244
780.0,UK560L1,Oxford,2008,234,192689,192923,0.12129191439071546
781.0,UK562L2,Preston,2008,61,25701,25762,0.236782858473721
782.0,UK566L1,Norwich,2008,4801,145439,150240,3.1955537806176784
783.0,UK568L1,Cheshire West and Chester,2008,5126,131019,136145,3.7651033824231517
784.0,UK569L2,Ipswich,2008,10214,145432,155646,6.562327332536653
785.0,UK571L1,Cheltenham,2008,38,46145,46183,0.08228135894160188
786.0,XK001L1,Pristina,2008,63,255744,255807,0.0246279421595187
787.0,XK002L1,Prizren,2008,8,127625,127633,0.0062679714493900475
788.0,XK003L1,MitrovicÃ«,2008,1,117913,117914,0.0008480757161999422
1.0,AL001L1,Tirana,2009,1606,165515,167121,0.9609803675181456
2.0,AL003L1,Elbasan,2009,657,125347,126004,0.5214120186660741
3.0,AL004L1,ShkodÃ«r,2009,6586,178743,185329,3.5536802119474014
4.0,AL005L0,VlorÃ«,2009,2150,61583,63733,3.3734486059027504
5.0,AT001L3,Wien,2009,10200,908290,918490,1.1105183507713747
6.0,AT002L3,Graz,2009,154,290978,291132,0.052896967698501024
7.0,AT003L3,Linz,2009,408,358822,359230,0.11357626033460456
8.0,AT004L3,Salzburg,2009,400,137076,137476,0.2909598766330123
9.0,AT005L3,Innsbruck,2009,7473,205349,212822,3.5113851011643535
10.0,AT006L2,Klagenfurt,2009,1571,181689,183260,0.8572519917057733
11.0,BA001L1,Sarajevo,2009,1,263773,263774,0.00037911242199761917
12.0,BA002L1,Banja Luka,2009,87,275215,275302,0.03160165926873034
13.0,BA003L1,Mostar,2009,1113,181234,182347,0.6103747251120117
14.0,BA004L1,Tuzla,2009,136,112125,112261,0.12114625738235006
15.0,BA005L1,Zenica,2009,2,86714,86716,0.0023063794455463814
16.0,BE001L2,Bruxelles / Brussel,2009,36,326615,326651,0.011020936718393638
17.0,BE002L2,Antwerpen,2009,4623,114589,119212,3.877965305506157
18.0,BE003L2,Gent,2009,399,101442,101841,0.39178719769051756
19.0,BE004L2,Charleroi,2009,12,109753,109765,0.010932446590443219
20.0,BE005L2,LiÃ¨ge,2009,91,141307,141398,0.06435734593134274
21.0,BE006L2,Brugge,2009,786,55753,56539,1.3901908417198747
22.0,BE007L2,Namur,2009,15,84092,84107,0.01783442519647592
23.0,BE008L1,Leuven,2009,0,45076,45076,0.0
24.0,BE009L1,Mons,2009,8,39192,39200,0.020408163265306124
25.0,BE010L1,Kortrijk,2009,35,22304,22339,0.15667666412999687
26.0,BE011L1,Oostende,2009,172,20760,20932,0.8217083890693675
27.0,BG001L2,Sofia,2009,1145,570629,571774,0.2002539464893472
28.0,BG002L2,Plovdiv,2009,198,276888,277086,0.07145795890084666
29.0,BG003L2,Varna,2009,3621,201177,204798,1.768083672692116
30.0,BG004L2,Burgas,2009,5007,290893,295900,1.692125718148023
31.0,BG005L1,Pleven,2009,1018,178058,179076,0.5684737206549175
32.0,BG006L2,Ruse,2009,2454,131563,134017,1.8311109784579567
33.0,BG007L2,Vidin,2009,1750,59214,60964,2.8705465520635127
34.0,BG008L2,Stara Zagora,2009,0,132068,132068,0.0
35.0,BG009L1,Sliven,2009,8,136766,136774,0.00584906488075219
36.0,BG010L1,Dobrich,2009,5,140333,140338,0.0035628268893670993
37.0,BG011L1,Shumen,2009,48,94459,94507,0.050789888579681926
38.0,BG013L1,Yambol,2009,288,130518,130806,0.22017338654190177
39.0,BG014L1,Haskovo,2009,381,73587,73968,0.5150876054510058
40.0,BG015L1,Pazardzhik,2009,8,63814,63822,0.012534862586568895
41.0,BG016L1,Blagoevgrad,2009,2,135477,135479,0.001476243550660988
42.0,BG017L1,Veliko Tarnovo,2009,0,88539,88539,0.0
43.0,BG018L1,Vratsa,2009,129,70428,70557,0.18283090267443344
44.0,CH001L2,ZÃ¼rich,2009,13,127704,127717,0.010178754590226831
45.0,CH002L2,GenÃ¨ve,2009,270,53627,53897,0.5009555262816112
46.0,CH003L2,Basel,2009,83,69337,69420,0.11956208585422068
47.0,CH004L2,Bern,2009,87,78201,78288,0.11112814224402208
48.0,CH005L2,Lausanne,2009,34,77471,77505,0.043868137539513574
49.0,CH006L1,Winterthur,2009,0,13291,13291,0.0
50.0,CH007L2,St. Gallen,2009,50,31859,31909,0.15669560312137643
51.0,CH008L2,Luzern,2009,0,29259,29259,0.0
52.0,CH009L2,Lugano,2009,24,30601,30625,0.07836734693877552
53.0,CH010L1,Biel/Bienne,2009,2,9093,9095,0.02199010445299615
54.0,CY001L2,Lefkosia,2009,34,162594,162628,0.020906608948028628
55.0,CY501L2,Lemesos,2009,992,124907,125899,0.7879331845368112
56.0,CZ001L2,Praha,2009,133,570429,570562,0.023310350145996403
57.0,CZ002L2,Brno,2009,1359,266556,267915,0.5072504339062762
58.0,CZ003L2,Ostrava,2009,146,142520,142666,0.10233692680806919
59.0,CZ004L2,PlzeÅ,2009,51,195906,195957,0.02602611797486183
60.0,CZ005L2,ÃstÃ­ nad Labem,2009,8,35903,35911,0.022277296650051515
61.0,CZ006L2,Olomouc,2009,7,93557,93564,0.007481509982471891
62.0,CZ007L2,Liberec,2009,0,61316,61316,0.0
63.0,CZ008L2,ÄeskÃ© BudÄjovice,2009,131,129273,129404,0.1012333467280764
64.0,CZ009L2,Hradec KrÃ¡lovÃ©,2009,11,79494,79505,0.013835607823407333
65.0,CZ010L2,Pardubice,2009,75,86282,86357,0.08684877890616859
66.0,CZ011L2,ZlÃ­n,2009,5,57947,57952,0.008627829928216455
67.0,CZ013L2,Karlovy Vary,2009,7,46977,46984,0.014898688915375446
68.0,CZ014L2,Jihlava,2009,4,96023,96027,0.004165495121163839
69.0,CZ016L2,Most,2009,139,27639,27778,0.5003959968320254
70.0,CZ018L2,Chomutov-Jirkov,2009,50,45636,45686,0.10944271768156547
71.0,DE001L1,Berlin,2009,4768,1743497,1748265,0.2727275327253019
72.0,DE002L1,Hamburg,2009,10160,724014,734174,1.383868129353532
73.0,DE003L1,MÃ¼nchen,2009,6439,543502,549941,1.1708528733082277
74.0,DE004L1,KÃ¶ln,2009,1005,161625,162630,0.6179671647297547
75.0,DE005L1,Frankfurt am Main,2009,2271,428060,430331,0.5277333029691098
76.0,DE007L1,Stuttgart,2009,59,365111,365170,0.01615685844948928
77.0,DE008L2,Leipzig,2009,2573,395116,397689,0.646987973014089
78.0,DE009L2,Dresden,2009,1409,581787,583196,0.24159973662370798
79.0,DE011L1,DÃ¼sseldorf,2009,1216,119101,120317,1.0106634972614013
80.0,DE012L1,Bremen,2009,660,588879,589539,0.11195188104603766
81.0,DE013L1,Hannover,2009,2961,294351,297312,0.9959234743299967
82.0,DE014L1,NÃ¼rnberg,2009,39,293462,293501,0.013287859325862605
83.0,DE017L0,Bielefeld,2009,6,25877,25883,0.02318123865085191
84.0,DE018L1,Halle an der Saale,2009,1257,156329,157586,0.7976596905816505
85.0,DE019L2,Magdeburg,2009,167,416867,417034,0.040044696595481426
86.0,DE020L1,Wiesbaden,2009,744,100694,101438,0.7334529466274966
87.0,DE021L1,GÃ¶ttingen,2009,1280,237677,238957,0.5356612277522734
88.0,DE025L1,Darmstadt,2009,75,78112,78187,0.09592387481294844
89.0,DE026L1,Trier,2009,3,121124,121127,0.0024767392901665192
90.0,DE027L1,Freiburg im Breisgau,2009,79,221117,221196,0.03571493155391598
91.0,DE028L1,Regensburg,2009,53,253609,253662,0.02089394548651355
92.0,DE029L0,Frankfurt (Oder),2009,0,14844,14844,0.0
93.0,DE030L1,Weimar,2009,4,89024,89028,0.0044929685042907844
94.0,DE031L1,Schwerin,2009,4859,485144,490003,0.9916265818780702
95.0,DE032L1,Erfurt,2009,137,285375,285512,0.04798397265263807
96.0,DE033L1,Augsburg,2009,6,199928,199934,0.0030009903268078467
97.0,DE034L1,Bonn,2009,747,128590,129337,0.5775609454371139
98.0,DE035L1,Karlsruhe,2009,571,125241,125812,0.45385177884462535
99.0,DE036L0,MÃ¶nchengladbach,2009,1,17022,17023,0.005874405216471833
100.0,DE037L1,Mainz,2009,1016,69289,70305,1.4451319251831307
101.0,DE038L1,Ruhrgebiet,2009,2611,441141,443752,0.5883917142908651
102.0,DE039L1,Kiel,2009,4614,335148,339762,1.358009430130503
103.0,DE040L1,SaarbrÃ¼cken,2009,29,153653,153682,0.01887013443344048
104.0,DE042L1,Koblenz,2009,418,91758,92176,0.45348029855927796
105.0,DE043L2,Rostock,2009,3255,358549,361804,0.8996583785696124
106.0,DE044L1,Kaiserslautern,2009,1,135526,135527,0.0007378603525496764
107.0,DE045L1,Iserlohn,2009,83,106024,106107,0.07822292591440715
108.0,DE048L1,Wilhelmshaven,2009,601,73446,74047,0.8116466568530798
109.0,DE050L1,TÃ¼bingen,2009,0,52025,52025,0.0
110.0,DE051L1,Villingen-Schwenningen,2009,12,102548,102560,0.01170046801872075
111.0,DE052L1,Flensburg,2009,953,204522,205475,0.46380338240661884
112.0,DE053L1,Marburg,2009,49,126193,126242,0.038814340710698496
113.0,DE054L1,Konstanz,2009,64,81836,81900,0.07814407814407814
114.0,DE055L0,NeumÃ¼nster,2009,4,7172,7176,0.055741360089186176
115.0,DE056L0,Brandenburg an der Havel,2009,313,22517,22830,1.3710030661410424
116.0,DE057L1,GieÃen,2009,4,85524,85528,0.004676830979328407
117.0,DE058L1,LÃ¼neburg,2009,159,132343,132502,0.11999818870658556
118.0,DE059L1,Bayreuth,2009,0,199920,199920,0.0
119.0,DE060L1,Celle,2009,1695,153352,155047,1.093216895522003
120.0,DE061L1,Aschaffenburg,2009,239,147377,147616,0.16190656839367007
121.0,DE062L1,Bamberg,2009,19,122136,122155,0.015554009250542343
122.0,DE063L1,Plauen,2009,67,141221,141288,0.0474208708453655
123.0,DE064L1,Neubrandenburg,2009,18652,565339,583991,3.1938848372663275
124.0,DE065L1,Fulda,2009,1,138224,138225,0.0007234581298607343
125.0,DE066L1,Kempten (AllgÃ¤u),2009,18,159149,159167,0.011308876840048504
126.0,DE067L1,Landshut,2009,168,141285,141453,0.11876736442493266
127.0,DE069L1,Rosenheim,2009,66,147697,147763,0.044666120747413086
128.0,DE071L1,Stralsund,2009,18280,319968,338248,5.404318724722688
129.0,DE072L1,Friedrichshafen,2009,25,66594,66619,0.037526831684654524
130.0,DE073L1,Offenburg,2009,60,185824,185884,0.03227819500333541
131.0,DE074L1,GÃ¶rlitz,2009,1317,209790,211107,0.6238542540038938
132.0,DE077L1,Schweinfurt,2009,27,201313,201340,0.01341015198172246
133.0,DE078L1,Greifswald,2009,2890,346904,349794,0.8262005637603848
134.0,DE079L1,Wetzlar,2009,11,106479,106490,0.01032960841393558
135.0,DE081L1,Passau,2009,132,159934,160066,0.08246598278210238
136.0,DE082L0,Dessau-RoÃlau,2009,3,24645,24648,0.012171372930866602
137.0,DE083L1,Braunschweig-Salzgitter-Wolfsburg,2009,161,412683,412844,0.03899778124424722
138.0,DE084L1,Mannheim-Ludwigshafen,2009,1549,202879,204428,0.7577239908427417
139.0,DE504L1,MÃ¼nster,2009,20,141743,141763,0.014108053582387507
140.0,DE505L0,Chemnitz,2009,1,22192,22193,0.004505925291758662
141.0,DE507L1,Aachen,2009,91,70429,70520,0.1290414066931367
142.0,DE508L0,Krefeld,2009,110,13570,13680,0.804093567251462
143.0,DE510L1,LÃ¼beck,2009,2943,159206,162149,1.8149973172822527
144.0,DE513L1,Kassel,2009,939,138922,139861,0.6713808710076433
145.0,DE516L0,Solingen,2009,0,8954,8954,0.0
146.0,DE517L1,OsnabrÃ¼ck,2009,10,224120,224130,0.004461696336947308
147.0,DE520L1,Oldenburg (Oldenburg),2009,49,189920,189969,0.025793682127083894
148.0,DE522L1,Heidelberg,2009,1433,115672,117105,1.2236881431194229
149.0,DE523L1,Paderborn,2009,70,124613,124683,0.05614237706824507
150.0,DE524L2,WÃ¼rzburg,2009,61,305868,305929,0.019939266954097194
151.0,DE527L1,Bremerhaven,2009,755,213724,214479,0.35201581506814184
152.0,DE529L1,Heilbronn,2009,11,119973,119984,0.009167889051873584
153.0,DE530L0,Remscheid,2009,0,7369,7369,0.0
154.0,DE532L1,Ulm,2009,45,199263,199308,0.02257812029622494
155.0,DE533L1,Pforzheim,2009,0,67148,67148,0.0
156.0,DE534L1,Ingolstadt,2009,83,284752,284835,0.029139677357066372
157.0,DE535L1,Gera,2009,0,99786,99786,0.0
158.0,DE537L1,Reutlingen,2009,0,109282,109282,0.0
159.0,DE539L1,Cottbus,2009,474,181806,182280,0.26003949967083606
160.0,DE540L2,Siegen,2009,14,177550,177564,0.007884481088508932
161.0,DE542L1,Hildesheim,2009,11,120799,120810,0.009105206522638855
162.0,DE544L1,Zwickau,2009,21,94783,94804,0.022150964094342012
163.0,DE546L0,Wuppertal,2009,2,16831,16833,0.011881423394522663
164.0,DE547L2,Jena,2009,0,93068,93068,0.0
165.0,DE548L1,DÃ¼ren,2009,62,93976,94038,0.06593079393436696
166.0,DE549L1,Bocholt,2009,37,142228,142265,0.02600780234070221
167.0,DK001L2,KÃ¸benhavn,2009,10573,280650,291223,3.630551158390649
168.0,DK002L3,Ãrhus,2009,5347,457177,462524,1.1560481185841167
169.0,DK003L2,Odense,2009,6837,353002,359839,1.9000163962216436
170.0,DK004L3,Aalborg,2009,3425,617034,620459,0.5520106888609884
171.0,EE001L1,Tallinn,2009,5523,433538,439061,1.2579117708017793
172.0,EE002L1,Tartu,2009,836,298806,299642,0.2789996061967281
173.0,EE003L0,Narva,2009,308,6581,6889,4.470895630715634
174.0,EL001L1,Athina,2009,5161,304226,309387,1.6681373166939788
175.0,EL002L1,Thessaloniki,2009,1528,140591,142119,1.0751553275775934
176.0,EL003L1,Patra,2009,668,50922,51590,1.294824578406668
177.0,EL004L1,Irakleio,2009,1080,60304,61384,1.759416134497589
178.0,EL005L1,Larisa,2009,167,155352,155519,0.10738237771590609
179.0,EL006L1,Volos,2009,272,30544,30816,0.8826583592938734
180.0,EL007L1,Ioannina,2009,1982,130659,132641,1.49425893954358
181.0,EL008L1,Kavala,2009,321,35247,35568,0.9024966261808367
182.0,EL009L1,Kalamata,2009,269,44183,44452,0.6051471249887519
183.0,ES001L3,Madrid,2009,2367,785236,787603,0.30053212087815817
184.0,ES002L2,Barcelona,2009,1240,263367,264607,0.46861949986205964
185.0,ES003L3,Valencia,2009,3138,171982,175120,1.791914116034719
186.0,ES004L3,Sevilla,2009,4164,464262,468426,0.8889344314790384
187.0,ES005L2,Zaragoza,2009,155,275983,276138,0.0561313546125488
188.0,ES006L2,MÃ¡laga,2009,915,151827,152742,0.5990493773814668
189.0,ES007L2,Murcia,2009,90,120046,120136,0.07491509622427915
190.0,ES008L2,Las Palmas,2009,1158,75438,76596,1.5118282939056868
191.0,ES009L2,Valladolid,2009,181,115348,115529,0.15667061949813468
192.0,ES010L2,Palma de Mallorca,2009,2272,201962,204234,1.1124494452441807
193.0,ES011L2,Santiago de Compostela,2009,4,126252,126256,0.0031681662653656067
194.0,ES012L2,Vitoria/Gasteiz,2009,1111,158210,159321,0.6973343124886235
195.0,ES013L2,Oviedo,2009,0,93487,93487,0.0
196.0,ES014L3,Pamplona/IruÃ±a,2009,85,169429,169514,0.05014335099165851
197.0,ES015L2,Santander,2009,410,69073,69483,0.5900723918080681
198.0,ES016L2,Toledo,2009,464,92934,93398,0.49679864665196255
199.0,ES017L2,Badajoz,2009,805,217944,218749,0.36800168229340474
200.0,ES018L2,LogroÃ±o,2009,61,46077,46138,0.13221205947375267
201.0,ES019L3,Bilbao,2009,1050,152271,153321,0.6848376934666484
202.0,ES020L2,CÃ³rdoba,2009,1192,185710,186902,0.6377673861167885
203.0,ES021L2,Alicante/Alacant,2009,414,35644,36058,1.1481502024516057
204.0,ES022L2,Vigo,2009,1108,135363,136471,0.8118941020436578
205.0,ES023L2,GijÃ³n,2009,569,52833,53402,1.0655031646754802
206.0,ES025L3,Santa Cruz de Tenerife,2009,66983,0,66983,100.0
207.0,ES026L2,CoruÃ±a (A),2009,612,75363,75975,0.8055281342546892
208.0,ES028L1,Reus,2009,0,11534,11534,0.0
209.0,ES031L1,Lugo,2009,3,134008,134011,0.002238622202655006
210.0,ES033L1,Girona,2009,2,39619,39621,0.005047828171929028
211.0,ES034L1,CÃ¡ceres,2009,1945,236328,238273,0.816290557469793
212.0,ES035L1,Torrevieja,2009,1702,7136,8838,19.25775062231274
213.0,ES039L1,AvilÃ©s,2009,299,18843,19142,1.5620102392644446
214.0,ES040L1,Talavera de la Reina,2009,551,82715,83266,0.6617346816227512
215.0,ES041L1,Palencia,2009,6,28375,28381,0.02114090412599979
216.0,ES043L1,Ferrol,2009,718,46252,46970,1.5286352991271024
217.0,ES044L1,Pontevedra,2009,215,51401,51616,0.416537507749535
218.0,ES046L1,Gandia,2009,237,17100,17337,1.3670185153140681
219.0,ES048L1,Guadalajara,2009,4,45379,45383,0.008813873036158914
220.0,ES050L1,Manresa,2009,3,29600,29603,0.010134108029591596
221.0,ES053L1,Ciudad Real,2009,577,95768,96345,0.5988894078571799
222.0,ES054L1,Benidorm,2009,328,20345,20673,1.5866105548299714
223.0,ES057L1,Ponferrada,2009,285,62058,62343,0.45714835667195997
224.0,ES059L1,Zamora,2009,336,33844,34180,0.9830310122878877
225.0,ES070L1,Irun,2009,95,7147,7242,1.311792322562828
226.0,ES072L1,Arrecife,2009,4936,53998,58934,8.37547086571419
227.0,ES501L3,Granada,2009,366,162258,162624,0.22505903187721368
228.0,ES505L1,Elche/Elx,2009,621,38197,38818,1.5997733010459063
229.0,ES506L1,Cartagena,2009,1522,59426,60948,2.4972107370217236
230.0,ES508L1,Jerez de la Frontera,2009,175,125931,126106,0.13877214406927504
231.0,ES510L1,Donostia-San SebastiÃ¡n,2009,291,33029,33320,0.8733493397358942
232.0,ES514L1,AlmerÃ­a,2009,742,39988,40730,1.8217530076110975
233.0,ES515L1,Burgos,2009,3,149388,149391,0.0020081531015924657
234.0,ES516L1,Salamanca,2009,17,45627,45644,0.03724476382437999
235.0,ES519L1,Albacete,2009,25,245300,245325,0.010190563538163661
236.0,ES520L1,CastellÃ³n/CastellÃ³,2009,356,32438,32794,1.0855644325181435
237.0,ES521L1,Huelva,2009,3892,93528,97420,3.995072880312051
238.0,ES522L1,CÃ¡diz,2009,987,23846,24833,3.9745499939596503
239.0,ES523L1,LeÃ³n,2009,1,118886,118887,0.0008411348591519679
240.0,ES525L1,Tarragona,2009,485,21255,21740,2.230910763569457
241.0,ES527L1,JaÃ©n,2009,31,99900,99931,0.03102140476929081
242.0,ES528L1,Lleida,2009,114,70561,70675,0.1613017332861691
243.0,ES529L1,Ourense,2009,223,64945,65168,0.34219248711023814
244.0,ES532L1,Algeciras,2009,375,41919,42294,0.886650588735991
245.0,ES533L1,Marbella,2009,573,68632,69205,0.8279748573079979
246.0,ES537L1,Alcoy,2009,0,20529,20529,0.0
247.0,ES538L1,Ãvila,2009,473,53173,53646,0.8817059985833055
248.0,ES542L1,Cuenca,2009,63,164519,164582,0.03827879111932046
249.0,ES543L1,Eivissa,2009,2089,57313,59402,3.516716608868388
250.0,ES544L1,Linares,2009,13,25763,25776,0.05043451272501552
251.0,ES545L1,Lorca,2009,127,182080,182207,0.06970094453012234
252.0,ES546L1,MÃ©rida,2009,877,127422,128299,0.6835594977357579
253.0,ES547L1,Sagunto,2009,207,15321,15528,1.3330757341576507
254.0,ES550L1,Puerto de la Cruz,2009,27472,0,27472,100.0
255.0,ES552L1,Igualada,2009,0,25426,25426,0.0
256.0,FI001L3,Helsinki,2009,17635,473883,491518,3.5878645339539954
257.0,FI002L3,Tampere,2009,81127,607516,688643,11.780704951622248
258.0,FI003L4,Turku,2009,18155,448289,466444,3.8922142851017485
259.0,FI004L4,Oulu,2009,8072,715749,723821,1.1151928446397659
260.0,FI007L2,Lahti,2009,26132,309271,335403,7.791224288393366
261.0,FI008L2,Kuopio,2009,116009,804397,920406,12.604111663765774
262.0,FI009L2,JyvÃ¤skylÃ¤,2009,58381,418561,476942,12.240691740295466
263.0,FR001L1,Paris,2009,2400,1207552,1209952,0.19835497606516622
264.0,FR003L2,Lyon,2009,786,366445,367231,0.2140342182441025
265.0,FR004L2,Toulouse,2009,997,523675,524672,0.19002348133691144
266.0,FR006L2,Strasbourg,2009,150,203733,203883,0.07357160724533188
267.0,FR007L2,Bordeaux,2009,4719,551035,555754,0.8491166955163616
268.0,FR008L2,Nantes,2009,1138,315481,316619,0.359422523600921
269.0,FR009L2,Lille,2009,65,144388,144453,0.04499733477324804
270.0,FR010L2,Montpellier,2009,7289,216629,223918,3.255209496333479
271.0,FR011L2,Saint-Etienne,2009,203,180852,181055,0.11212062632901605
272.0,FR012L2,Le Havre,2009,1189,75249,76438,1.5555090400062797
273.0,FR013L2,Rennes,2009,43,382094,382137,0.0112525089169591
274.0,FR014L2,Amiens,2009,15,244780,244795,0.006127576135133478
275.0,FR016L2,Nancy,2009,103,283406,283509,0.03633041631835321
276.0,FR017L2,Metz,2009,18,176912,176930,0.010173514949415022
277.0,FR018L2,Reims,2009,5,243146,243151,0.0020563353636217823
278.0,FR019L2,OrlÃ©ans,2009,1493,290474,291967,0.511359160453065
279.0,FR020L2,Dijon,2009,77,385684,385761,0.01996054551911676
280.0,FR021L2,Poitiers,2009,27,250415,250442,0.010780939299318804
281.0,FR022L2,Clermont-Ferrand,2009,100,266026,266126,0.037576185716540283
282.0,FR023L2,Caen,2009,669,225604,226273,0.29566055163453
283.0,FR024L2,Limoges,2009,445,317389,317834,0.14001019400064182
284.0,FR025L2,BesanÃ§on,2009,9,239027,239036,0.0037651232450342208
285.0,FR026L2,Grenoble,2009,994,264854,265848,0.3738978664500015
286.0,FR027L2,Ajaccio,2009,1486,145523,147009,1.0108224666517016
289.0,FR032L2,Toulon,2009,2276,104780,107056,2.125990136003587
290.0,FR034L2,Valenciennes,2009,11,78435,78446,0.014022384825230095
291.0,FR035L2,Tours,2009,646,284202,284848,0.22678762006403413
292.0,FR036L2,Angers,2009,278,230973,231251,0.12021569636455627
293.0,FR037L2,Brest,2009,1163,133831,134994,0.8615197712490925
294.0,FR038L2,Le Mans,2009,32,224079,224111,0.014278638710281958
295.0,FR039L1,Avignon,2009,1496,85729,87225,1.715104614502723
296.0,FR040L2,Mulhouse,2009,24,129742,129766,0.01849482915401569
297.0,FR042L2,Dunkerque,2009,723,90402,91125,0.7934156378600824
298.0,FR043L2,Perpignan,2009,1528,181502,183030,0.8348358192646014
299.0,FR044L2,NÃ®mes,2009,1365,149126,150491,0.9070309852416424
300.0,FR045L2,Pau,2009,82,201677,201759,0.040642548783449556
301.0,FR046L2,Bayonne,2009,880,101750,102630,0.857449088960343
302.0,FR047L0,Annemasse,2009,2,7798,7800,0.02564102564102564
303.0,FR048L2,Annecy,2009,1554,117489,119043,1.3054106499332174
304.0,FR049L2,Lorient,2009,554,112628,113182,0.4894771253379513
305.0,FR050L2,MontbÃ©liard,2009,30,123027,123057,0.0243789463419391
306.0,FR051L2,Troyes,2009,164,260786,260950,0.06284728875263461
307.0,FR052L2,Saint-Nazaire,2009,462,106673,107135,0.43123162365240114
308.0,FR053L2,La Rochelle,2009,274,111066,111340,0.24609304832045983
309.0,FR056L2,AngoulÃªme,2009,4,214288,214292,0.001866611912717227
310.0,FR057L2,Boulogne-sur-Mer,2009,137,68401,68538,0.19988911260906359
311.0,FR058L2,ChambÃ©ry,2009,3222,98467,101689,3.168484300170127
312.0,FR059L2,Chalon-sur-SaÃ´ne,2009,104,156254,156358,0.06651402550557055
313.0,FR060L2,Chartres,2009,134,161226,161360,0.08304412493802678
314.0,FR061L2,Niort,2009,2,178917,178919,0.001117824266847009
315.0,FR062L2,Calais,2009,94,50136,50230,0.18713915986462273
316.0,FR063L2,BÃ©ziers,2009,434,84709,85143,0.5097306883713283
317.0,FR064L2,Arras,2009,13,107550,107563,0.012085940332642264
318.0,FR065L2,Bourges,2009,230,250089,250319,0.09188275760130074
319.0,FR066L2,Saint-Brieuc,2009,365,114816,115181,0.31689254304095293
320.0,FR067L2,Quimper,2009,878,121044,121922,0.7201325437574844
321.0,FR068L2,Vannes,2009,3962,117072,121034,3.273460349984302
322.0,FR069L2,Cherbourg,2009,542,90176,90718,0.5974558522013271
323.0,FR073L2,Tarbes,2009,79,104250,104329,0.0757219948432363
324.0,FR074L2,CompiÃ¨gne,2009,87,98650,98737,0.08811286549115327
325.0,FR076L2,Belfort,2009,22,65597,65619,0.03352687483808043
326.0,FR077L2,Roanne,2009,81,123119,123200,0.06574675324675325
327.0,FR079L2,Saint-Quentin,2009,0,99374,99374,0.0
328.0,FR082L2,Beauvais,2009,2,131140,131142,0.0015250644339723353
329.0,FR084L2,Creil,2009,65,29578,29643,0.21927605168167866
330.0,FR086L2,Evreux,2009,29355,97215,126570,23.19269969187011
331.0,FR090L2,ChÃ¢teauroux,2009,714,260463,261177,0.27337782423414003
332.0,FR093L2,Brive-la-Gaillarde,2009,0,132582,132582,0.0
333.0,FR096L2,Albi,2009,244,133994,134238,0.1817667128532904
334.0,FR099L2,FrÃ©jus,2009,434,43979,44413,0.9771913628892441
335.0,FR104L2,ChÃ¢lons-en-Champagne,2009,24,152785,152809,0.01570588119809697
336.0,FR203L2,Marseille,2009,2912,422864,425776,0.6839276990718124
337.0,FR205L2,Nice,2009,1101,306239,307340,0.35823517928027593
338.0,FR207L2,Lens - LiÃ©vin,2009,2,25306,25308,0.00790263948158685
339.0,FR208L1,HÃ©nin - Carvin,2009,16,11582,11598,0.13795481979651664
340.0,FR209L2,Douai,2009,113,44971,45084,0.25064324372282853
341.0,FR214L1,Valence,2009,738,90223,90961,0.8113367267290377
342.0,FR215L2,Rouen,2009,20754,266372,287126,7.228185535270231
343.0,FR304L1,Melun,2009,5,44831,44836,0.011151753055580338
344.0,FR324L1,Martigues,2009,1754,18702,20456,8.574501368791552
345.0,FR505L1,Charleville-MÃ©ziÃ¨res,2009,3,135366,135369,0.002216164705360902
346.0,FR506L1,Colmar,2009,53,101932,101985,0.051968426729420994
347.0,FR519L1,Cannes,2009,507,19629,20136,2.517878426698451
348.0,HR001L2,Grad Zagreb,2009,55,505813,505868,0.010872401496042445
349.0,HR002L2,Rijeka,2009,339,106895,107234,0.3161310778297928
350.0,HR003L2,Slavonski Brod,2009,87,97743,97830,0.08892977614228764
351.0,HR004L2,Osijek,2009,1304,171630,172934,0.7540448957405715
352.0,HR005L2,Split,2009,2868,336202,339070,0.8458430412599168
353.0,HR006L1,Pula - Pola,2009,1276,57621,58897,2.1664940489328828
354.0,HR007L1,Zadar,2009,2460,154040,156500,1.571884984025559
355.0,HU001L2,Budapest,2009,5955,633179,639134,0.9317294964749177
356.0,HU002L2,Miskolc,2009,3,164666,164669,0.001821836532680711
357.0,HU003L2,NyÃ­regyhÃ¡za,2009,18,168207,168225,0.01069995541685243
358.0,HU004L2,PÃ©cs,2009,34,185454,185488,0.018330026740274303
359.0,HU005L2,Debrecen,2009,331,201247,201578,0.16420442707041444
360.0,HU006L2,Szeged,2009,621,160312,160933,0.38587486718075226
361.0,HU007L2,GyÃµr,2009,289,204351,204640,0.14122361219702892
362.0,HU008L2,KecskemÃ©t,2009,66,182073,182139,0.036236061469537
363.0,HU009L2,SzÃ©kesfehÃ©rvÃ¡r,2009,920,300203,301123,0.305522992265619
364.0,HU010L1,Szombathely,2009,19,134258,134277,0.014149854405445462
365.0,HU011L1,Szolnok,2009,628,143347,143975,0.436186837992707
366.0,HU012L1,TatabÃ¡nya,2009,18,69812,69830,0.025776886724903334
367.0,HU013L1,VeszprÃ©m,2009,7146,124174,131320,5.4416692049954305
368.0,HU014L1,BÃ©kÃ©scsaba,2009,55,106108,106163,0.051807126776748966
369.0,HU015L1,KaposvÃ¡r,2009,0,145560,145560,0.0
370.0,HU016L1,Eger,2009,3,100575,100578,0.0029827596492274654
371.0,HU017L1,DunaÃºjvÃ¡ros,2009,719,60951,61670,1.1658829252472838
372.0,HU018L1,Zalaegerszeg,2009,3,139976,139979,0.0021431786196500903
373.0,HU019L1,Sopron,2009,936,79734,80670,1.1602826329490517
374.0,IE001L1,Dublin,2009,7099,696503,703602,1.0089510831407529
375.0,IE002L1,Cork,2009,22500,307163,329663,6.825151745873817
376.0,IE003L1,Limerick,2009,1687,154771,156458,1.0782446407342545
377.0,IE004L1,Galway,2009,7627,218656,226283,3.3705581064419334
378.0,IE005L1,Waterford,2009,1121,94736,95857,1.1694503270496677
379.0,IS001L1,ReykjavÃ­k,2009,1046719,250511,1297230,80.68877531355272
380.0,IT001L3,Roma,2009,8903,608313,617216,1.4424447843218582
381.0,IT002L3,Milano,2009,21,384024,384045,0.0054681092059524275
382.0,IT003L3,Napoli,2009,3025,149917,152942,1.977873965294033
383.0,IT004L2,Torino,2009,206,169973,170179,0.12104901309797332
384.0,IT005L3,Palermo,2009,1744,148329,150073,1.1621011107927475
385.0,IT006L3,Genova,2009,708,120056,120764,0.5862674306912656
386.0,IT007L3,Firenze,2009,84,163687,163771,0.05129113212962001
387.0,IT008L3,Bari,2009,702,112727,113429,0.6188893492845745
388.0,IT009L1,Bologna,2009,71,185186,185257,0.03832513751167298
389.0,IT010L2,Catania,2009,537,60888,61425,0.8742368742368744
390.0,IT011L2,Venezia,2009,1783,65254,67037,2.6597252263675286
391.0,IT012L3,Verona,2009,55,73106,73161,0.07517666516313336
392.0,IT013L3,Cremona,2009,159,60238,60397,0.2632581088464659
393.0,IT014L3,Trento,2009,608,97579,98187,0.6192265778565391
394.0,IT015L1,Trieste,2009,327,21310,21637,1.5113000878125433
395.0,IT016L3,Perugia,2009,5424,125604,131028,4.139573220990933
396.0,IT017L3,Ancona,2009,471,43772,44243,1.0645751870352371
397.0,IT019L2,Pescara,2009,226,16217,16443,1.3744450526059722
398.0,IT020L3,Campobasso,2009,488,102347,102835,0.47454660378275876
399.0,IT021L2,Caserta,2009,1,9341,9342,0.010704345964461572
400.0,IT022L2,Taranto,2009,3468,103460,106928,3.2433039054316923
401.0,IT023L2,Potenza,2009,99,138356,138455,0.07150337654833701
402.0,IT024L3,Catanzaro,2009,293,89790,90083,0.32525559761553235
403.0,IT025L3,Reggio di Calabria,2009,618,47630,48248,1.280882109102968
404.0,IT026L3,Sassari,2009,2237,150988,153225,1.4599445260238213
405.0,IT027L2,Cagliari,2009,4852,190440,195292,2.4844847715216187
406.0,IT028L3,Padova,2009,6,61439,61445,0.009764830336072911
407.0,IT029L3,Brescia,2009,73,60196,60269,0.12112362906303406
408.0,IT030L3,Modena,2009,125,69143,69268,0.1804585089796154
409.0,IT031L3,Foggia,2009,4,89707,89711,0.004458762024723836
410.0,IT032L3,Salerno,2009,349,37490,37839,0.9223288141864214
411.0,IT033L2,Piacenza,2009,284,93843,94127,0.301720016573353
412.0,IT034L1,Bolzano,2009,609,106147,106756,0.570459739967777
413.0,IT035L2,Udine,2009,1,71829,71830,0.0013921759710427398
414.0,IT036L2,La Spezia,2009,644,42275,42919,1.5005009436380157
415.0,IT037L1,Lecce,2009,337,61173,61510,0.5478783937571127
416.0,IT038L1,Barletta,2009,227,14870,15097,1.5036099887394845
417.0,IT039L2,Pesaro,2009,159,25532,25691,0.6188937760305165
418.0,IT040L2,Como,2009,109,19632,19741,0.5521503469935667
419.0,IT041L2,Pisa,2009,488,47565,48053,1.0155453353588746
420.0,IT042L1,Treviso,2009,31,24014,24045,0.1289249324183822
421.0,IT043L2,Varese,2009,464,23200,23664,1.9607843137254901
422.0,IT045L2,Asti,2009,1,54835,54836,0.0018236195200233424
423.0,IT046L2,Pavia,2009,155,36049,36204,0.4281294884543144
424.0,IT047L1,Massa,2009,205,11038,11243,1.8233567553144179
425.0,IT048L2,Cosenza,2009,190,92289,92479,0.20545204857318958
426.0,IT052L1,Savona,2009,206,28499,28705,0.7176450095802125
427.0,IT054L1,Matera,2009,717,77072,77789,0.9217241512296084
428.0,IT056L1,Acireale,2009,52,5936,5988,0.8684034736138945
429.0,IT057L2,Avellino,2009,3,39756,39759,0.007545461404964914
430.0,IT058L2,Pordenone,2009,32,37018,37050,0.08636977058029689
431.0,IT060L1,Lecco,2009,1202,29010,30212,3.978551568913015
432.0,IT061L0,Altamura,2009,0,42800,42800,0.0
433.0,IT064L1,Battipaglia,2009,54,6432,6486,0.8325624421831638
434.0,IT065L0,Bisceglie,2009,79,6865,6944,1.1376728110599077
435.0,IT066L1,Carpi,2009,5,20617,20622,0.024245950926195328
436.0,IT067L0,Cerignola,2009,182,58715,58897,0.3090140414622137
437.0,IT068L1,Gallarate,2009,0,5319,5319,0.0
438.0,IT069L1,Gela,2009,429,57466,57895,0.7409966318334917
439.0,IT073L1,Sassuolo,2009,0,24062,24062,0.0
440.0,IT501L2,Messina,2009,793,33650,34443,2.302354614870946
441.0,IT502L2,Prato,2009,4,40955,40959,0.00976586342440001
442.0,IT503L3,Parma,2009,77,113430,113507,0.06783722589796223
443.0,IT504L3,Livorno,2009,374,25440,25814,1.4488262183311382
444.0,IT505L3,Reggio nell'Emilia,2009,12,69022,69034,0.01738273894023235
445.0,IT506L2,Ravenna,2009,3407,77782,81189,4.196381283178756
446.0,IT507L2,Ferrara,2009,805,90678,91483,0.8799449077970771
447.0,IT508L3,Rimini,2009,324,32255,32579,0.9945056631572486
448.0,IT509L3,Siracusa,2009,550,33592,34142,1.6109191025716125
449.0,IT511L2,Bergamo,2009,0,18556,18556,0.0
450.0,IT512L3,ForlÃ¬,2009,8,72743,72751,0.01099641242044783
451.0,IT513L3,Latina,2009,527,65966,66493,0.7925646308633991
452.0,IT514L2,Vicenza,2009,1,34981,34982,0.0028586130009719286
453.0,IT515L2,Terni,2009,154,102178,102332,0.15049056013759138
454.0,IT516L2,Novara,2009,8,54157,54165,0.014769685221083725
455.0,IT518L1,Alessandria,2009,23,76891,76914,0.029903528616376733
456.0,IT519L1,Arezzo,2009,1,88626,88627,0.0011283243255441344
457.0,IT520L1,Grosseto,2009,408,119191,119599,0.3411399760867566
458.0,IT521L1,Brindisi,2009,775,63212,63987,1.2111835216528357
459.0,IT522L1,Trapani,2009,953,49837,50790,1.8763536129159284
460.0,IT523L1,Ragusa,2009,263,52587,52850,0.4976348155156103
461.0,IT524L0,Andria,2009,0,39880,39880,0.0
462.0,IT525L0,Trani,2009,112,10267,10379,1.0791020329511514
463.0,IT526L1,L'Aquila,2009,531,139738,140269,0.3785583414724565
464.0,LT001L1,Vilnius,2009,1446,423123,424569,0.3405806829985232
465.0,LT002L1,Kaunas,2009,906,161145,162051,0.5590832515689506
466.0,LT003L1,PanevÄÅ¾ys,2009,62,222746,222808,0.027826648953358943
467.0,LT004L0,Alytus,2009,3,3956,3959,0.07577671129072998
468.0,LT501L0,KlaipÄda,2009,64,8859,8923,0.7172475624789868
469.0,LT502L0,Å iauliai,2009,1164,6881,8045,14.468614045991298
470.0,LU001L1,Luxembourg,2009,37,259678,259715,0.014246385460986081
471.0,LV001L1,RÄ«ga,2009,9458,606791,616249,1.5347692247776468
472.0,LV002L2,LiepÄja,2009,3143,268914,272057,1.155272608313699
473.0,LV003L1,Jelgava,2009,130,166329,166459,0.07809730924732215
474.0,LV501L1,Daugavpils,2009,1459,258216,259675,0.5618561663617984
475.0,ME001L1,Podgorica,2009,971,183510,184481,0.5263414660588354
476.0,MK001L1,Skopje,2009,2,224351,224353,0.0008914523095300709
477.0,MK003L1,Bitola,2009,3,119659,119662,0.0025070615567180893
478.0,MK004L1,Tetovo,2009,10,105611,105621,0.009467814165743554
479.0,MK005L1,Prilep,2009,70,86761,86831,0.08061636972970483
480.0,MT001L1,Valletta,2009,1036,24920,25956,3.9913700107874863
481.0,NL001L3,s' Gravenhage,2009,3084,39623,42707,7.22129861615192
482.0,NL002L3,Amsterdam,2009,73123,259834,332957,21.961694753376563
483.0,NL003L3,Rotterdam,2009,27507,189664,217171,12.666055780928392
484.0,NL004L3,Utrecht,2009,580,96707,97287,0.5961742062146022
485.0,NL005L3,Eindhoven,2009,98,144308,144406,0.06786421616830325
486.0,NL006L3,Tilburg,2009,10,43224,43234,0.02312994402553546
487.0,NL007L3,Groningen,2009,2483,205677,208160,1.1928324365872407
488.0,NL008L3,Enschede,2009,78,84878,84956,0.0918122322143227
489.0,NL009L3,Arnhem,2009,641,55257,55898,1.1467315467458585
490.0,NL010L3,Heerlen,2009,15,33328,33343,0.04498695378340281
491.0,NL012L3,Breda,2009,1065,72305,73370,1.4515469537958294
492.0,NL013L3,Nijmegen,2009,704,39132,39836,1.7672457074003414
493.0,NL014L3,Apeldoorn,2009,22,71102,71124,0.03093189359428604
494.0,NL015L3,Leeuwarden,2009,699,110224,110923,0.6301668725151681
495.0,NL016L3,Sittard-Geleen,2009,27,22885,22912,0.11784217877094973
496.0,NL020L3,Roosendaal,2009,3,24571,24574,0.012208024741596811
497.0,NL026L0,Alphen aan den Rijn,2009,62,13148,13210,0.4693414080242241
498.0,NL028L3,Bergen op Zoom,2009,1467,33314,34781,4.217820074178431
499.0,NL030L0,Gouda,2009,8,1780,1788,0.44742729306487694
500.0,NL032L3,MiddelburgÂ Â Â Â Â Â ,2009,929,22459,23388,3.9721224559603217
501.0,NL503L3,s-Hertogenbosch,2009,220,36639,36859,0.5968691500040696
502.0,NL504L3,Amersfoort,2009,16,12228,12244,0.1306762495916367
503.0,NL505L3,Maastricht,2009,9,20376,20385,0.04415011037527594
504.0,NL507L3,Leiden,2009,226,19555,19781,1.1425104898640108
505.0,NL511L3,Zwolle,2009,1051,121969,123020,0.8543326288408389
506.0,NL512L3,Ede,2009,8,35257,35265,0.022685382106904864
507.0,NL513L3,Deventer,2009,22,25223,25245,0.08714596949891067
508.0,NL514L3,Alkmaar,2009,505,47287,47792,1.0566622028791428
509.0,NL515L3,Venlo,2009,421,50815,51236,0.8216878757123897
510.0,NL519L3,Almelo,2009,6,42019,42025,0.014277215942891136
511.0,NL520L3,Lelystad,2009,59011,59831,118842,49.65500412312146
512.0,NL521L3,Oss,2009,3,33143,33146,0.009050865866167863
513.0,NL522L3,Assen,2009,171,70691,70862,0.24131410346871382
514.0,NL524L3,Veenendaal,2009,6,8179,8185,0.07330482590103848
515.0,NL529L3,Soest,2009,18,7924,7942,0.22664316293125158
516.0,NO001L1,Oslo,2009,27911,718732,746643,3.7381988446955243
517.0,NO002L1,Bergen,2009,49657,308086,357743,13.880634980977966
518.0,NO003L1,Trondheim,2009,25828,647428,673256,3.8362821868650263
519.0,NO004L1,Stavanger,2009,30385,258692,289077,10.511040311058991
520.0,NO005L1,Kristiansand,2009,7102,308360,315462,2.2513012660795915
521.0,NO006L1,TromsÃ¸,2009,58525,316088,374613,15.622789385312307
522.0,PL001L2,Warszawa,2009,1650,859593,861243,0.19158356004054605
523.0,PL002L2,ÅÃ³dÅº,2009,28,169472,169500,0.016519174041297935
524.0,PL003L2,KrakÃ³w,2009,415,375333,375748,0.11044636298796001
525.0,PL004L2,WrocÅaw,2009,280,264420,264700,0.10578012844729882
526.0,PL005L2,PoznaÅ,2009,102,309226,309328,0.032974706460456214
527.0,PL006L2,GdaÅsk,2009,789,262727,263516,0.2994125593891832
528.0,PL007L2,Szczecin,2009,2719,110341,113060,2.4049177427914383
529.0,PL008L2,Bydgoszcz,2009,50,210086,210136,0.023794114287889745
530.0,PL009L2,Lublin,2009,109,322675,322784,0.033768712203826705
531.0,PL010L2,Katowice,2009,592,394003,394595,0.15002724312269544
532.0,PL011L2,BiaÅystok,2009,5,223317,223322,0.0022389195869641147
533.0,PL012L2,Kielce,2009,45,224184,224229,0.02006876898171066
534.0,PL013L2,ToruÅ,2009,261,158672,158933,0.16422014307915914
535.0,PL014L2,Olsztyn,2009,2602,199942,202544,1.2846591357927166
536.0,PL015L2,RzeszÃ³w,2009,38,229311,229349,0.016568635572860573
537.0,PL016L2,Opole,2009,6,176610,176616,0.003397200706617747
538.0,PL017L2,GorzÃ³w Wielkopolski,2009,136,97284,97420,0.1396017244918908
539.0,PL018L2,Zielona GÃ³ra,2009,30,169254,169284,0.017721698447579214
540.0,PL019L2,Jelenia GÃ³ra,2009,3,83338,83341,0.003599668830467597
541.0,PL020L2,Nowy SÄcz,2009,228,130190,130418,0.17482249382753914
542.0,PL021L2,SuwaÅki,2009,1159,70974,72133,1.6067541901764797
543.0,PL022L2,Konin,2009,183,117980,118163,0.15487081404500563
544.0,PL024L2,CzÄstochowa,2009,3,193895,193898,0.001547205231616623
545.0,PL025L2,Radom,2009,0,68022,68022,0.0
546.0,PL026L2,PÅock,2009,1258,169817,171075,0.7353499926932632
547.0,PL027L2,Kalisz,2009,22,149001,149023,0.014762821846292185
548.0,PL028L2,Koszalin,2009,130,129541,129671,0.1002537190273847
549.0,PL029L1,SÅupsk,2009,6673,228331,235004,2.8395261357253494
550.0,PL030L1,JastrzÄbie-ZdrÃ³j,2009,5,29566,29571,0.01690845761049677
551.0,PL031L1,Siedlce,2009,53,126116,126169,0.0420071491412312
552.0,PL032L1,PiotrkÃ³w Trybunalski,2009,59,116863,116922,0.050460991088075814
553.0,PL033L1,Lubin,2009,171,93135,93306,0.18326795704456306
554.0,PL034L1,PiÅa,2009,38,52154,52192,0.0728080931943593
555.0,PL035L1,InowrocÅaw,2009,3,20125,20128,0.014904610492845785
556.0,PL036L1,Ostrowiec ÅwiÄtokrzyski,2009,2,61458,61460,0.003254149040026033
557.0,PL037L1,Gniezno,2009,5,66566,66571,0.007510777966381758
558.0,PL038L1,Stargard SzczeciÅski,2009,1179,35485,36664,3.2156884137028148
559.0,PL039L1,OstrÃ³w Wielkopolski,2009,8,84753,84761,0.009438302993121837
560.0,PL040L1,PrzemyÅl,2009,102,84987,85089,0.11987448436343122
561.0,PL041L1,ZamoÅÄ,2009,232,112475,112707,0.20584347023698615
562.0,PL042L1,CheÅm,2009,26,46544,46570,0.0558299334335409
563.0,PL043L1,Pabianice,2009,0,32959,32959,0.0
564.0,PL044L1,GÅogÃ³w,2009,7,64074,64081,0.010923674724177213
565.0,PL045L1,Stalowa Wola,2009,73,190240,190313,0.03835786309921024
566.0,PL046L1,TomaszÃ³w Mazowiecki,2009,238,18925,19163,1.241976725982362
567.0,PL047L1,ÅomÅ¼a,2009,0,56002,56002,0.0
568.0,PL048L1,Leszno,2009,0,77572,77572,0.0
569.0,PL049L1,Åwidnica,2009,0,47990,47990,0.0
570.0,PL051L1,Tczew,2009,25,27099,27124,0.09216929656392862
571.0,PL052L1,EÅk,2009,1984,38068,40052,4.953560371517028
572.0,PL506L2,Bielsko-BiaÅa,2009,281,73154,73435,0.3826513243004017
573.0,PL508L1,Rybnik,2009,32,14849,14881,0.215039311874202
574.0,PL511L2,WaÅbrzych,2009,2,51508,51510,0.0038827412152980007
575.0,PL512L2,ElblÄg,2009,20,96455,96475,0.020730759264058048
576.0,PL513L2,WÅocÅawek,2009,2001,120478,122479,1.633749459090946
577.0,PL514L2,TarnÃ³w,2009,85,125242,125327,0.06782257614081562
578.0,PL516L2,Legnica,2009,3,56497,56500,0.005309734513274336
579.0,PL517L2,GrudziÄdz,2009,55,54988,55043,0.09992187925803463
580.0,PT001L3,Lisboa,2009,7348,431933,439281,1.672733398439723
581.0,PT002L2,Porto,2009,1206,94534,95740,1.2596615834551912
582.0,PT003L1,Braga,2009,54,49295,49349,0.1094247097205617
583.0,PT004L2,Funchal,2009,35962,0,35962,100.0
584.0,PT005L2,Coimbra,2009,444,162343,162787,0.27274905244276265
585.0,PT007L1,Ponta Delgada,2009,55294,0,55294,100.0
586.0,PT008L2,Aveiro,2009,1921,41409,43330,4.433417955227325
587.0,PT009L1,Faro,2009,2519,46631,49150,5.125127161749746
588.0,PT014L1,Viseu,2009,5,70869,70874,0.007054773259587437
589.0,PT016L0,Viana do Castelo,2009,399,31853,32252,1.237132580925214
590.0,PT019L0,PÃ³voa de Varzim,2009,60,8346,8406,0.7137758743754461
591.0,PT505L1,GuimarÃ£es,2009,0,26541,26541,0.0
592.0,RO001L1,BucureÅti,2009,212,107630,107842,0.19658389124830772
593.0,RO002L1,Cluj-Napoca,2009,4,59298,59302,0.006745135071329803
594.0,RO003L1,TimiÅoara,2009,15,23639,23654,0.06341422169611906
595.0,RO004L1,Craiova,2009,47,34349,34396,0.13664379579020816
596.0,RO005L1,BrÄila,2009,1112,22417,23529,4.726082706447363
597.0,RO006L1,Oradea,2009,32,20307,20339,0.15733320222233146
598.0,RO007L1,BacÄu,2009,77,22016,22093,0.34852668265966597
599.0,RO008L1,Arad,2009,37,51571,51608,0.07169431095954115
600.0,RO009L1,Sibiu,2009,4,56336,56340,0.007099751508697196
601.0,RO010L1,TÃ¢rgu MureÅ,2009,17,13723,13740,0.12372634643377002
602.0,RO011L1,Piatra NeamÅ£,2009,75,14924,14999,0.5000333355557037
603.0,RO012L1,CÇlÇraÅi,2009,529,24015,24544,2.1553129074315516
604.0,RO013L1,Giurgiu,2009,536,10414,10950,4.894977168949772
605.0,RO014L1,Alba Iulia,2009,0,26002,26002,0.0
606.0,RO015L1,FocÅani,2009,0,27102,27102,0.0
607.0,RO016L1,TÃ¢rgu Jiu,2009,5,24517,24522,0.0203898540086453
608.0,RO017L1,Tulcea,2009,1414,39533,40947,3.4532444379319607
609.0,RO018L1,TÃ¢rgoviÅte,2009,1,20256,20257,0.004936565137976996
610.0,RO019L1,Slatina,2009,102,7021,7123,1.431980906921241
611.0,RO020L1,BÃ¢rlad,2009,84,26235,26319,0.31916106235039327
612.0,RO021L1,Roman,2009,0,14390,14390,0.0
613.0,RO022L1,BistriÅ£a,2009,0,42631,42631,0.0
614.0,RO501L1,Constanta,2009,5387,53964,59351,9.076510926521879
615.0,RO502L1,Iasi,2009,14,79922,79936,0.017514011208967173
616.0,RO503L1,Galati,2009,930,40302,41232,2.2555296856810245
617.0,RO504L1,Brasov,2009,37,98466,98503,0.037562307746972175
618.0,RO505L1,Ploiesti,2009,0,34337,34337,0.0
619.0,RO506L1,Pitesti,2009,20,24864,24884,0.08037293039704227
620.0,RO507L1,Baia Mare,2009,1,52540,52541,0.0019032755371995206
621.0,RO508L1,Buzau,2009,0,38540,38540,0.0
622.0,RO509L1,Satu Mare,2009,0,70844,70844,0.0
623.0,RO510L1,Botosani,2009,54,37286,37340,0.144617032672737
624.0,RO511L1,Ramnicu Valcea,2009,401,28772,29173,1.3745586672608234
625.0,RO512L1,Suceava,2009,61,39617,39678,0.15373758758001915
626.0,RO513L1,Drobeta-Turnu Severin,2009,1992,30942,32934,6.0484605574785935
627.0,RS001L1,Beograd,2009,6382,306642,313024,2.0388213044367207
628.0,RS002L1,Novi Sad,2009,2062,187381,189443,1.0884540468637005
629.0,RS003L1,NiÅ¡,2009,11,341553,341564,0.0032204799100607794
630.0,RS004L1,Kragujevac,2009,351,143724,144075,0.24362311296199898
631.0,RS005L1,Subotica,2009,47,160245,160292,0.029321488283881918
632.0,RS006L1,Novi Pazar,2009,4,140787,140791,0.0028410906947177023
633.0,RS008L1,Zrenjanin,2009,773,184358,185131,0.41754217283977285
634.0,RS009L1,Kraljevo,2009,3,176509,176512,0.0016996011602610588
635.0,RS011L0,ÄaÄak,2009,0,63687,63687,0.0
636.0,RS012L1,KruÅ¡evac,2009,0,122649,122649,0.0
637.0,RS013L1,Leskovac,2009,0,166282,166282,0.0
638.0,RS014L1,Valjevo,2009,1,141661,141662,0.0007059056063023252
639.0,RS015L1,Vranje,2009,0,195356,195356,0.0
640.0,RS016L1,Smederevo,2009,2644,157580,160224,1.6501897343718794
641.0,SE001L1,Stockholm,2009,70385,685341,755726,9.313560734975376
642.0,SE002L1,GÃ¶teborg,2009,23968,411291,435259,5.506606411355079
643.0,SE003L1,MalmÃ¶,2009,2712,185304,188016,1.4424304314526424
644.0,SE004L1,JÃ¶nkÃ¶ping,2009,51241,295950,347191,14.758735105460682
645.0,SE005L1,UmeÃ¥,2009,24148,964101,988249,2.443513729839342
646.0,SE006L1,Uppsala,2009,13409,684118,697527,1.9223628619393947
647.0,SE007L1,LinkÃ¶ping,2009,14232,408964,423196,3.3629807465098915
648.0,SE008L1,Ãrebro,2009,23354,345243,368597,6.335917004207847
649.0,SE501L1,VÃ¤sterÃ¥s,2009,18667,271748,290415,6.427698293820912
650.0,SE502L1,NorrkÃ¶ping,2009,14293,297445,311738,4.584939917494819
651.0,SE503L1,Helsingborg,2009,843,113579,114422,0.7367464298823653
652.0,SE505L1,BorÃ¥s,2009,3223,94139,97362,3.310326410714653
653.0,SI001L2,Ljubljana,2009,219,233068,233287,0.09387578390566126
654.0,SI002L1,Maribor,2009,727,216258,216985,0.33504620135032376
655.0,SK001L1,Bratislava,2009,1664,203277,204941,0.811940997652983
656.0,SK002L1,KoÅ¡ice,2009,4,177630,177634,0.002251821160363444
657.0,SK003L1,BanskÃ¡ Bystrica,2009,3,80877,80880,0.0037091988130563795
658.0,SK004L1,Nitra,2009,3,87124,87127,0.0034432495093369452
659.0,SK005L1,PreÅ¡ov,2009,11,93288,93299,0.011790051340314472
660.0,SK006L1,Å½ilina,2009,68,81380,81448,0.08348885178273253
661.0,SK007L1,Trnava,2009,28,74192,74220,0.0377256804095931
662.0,SK008L1,TrenÄÃ­n,2009,3,67420,67423,0.0044495201934058115
739.0,UK001L3,London,2009,1872,696298,698170,0.2681295386510449
740.0,UK002L3,West Midlands urban area,2009,298,215011,215309,0.13840573315560428
741.0,UK003L2,Leeds,2009,320,512107,512427,0.06244791941096
742.0,UK004L1,Glasgow,2009,1994,335690,337684,0.5904928868409519
743.0,UK006L3,Liverpool,2009,627,99876,100503,0.6238619742694248
744.0,UK007L1,Edinburgh,2009,974,174444,175418,0.5552451857848111
745.0,UK008L3,Greater Manchester,2009,534,311712,312246,0.17101900424665167
746.0,UK009L1,Cardiff,2009,230,84261,84491,0.27221834278207147
747.0,UK010L3,Sheffield,2009,207,125880,126087,0.1641723571819458
748.0,UK011L2,Bristol,2009,4051,94334,98385,4.117497586014128
749.0,UK012L2,Belfast,2009,21345,173800,195145,10.938020446334777
750.0,UK013L2,Newcastle upon Tyne,2009,15989,530719,546708,2.9245959451846324
751.0,UK014L1,Leicester,2009,83,139698,139781,0.059378599380459425
752.0,UK016L1,Aberdeen,2009,3161,650787,653948,0.483371766562479
753.0,UK017L2,Cambridge,2009,87,159532,159619,0.05450478953006847
754.0,UK018L3,Exeter,2009,2118,245608,247726,0.8549768696059356
755.0,UK019L3,Lincoln,2009,1660,209883,211543,0.7847104371215309
756.0,UK023L1,Portsmouth,2009,342,20511,20853,1.6400517911091932
757.0,UK024L1,Worcester,2009,283,60919,61202,0.46240318943825365
758.0,UK025L3,Coventry,2009,77,81370,81447,0.0945400076123123
759.0,UK026L1,Kingston upon Hull,2009,1400,250298,251698,0.5562221392303475
760.0,UK027L1,Stoke-on-Trent,2009,14,88162,88176,0.015877336236617676
761.0,UK029L1,Nottingham,2009,143,90146,90289,0.15838031210889475
762.0,UK033L1,Guildford,2009,3,61688,61691,0.004862945972670243
763.0,UK050L1,Burnley,2009,4,27970,27974,0.014298991921069565
764.0,UK056L1,Hastings,2009,66,54684,54750,0.12054794520547946
765.0,UK515L1,Brighton and Hove,2009,108,42299,42407,0.2546749357417407
766.0,UK516L1,Plymouth,2009,1409,214366,215775,0.6529950179585217
767.0,UK517L1,Swansea,2009,491,83551,84042,0.584231693676971
768.0,UK518L1,Derby,2009,130,67972,68102,0.19089013538515756
769.0,UK520L2,Southampton,2009,4817,148535,153352,3.141139339558662
770.0,UK528L1,Northampton,2009,2172,152373,154545,1.4054158982820537
771.0,UK539L1,Bournemouth,2009,1363,92430,93793,1.4532001322060282
772.0,UK546L1,Colchester,2009,478,69017,69495,0.6878192675732067
773.0,UK550L0,Dundee City,2009,1537,224879,226416,0.6788389513108615
774.0,UK551L1,Falkirk,2009,69,29720,29789,0.23162912484474135
775.0,UK552L0,Reading,2009,19,21902,21921,0.08667487797089549
776.0,UK553L1,Blackpool,2009,90,48865,48955,0.18384230415687877
777.0,UK557L1,Blackburn with Darwen,2009,273,79281,79554,0.34316313447469643
778.0,UK558L1,Newport,2009,74,31626,31700,0.2334384858044164
779.0,UK559L2,Middlesbrough,2009,1044,60725,61769,1.6901682073532032
780.0,UK560L1,Oxford,2009,5325,187598,192923,2.7601685646605123
781.0,UK562L2,Preston,2009,17,25745,25762,0.06598866547628289
782.0,UK566L1,Norwich,2009,40,150200,150240,0.026624068157614485
783.0,UK568L1,Cheshire West and Chester,2009,339,135806,136145,0.24899922876345074
784.0,UK569L2,Ipswich,2009,1261,154385,155646,0.8101718001105072
785.0,UK571L1,Cheltenham,2009,67,46116,46183,0.14507502760756122
786.0,XK001L1,Pristina,2009,10,255797,255807,0.003909197168177571
787.0,XK002L1,Prizren,2009,3,127630,127633,0.002350489293521268
788.0,XK003L1,MitrovicÃ«,2009,0,117914,117914,0.0
1.0,AL001L1,Tirana,2010,1590,165531,167121,0.9514064659737556
2.0,AL003L1,Elbasan,2010,713,125291,126004,0.5658550522205644
3.0,AL004L1,ShkodÃ«r,2010,5110,180219,185329,2.7572587128835746
4.0,AL005L0,VlorÃ«,2010,2245,61488,63733,3.5225079629077563
5.0,AT001L3,Wien,2010,2774,915716,918490,0.302017441670568
6.0,AT002L3,Graz,2010,266,290866,291132,0.09136748966104723
7.0,AT003L3,Linz,2010,1415,357815,359230,0.393898059738886
8.0,AT004L3,Salzburg,2010,1898,135578,137476,1.3806046146236433
9.0,AT005L3,Innsbruck,2010,24064,188758,212822,11.307101709409743
10.0,AT006L2,Klagenfurt,2010,2274,180986,183260,1.2408599803557787
11.0,BA001L1,Sarajevo,2010,8,263766,263774,0.0030328993759809533
12.0,BA002L1,Banja Luka,2010,0,275302,275302,0.0
13.0,BA003L1,Mostar,2010,2114,180233,182347,1.1593280942379092
14.0,BA004L1,Tuzla,2010,75,112186,112261,0.06680859782114892
15.0,BA005L1,Zenica,2010,0,86716,86716,0.0
16.0,BE001L2,Bruxelles / Brussel,2010,59,326592,326651,0.018062090732922906
17.0,BE002L2,Antwerpen,2010,4388,114824,119212,3.680837499580579
18.0,BE003L2,Gent,2010,495,101346,101841,0.4860517866085368
19.0,BE004L2,Charleroi,2010,134,109631,109765,0.12207898692661596
20.0,BE005L2,LiÃ¨ge,2010,62,141336,141398,0.04384786206311263
21.0,BE006L2,Brugge,2010,852,55687,56539,1.5069244238490245
22.0,BE007L2,Namur,2010,5,84102,84107,0.0059448083988253055
23.0,BE008L1,Leuven,2010,0,45076,45076,0.0
24.0,BE009L1,Mons,2010,5,39195,39200,0.012755102040816327
25.0,BE010L1,Kortrijk,2010,0,22339,22339,0.0
26.0,BE011L1,Oostende,2010,131,20801,20932,0.6258360405121346
27.0,BG001L2,Sofia,2010,2514,569260,571774,0.43968421089451426
28.0,BG002L2,Plovdiv,2010,317,276769,277086,0.11440491399782016
29.0,BG003L2,Varna,2010,3944,200854,204798,1.9258000566411784
30.0,BG004L2,Burgas,2010,5331,290569,295900,1.8016221696519095
31.0,BG005L1,Pleven,2010,1052,178024,179076,0.5874600728182447
32.0,BG006L2,Ruse,2010,2649,131368,134017,1.9766149070640293
33.0,BG007L2,Vidin,2010,1862,59102,60964,3.0542615313955777
34.0,BG008L2,Stara Zagora,2010,8,132060,132068,0.006057485537753279
35.0,BG009L1,Sliven,2010,67,136707,136774,0.048985918376299585
36.0,BG010L1,Dobrich,2010,36,140302,140338,0.025652353603443118
37.0,BG011L1,Shumen,2010,55,94452,94507,0.05819674733088554
38.0,BG013L1,Yambol,2010,398,130408,130806,0.30426738834610034
39.0,BG014L1,Haskovo,2010,451,73517,73968,0.6097231235128705
40.0,BG015L1,Pazardzhik,2010,35,63787,63822,0.05484002381623891
41.0,BG016L1,Blagoevgrad,2010,98,135381,135479,0.07233593398238841
42.0,BG017L1,Veliko Tarnovo,2010,2,88537,88539,0.0022588915619105704
43.0,BG018L1,Vratsa,2010,13,70544,70557,0.018424819649361508
44.0,CH001L2,ZÃ¼rich,2010,82,127635,127717,0.06420445203066154
45.0,CH002L2,GenÃ¨ve,2010,99,53798,53897,0.18368369296992412
46.0,CH003L2,Basel,2010,142,69278,69420,0.20455200230481127
47.0,CH004L2,Bern,2010,2,78286,78288,0.0025546699366441857
48.0,CH005L2,Lausanne,2010,44,77461,77505,0.05677053093348817
49.0,CH006L1,Winterthur,2010,0,13291,13291,0.0
50.0,CH007L2,St. Gallen,2010,18,31891,31909,0.05641041712369551
51.0,CH008L2,Luzern,2010,39,29220,29259,0.13329232031169896
52.0,CH009L2,Lugano,2010,32,30593,30625,0.10448979591836734
53.0,CH010L1,Biel/Bienne,2010,5,9090,9095,0.054975261132490384
54.0,CY001L2,Lefkosia,2010,44,162584,162628,0.02705561157980176
55.0,CY501L2,Lemesos,2010,1158,124741,125899,0.9197849069492212
56.0,CZ001L2,Praha,2010,301,570261,570562,0.05275500296199186
57.0,CZ002L2,Brno,2010,725,267190,267915,0.27060821529216356
58.0,CZ003L2,Ostrava,2010,430,142236,142666,0.30140327758540925
59.0,CZ004L2,PlzeÅ,2010,224,195733,195957,0.11431079267390294
60.0,CZ005L2,ÃstÃ­ nad Labem,2010,42,35869,35911,0.11695580741277047
61.0,CZ006L2,Olomouc,2010,32,93532,93564,0.03420118849130007
62.0,CZ007L2,Liberec,2010,0,61316,61316,0.0
63.0,CZ008L2,ÄeskÃ© BudÄjovice,2010,934,128470,129404,0.7217705789620105
64.0,CZ009L2,Hradec KrÃ¡lovÃ©,2010,50,79455,79505,0.06288912647003334
65.0,CZ010L2,Pardubice,2010,134,86223,86357,0.15516981831235452
66.0,CZ011L2,ZlÃ­n,2010,42,57910,57952,0.07247377139701822
67.0,CZ013L2,Karlovy Vary,2010,54,46930,46984,0.11493274306146772
68.0,CZ014L2,Jihlava,2010,58,95969,96027,0.06039967925687567
69.0,CZ016L2,Most,2010,178,27600,27778,0.6407948736410108
70.0,CZ018L2,Chomutov-Jirkov,2010,171,45515,45686,0.3742940944709539
71.0,DE001L1,Berlin,2010,20106,1728159,1748265,1.1500544825870218
72.0,DE002L1,Hamburg,2010,8397,725777,734174,1.143734319112363
73.0,DE003L1,MÃ¼nchen,2010,10563,539378,549941,1.9207514987971437
74.0,DE004L1,KÃ¶ln,2010,712,161918,162630,0.43780360327122914
75.0,DE005L1,Frankfurt am Main,2010,678,429653,430331,0.15755313932763385
76.0,DE007L1,Stuttgart,2010,94,365076,365170,0.02574143549579648
77.0,DE008L2,Leipzig,2010,4197,393492,397689,1.0553472688457564
78.0,DE009L2,Dresden,2010,4381,578815,583196,0.7512054266490168
79.0,DE011L1,DÃ¼sseldorf,2010,1402,118915,120317,1.1652551177306614
80.0,DE012L1,Bremen,2010,1718,587821,589539,0.29141413884407985
81.0,DE013L1,Hannover,2010,3679,293633,297312,1.2374206221074158
82.0,DE014L1,NÃ¼rnberg,2010,198,293303,293501,0.06746143965437937
83.0,DE017L0,Bielefeld,2010,0,25883,25883,0.0
84.0,DE018L1,Halle an der Saale,2010,915,156671,157586,0.5806353356262612
85.0,DE019L2,Magdeburg,2010,72,416962,417034,0.01726477937050696
86.0,DE020L1,Wiesbaden,2010,975,100463,101438,0.9611782566690983
87.0,DE021L1,GÃ¶ttingen,2010,1441,237516,238957,0.6030373665554891
88.0,DE025L1,Darmstadt,2010,981,77206,78187,1.2546842825533655
89.0,DE026L1,Trier,2010,90,121037,121127,0.07430217870499559
90.0,DE027L1,Freiburg im Breisgau,2010,690,220506,221196,0.3119405414202788
91.0,DE028L1,Regensburg,2010,450,253212,253662,0.17740142394209618
92.0,DE029L0,Frankfurt (Oder),2010,211,14633,14844,1.4214497440043115
93.0,DE030L1,Weimar,2010,0,89028,89028,0.0
94.0,DE031L1,Schwerin,2010,4629,485374,490003,0.9446880937463648
95.0,DE032L1,Erfurt,2010,53,285459,285512,0.018563142705035163
96.0,DE033L1,Augsburg,2010,121,199813,199934,0.0605199715906249
97.0,DE034L1,Bonn,2010,394,128943,129337,0.3046305388249302
98.0,DE035L1,Karlsruhe,2010,636,125176,125812,0.5055161669793025
99.0,DE036L0,MÃ¶nchengladbach,2010,0,17023,17023,0.0
100.0,DE037L1,Mainz,2010,974,69331,70305,1.3853922196145367
101.0,DE038L1,Ruhrgebiet,2010,2760,440992,443752,0.621969027745227
102.0,DE039L1,Kiel,2010,3537,336225,339762,1.0410228336306002
103.0,DE040L1,SaarbrÃ¼cken,2010,6,153676,153682,0.0039041657448497546
104.0,DE042L1,Koblenz,2010,814,91362,92176,0.883093212983857
105.0,DE043L2,Rostock,2010,3213,358591,361804,0.8880498833622624
106.0,DE044L1,Kaiserslautern,2010,14,135513,135527,0.010330044935695469
107.0,DE045L1,Iserlohn,2010,105,106002,106107,0.09895671350617773
108.0,DE048L1,Wilhelmshaven,2010,782,73265,74047,1.0560859994327927
109.0,DE050L1,TÃ¼bingen,2010,0,52025,52025,0.0
110.0,DE051L1,Villingen-Schwenningen,2010,7,102553,102560,0.006825273010920437
111.0,DE052L1,Flensburg,2010,1142,204333,205475,0.5557853753497992
112.0,DE053L1,Marburg,2010,5,126237,126242,0.003960647011295765
113.0,DE054L1,Konstanz,2010,134,81766,81900,0.16361416361416362
114.0,DE055L0,NeumÃ¼nster,2010,69,7107,7176,0.9615384615384616
115.0,DE056L0,Brandenburg an der Havel,2010,1302,21528,22830,5.703022339027595
116.0,DE057L1,GieÃen,2010,4,85524,85528,0.004676830979328407
117.0,DE058L1,LÃ¼neburg,2010,57,132445,132502,0.0430182185929269
118.0,DE059L1,Bayreuth,2010,84,199836,199920,0.04201680672268908
119.0,DE060L1,Celle,2010,1169,153878,155047,0.7539649267641424
120.0,DE061L1,Aschaffenburg,2010,36,147580,147616,0.024387600260134402
121.0,DE062L1,Bamberg,2010,46,122109,122155,0.037657075027628835
122.0,DE063L1,Plauen,2010,1976,139312,141288,1.3985618028424212
123.0,DE064L1,Neubrandenburg,2010,24903,559088,583991,4.264278045380836
124.0,DE065L1,Fulda,2010,2,138223,138225,0.0014469162597214686
125.0,DE066L1,Kempten (AllgÃ¤u),2010,266,158901,159167,0.16712006885849454
126.0,DE067L1,Landshut,2010,42,141411,141453,0.029691841106233165
127.0,DE069L1,Rosenheim,2010,233,147530,147763,0.15768494142647346
128.0,DE071L1,Stralsund,2010,19583,318665,338248,5.789539036446631
129.0,DE072L1,Friedrichshafen,2010,119,66500,66619,0.17862771881895556
130.0,DE073L1,Offenburg,2010,377,185507,185884,0.20281465860429085
131.0,DE074L1,GÃ¶rlitz,2010,1211,209896,211107,0.5736427498851293
132.0,DE077L1,Schweinfurt,2010,29,201311,201340,0.01440349657296116
133.0,DE078L1,Greifswald,2010,4344,345450,349794,1.2418737885727027
134.0,DE079L1,Wetzlar,2010,64,106426,106490,0.06009953986289792
135.0,DE081L1,Passau,2010,383,159683,160066,0.2392762985268577
136.0,DE082L0,Dessau-RoÃlau,2010,8,24640,24648,0.03245699448231094
137.0,DE083L1,Braunschweig-Salzgitter-Wolfsburg,2010,291,412553,412844,0.0704866729321487
138.0,DE084L1,Mannheim-Ludwigshafen,2010,1133,203295,204428,0.5542293619269376
139.0,DE504L1,MÃ¼nster,2010,66,141697,141763,0.04655657682187877
140.0,DE505L0,Chemnitz,2010,0,22193,22193,0.0
141.0,DE507L1,Aachen,2010,27,70493,70520,0.03828701077708451
142.0,DE508L0,Krefeld,2010,70,13610,13680,0.5116959064327485
143.0,DE510L1,LÃ¼beck,2010,2124,160025,162149,1.3099063207296993
144.0,DE513L1,Kassel,2010,21,139840,139861,0.015014907658317901
145.0,DE516L0,Solingen,2010,0,8954,8954,0.0
146.0,DE517L1,OsnabrÃ¼ck,2010,13,224117,224130,0.005800205238031499
147.0,DE520L1,Oldenburg (Oldenburg),2010,217,189752,189969,0.11422916370565724
148.0,DE522L1,Heidelberg,2010,398,116707,117105,0.3398659322829939
149.0,DE523L1,Paderborn,2010,178,124505,124683,0.14276204454496602
150.0,DE524L2,WÃ¼rzburg,2010,34,305895,305929,0.011113689777693517
151.0,DE527L1,Bremerhaven,2010,1127,213352,214479,0.5254593689825111
152.0,DE529L1,Heilbronn,2010,55,119929,119984,0.045839445259367916
153.0,DE530L0,Remscheid,2010,4,7365,7369,0.0542814493146967
154.0,DE532L1,Ulm,2010,144,199164,199308,0.0722499849479198
155.0,DE533L1,Pforzheim,2010,0,67148,67148,0.0
156.0,DE534L1,Ingolstadt,2010,1524,283311,284835,0.5350466059297487
157.0,DE535L1,Gera,2010,21,99765,99786,0.021045036377848596
158.0,DE537L1,Reutlingen,2010,1,109281,109282,0.0009150637799454622
159.0,DE539L1,Cottbus,2010,653,181627,182280,0.35824007022163706
160.0,DE540L2,Siegen,2010,14,177550,177564,0.007884481088508932
161.0,DE542L1,Hildesheim,2010,2797,118013,120810,2.315205694892807
162.0,DE544L1,Zwickau,2010,111,94693,94804,0.11708366735580777
163.0,DE546L0,Wuppertal,2010,7,16826,16833,0.041584981880829326
164.0,DE547L2,Jena,2010,0,93068,93068,0.0
165.0,DE548L1,DÃ¼ren,2010,13,94025,94038,0.013824198728173719
166.0,DE549L1,Bocholt,2010,50,142215,142265,0.035145678838786776
167.0,DK001L2,KÃ¸benhavn,2010,13751,277472,291223,4.721811120687583
168.0,DK002L3,Ãrhus,2010,6508,456016,462524,1.4070621200197178
169.0,DK003L2,Odense,2010,6698,353141,359839,1.8613880096376434
170.0,DK004L3,Aalborg,2010,4068,616391,620459,0.6556436444632119
171.0,EE001L1,Tallinn,2010,5763,433298,439061,1.3125738792559576
172.0,EE002L1,Tartu,2010,721,298921,299642,0.24062047376536
173.0,EE003L0,Narva,2010,290,6599,6889,4.2096095224270575
174.0,EL001L1,Athina,2010,5168,304219,309387,1.6703998551975359
175.0,EL002L1,Thessaloniki,2010,1583,140536,142119,1.1138552902849022
176.0,EL003L1,Patra,2010,668,50922,51590,1.294824578406668
177.0,EL004L1,Irakleio,2010,1083,60301,61384,1.76430340153786
178.0,EL005L1,Larisa,2010,159,155360,155519,0.10223831171753933
179.0,EL006L1,Volos,2010,275,30541,30816,0.8923935617860852
180.0,EL007L1,Ioannina,2010,2028,130613,132641,1.528939015839748
181.0,EL008L1,Kavala,2010,330,35238,35568,0.9278002699055331
182.0,EL009L1,Kalamata,2010,270,44182,44452,0.6073967425537659
183.0,ES001L3,Madrid,2010,2433,785170,787603,0.3089119772271055
184.0,ES002L2,Barcelona,2010,1274,263333,264607,0.48146874421311603
185.0,ES003L3,Valencia,2010,3143,171977,175120,1.7947693010507082
186.0,ES004L3,Sevilla,2010,4691,463735,468426,1.0014388612075333
187.0,ES005L2,Zaragoza,2010,155,275983,276138,0.0561313546125488
188.0,ES006L2,MÃ¡laga,2010,1038,151704,152742,0.6795773264720902
189.0,ES007L2,Murcia,2010,101,120035,120136,0.08407138576280215
190.0,ES008L2,Las Palmas,2010,1669,74927,76596,2.1789649590056923
191.0,ES009L2,Valladolid,2010,209,115320,115529,0.18090695842602292
192.0,ES010L2,Palma de Mallorca,2010,2324,201910,204234,1.1379104360684313
193.0,ES011L2,Santiago de Compostela,2010,1,126255,126256,0.0007920415663414017
194.0,ES012L2,Vitoria/Gasteiz,2010,519,158802,159321,0.32575743310674676
195.0,ES013L2,Oviedo,2010,24,93463,93487,0.025672018569426764
196.0,ES014L3,Pamplona/IruÃ±a,2010,164,169350,169514,0.09674717132508229
197.0,ES015L2,Santander,2010,410,69073,69483,0.5900723918080681
198.0,ES016L2,Toledo,2010,470,92928,93398,0.503222767082807
199.0,ES017L2,Badajoz,2010,982,217767,218749,0.448916337903259
200.0,ES018L2,LogroÃ±o,2010,49,46089,46138,0.10620312974121114
201.0,ES019L3,Bilbao,2010,824,152497,153321,0.5374345327776364
202.0,ES020L2,CÃ³rdoba,2010,1327,185575,186902,0.7099977528330355
203.0,ES021L2,Alicante/Alacant,2010,412,35646,36058,1.1426035831160908
204.0,ES022L2,Vigo,2010,929,135542,136471,0.6807307046918393
205.0,ES023L2,GijÃ³n,2010,444,52958,53402,0.8314295344743643
206.0,ES025L3,Santa Cruz de Tenerife,2010,32537,34446,66983,48.575011570099875
207.0,ES026L2,CoruÃ±a (A),2010,433,75542,75975,0.5699243172096085
208.0,ES028L1,Reus,2010,0,11534,11534,0.0
209.0,ES031L1,Lugo,2010,17,133994,134011,0.012685525815045033
210.0,ES033L1,Girona,2010,2,39619,39621,0.005047828171929028
211.0,ES034L1,CÃ¡ceres,2010,2067,236206,238273,0.867492330226253
212.0,ES035L1,Torrevieja,2010,1714,7124,8838,19.393527947499432
213.0,ES039L1,AvilÃ©s,2010,258,18884,19142,1.34782154424825
214.0,ES040L1,Talavera de la Reina,2010,554,82712,83266,0.6653375927749622
215.0,ES041L1,Palencia,2010,12,28369,28381,0.04228180825199958
216.0,ES043L1,Ferrol,2010,505,46465,46970,1.0751543538428785
217.0,ES044L1,Pontevedra,2010,145,51471,51616,0.2809206447613143
218.0,ES046L1,Gandia,2010,246,17091,17337,1.418930610832324
219.0,ES048L1,Guadalajara,2010,3,45380,45383,0.006610404777119186
220.0,ES050L1,Manresa,2010,3,29600,29603,0.010134108029591596
221.0,ES053L1,Ciudad Real,2010,902,95443,96345,0.9362187970315013
222.0,ES054L1,Benidorm,2010,339,20334,20673,1.6398200551443913
223.0,ES057L1,Ponferrada,2010,316,62027,62343,0.5068732656432959
224.0,ES059L1,Zamora,2010,401,33779,34180,1.1732007021650088
225.0,ES070L1,Irun,2010,18,7224,7242,0.24855012427506215
226.0,ES072L1,Arrecife,2010,6960,51974,58934,11.809821155869278
227.0,ES501L3,Granada,2010,524,162100,162624,0.322215663124754
228.0,ES505L1,Elche/Elx,2010,693,38125,38818,1.7852542634860116
229.0,ES506L1,Cartagena,2010,1525,59423,60948,2.5021329658069176
230.0,ES508L1,Jerez de la Frontera,2010,202,125904,126106,0.16018270343996321
231.0,ES510L1,Donostia-San SebastiÃ¡n,2010,103,33217,33320,0.3091236494597839
232.0,ES514L1,AlmerÃ­a,2010,741,39989,40730,1.8192978148784682
233.0,ES515L1,Burgos,2010,2,149389,149391,0.001338768734394977
234.0,ES516L1,Salamanca,2010,17,45627,45644,0.03724476382437999
235.0,ES519L1,Albacete,2010,33,245292,245325,0.013451543870376031
236.0,ES520L1,CastellÃ³n/CastellÃ³,2010,350,32444,32794,1.067268402756602
237.0,ES521L1,Huelva,2010,3849,93571,97420,3.9509340997741735
238.0,ES522L1,CÃ¡diz,2010,991,23842,24833,3.9906575927193657
239.0,ES523L1,LeÃ³n,2010,4,118883,118887,0.0033645394366078715
240.0,ES525L1,Tarragona,2010,458,21282,21740,2.106715731370745
241.0,ES527L1,JaÃ©n,2010,31,99900,99931,0.03102140476929081
242.0,ES528L1,Lleida,2010,117,70558,70675,0.16554651574106827
243.0,ES529L1,Ourense,2010,433,64735,65168,0.6644365332678615
244.0,ES532L1,Algeciras,2010,396,41898,42294,0.9363030217052063
245.0,ES533L1,Marbella,2010,583,68622,69205,0.8424246802976664
246.0,ES537L1,Alcoy,2010,0,20529,20529,0.0
247.0,ES538L1,Ãvila,2010,512,53134,53646,0.9544048018491593
248.0,ES542L1,Cuenca,2010,72,164510,164582,0.04374718985065196
249.0,ES543L1,Eivissa,2010,2129,57273,59402,3.58405440894246
250.0,ES544L1,Linares,2010,13,25763,25776,0.05043451272501552
251.0,ES545L1,Lorca,2010,139,182068,182207,0.07628686054871657
252.0,ES546L1,MÃ©rida,2010,965,127334,128299,0.7521492762998933
253.0,ES547L1,Sagunto,2010,204,15324,15528,1.313755795981453
254.0,ES550L1,Puerto de la Cruz,2010,12364,15108,27472,45.005824111822946
255.0,ES552L1,Igualada,2010,0,25426,25426,0.0
256.0,FI001L3,Helsinki,2010,17753,473765,491518,3.6118717930981163
257.0,FI002L3,Tampere,2010,86808,601835,688643,12.605660697923307
258.0,FI003L4,Turku,2010,18718,447726,466444,4.012914733601462
259.0,FI004L4,Oulu,2010,7358,716463,723821,1.0165496718111244
260.0,FI007L2,Lahti,2010,32835,302568,335403,9.78971565549503
261.0,FI008L2,Kuopio,2010,132121,788285,920406,14.354643494284044
262.0,FI009L2,JyvÃ¤skylÃ¤,2010,58645,418297,476942,12.296044382755136
263.0,FR001L1,Paris,2010,1023,1208929,1209952,0.0845488085477771
264.0,FR003L2,Lyon,2010,1013,366218,367231,0.2758481718591296
265.0,FR004L2,Toulouse,2010,785,523887,524672,0.14961728470358626
266.0,FR006L2,Strasbourg,2010,762,203121,203883,0.37374376480628596
267.0,FR007L2,Bordeaux,2010,4775,550979,555754,0.8591930962260281
268.0,FR008L2,Nantes,2010,2028,314591,316619,0.6405174673661405
269.0,FR009L2,Lille,2010,60,144393,144453,0.04153600132915204
270.0,FR010L2,Montpellier,2010,7263,216655,223918,3.243598102876946
271.0,FR011L2,Saint-Etienne,2010,218,180837,181055,0.12040540167352462
272.0,FR012L2,Le Havre,2010,859,75579,76438,1.1237865982888091
273.0,FR013L2,Rennes,2010,112,382025,382137,0.029308860434870215
274.0,FR014L2,Amiens,2010,17,244778,244795,0.0069445862864846095
275.0,FR016L2,Nancy,2010,190,283319,283509,0.06701727282026321
276.0,FR017L2,Metz,2010,2,176928,176930,0.0011303905499350027
277.0,FR018L2,Reims,2010,9,243142,243151,0.0037014036545192077
278.0,FR019L2,OrlÃ©ans,2010,888,291079,291967,0.3041439614750982
279.0,FR020L2,Dijon,2010,55,385706,385761,0.014257532513654829
280.0,FR021L2,Poitiers,2010,37,250405,250442,0.014773879780547993
281.0,FR022L2,Clermont-Ferrand,2010,27,266099,266126,0.010145570143465876
282.0,FR023L2,Caen,2010,494,225779,226273,0.21832034754478
283.0,FR024L2,Limoges,2010,29,317805,317834,0.009124259833749693
284.0,FR025L2,BesanÃ§on,2010,12,239024,239036,0.005020164326712294
285.0,FR026L2,Grenoble,2010,5960,259888,265848,2.2418825795191237
286.0,FR027L2,Ajaccio,2010,1859,145150,147009,1.2645484290077478
289.0,FR032L2,Toulon,2010,2283,104773,107056,2.132528769989538
290.0,FR034L2,Valenciennes,2010,10,78436,78446,0.012747622568390994
291.0,FR035L2,Tours,2010,706,284142,284848,0.2478514857046565
292.0,FR036L2,Angers,2010,432,230819,231251,0.18681000298377087
293.0,FR037L2,Brest,2010,865,134129,134994,0.6407692193727128
294.0,FR038L2,Le Mans,2010,14,224097,224111,0.006246904435748356
295.0,FR039L1,Avignon,2010,1488,85737,87225,1.705932932072227
296.0,FR040L2,Mulhouse,2010,115,129651,129766,0.08862105636299185
297.0,FR042L2,Dunkerque,2010,768,90357,91125,0.8427983539094651
298.0,FR043L2,Perpignan,2010,1760,181270,183030,0.9615909960115828
299.0,FR044L2,NÃ®mes,2010,1374,149117,150491,0.9130114093201587
300.0,FR045L2,Pau,2010,4,201755,201759,0.0019825633552902227
301.0,FR046L2,Bayonne,2010,872,101758,102630,0.8496540972425217
302.0,FR047L0,Annemasse,2010,3,7797,7800,0.038461538461538464
303.0,FR048L2,Annecy,2010,1595,117448,119043,1.3398519862570668
304.0,FR049L2,Lorient,2010,556,112626,113182,0.4912441907723843
305.0,FR050L2,MontbÃ©liard,2010,33,123024,123057,0.026816840976133013
306.0,FR051L2,Troyes,2010,110,260840,260950,0.042153669285303695
307.0,FR052L2,Saint-Nazaire,2010,497,106638,107135,0.4639006860503104
308.0,FR053L2,La Rochelle,2010,159,111181,111340,0.1428058200107778
309.0,FR056L2,AngoulÃªme,2010,10,214282,214292,0.004666529781793067
310.0,FR057L2,Boulogne-sur-Mer,2010,159,68379,68538,0.23198809419592048
311.0,FR058L2,ChambÃ©ry,2010,1034,100655,101689,1.0168258120347333
312.0,FR059L2,Chalon-sur-SaÃ´ne,2010,19,156339,156358,0.012151600813517696
313.0,FR060L2,Chartres,2010,14,161346,161360,0.008676251859196828
314.0,FR061L2,Niort,2010,39,178880,178919,0.021797573203516676
315.0,FR062L2,Calais,2010,75,50155,50230,0.1493131594664543
316.0,FR063L2,BÃ©ziers,2010,442,84701,85143,0.5191266457606615
317.0,FR064L2,Arras,2010,11,107552,107563,0.010226564896851148
318.0,FR065L2,Bourges,2010,133,250186,250319,0.053132203308578256
319.0,FR066L2,Saint-Brieuc,2010,171,115010,115181,0.1484619859178163
320.0,FR067L2,Quimper,2010,814,121108,121922,0.667639966535982
321.0,FR068L2,Vannes,2010,791,120243,121034,0.653535370226548
322.0,FR069L2,Cherbourg,2010,683,90035,90718,0.7528825591393108
323.0,FR073L2,Tarbes,2010,2,104327,104329,0.0019170125276768682
324.0,FR074L2,CompiÃ¨gne,2010,19,98718,98737,0.01924303959002198
325.0,FR076L2,Belfort,2010,64,65555,65619,0.09753272680168854
326.0,FR077L2,Roanne,2010,9,123191,123200,0.007305194805194805
327.0,FR079L2,Saint-Quentin,2010,11,99363,99374,0.011069293779056896
328.0,FR082L2,Beauvais,2010,0,131142,131142,0.0
329.0,FR084L2,Creil,2010,12,29631,29643,0.04048173261815606
330.0,FR086L2,Evreux,2010,1,126569,126570,0.0007900766374338311
331.0,FR090L2,ChÃ¢teauroux,2010,231,260946,261177,0.08844576666398649
332.0,FR093L2,Brive-la-Gaillarde,2010,1,132581,132582,0.0007542501998763029
333.0,FR096L2,Albi,2010,86,134152,134238,0.06406531682534007
334.0,FR099L2,FrÃ©jus,2010,447,43966,44413,1.0064620719158806
335.0,FR104L2,ChÃ¢lons-en-Champagne,2010,26,152783,152809,0.01701470463127172
336.0,FR203L2,Marseille,2010,2924,422852,425776,0.6867460824471083
337.0,FR205L2,Nice,2010,1100,306240,307340,0.35790980672870437
338.0,FR207L2,Lens - LiÃ©vin,2010,28,25280,25308,0.1106369527422159
339.0,FR208L1,HÃ©nin - Carvin,2010,6,11592,11598,0.05173305742369374
340.0,FR209L2,Douai,2010,24,45060,45084,0.053233963268565346
341.0,FR214L1,Valence,2010,410,90551,90961,0.4507426259605765
342.0,FR215L2,Rouen,2010,632,286494,287126,0.22011242451049365
343.0,FR304L1,Melun,2010,72,44764,44836,0.16058524400035687
344.0,FR324L1,Martigues,2010,1730,18726,20456,8.457176378568636
345.0,FR505L1,Charleville-MÃ©ziÃ¨res,2010,10,135359,135369,0.007387215684536342
346.0,FR506L1,Colmar,2010,157,101828,101985,0.15394420748149237
347.0,FR519L1,Cannes,2010,495,19641,20136,2.458283671036949
348.0,HR001L2,Grad Zagreb,2010,205,505663,505868,0.040524405576158204
349.0,HR002L2,Rijeka,2010,513,106721,107234,0.47839304698136786
350.0,HR003L2,Slavonski Brod,2010,21,97809,97830,0.021465808034345293
351.0,HR004L2,Osijek,2010,1479,171455,172934,0.8552395711658783
352.0,HR005L2,Split,2010,3221,335849,339070,0.9499513374819359
353.0,HR006L1,Pula - Pola,2010,1380,57517,58897,2.343073501197005
354.0,HR007L1,Zadar,2010,2448,154052,156500,1.5642172523961662
355.0,HU001L2,Budapest,2010,4462,634672,639134,0.6981321600791071
356.0,HU002L2,Miskolc,2010,12,164657,164669,0.007287346130722844
357.0,HU003L2,NyÃ­regyhÃ¡za,2010,41,168184,168225,0.024372120671719424
358.0,HU004L2,PÃ©cs,2010,32,185456,185488,0.017251789873199343
359.0,HU005L2,Debrecen,2010,443,201135,201578,0.21976604589786583
360.0,HU006L2,Szeged,2010,658,160275,160933,0.40886580129619154
361.0,HU007L2,GyÃµr,2010,360,204280,204640,0.17591868647380765
362.0,HU008L2,KecskemÃ©t,2010,76,182063,182139,0.04172637381340625
363.0,HU009L2,SzÃ©kesfehÃ©rvÃ¡r,2010,773,300350,301123,0.2567057315449169
364.0,HU010L1,Szombathely,2010,21,134256,134277,0.015639312763913404
365.0,HU011L1,Szolnok,2010,687,143288,143975,0.47716617468310474
366.0,HU012L1,TatabÃ¡nya,2010,21,69809,69830,0.03007303451238723
367.0,HU013L1,VeszprÃ©m,2010,7147,124173,131320,5.4424307036247335
368.0,HU014L1,BÃ©kÃ©scsaba,2010,16,106147,106163,0.01507116415323606
369.0,HU015L1,KaposvÃ¡r,2010,0,145560,145560,0.0
370.0,HU016L1,Eger,2010,80,100498,100578,0.07954025731273241
371.0,HU017L1,DunaÃºjvÃ¡ros,2010,688,60982,61670,1.1156153721420463
372.0,HU018L1,Zalaegerszeg,2010,265,139714,139979,0.18931411140242466
373.0,HU019L1,Sopron,2010,331,80339,80670,0.4103136234039915
374.0,IE001L1,Dublin,2010,2879,700723,703602,0.40918018993692457
375.0,IE002L1,Cork,2010,11344,318319,329663,3.4410898402307812
376.0,IE003L1,Limerick,2010,2990,153468,156458,1.911056002249805
377.0,IE004L1,Galway,2010,18512,207771,226283,8.180906210364897
378.0,IE005L1,Waterford,2010,1865,93992,95857,1.9456064763136758
379.0,IS001L1,ReykjavÃ­k,2010,1297230,0,1297230,100.0
380.0,IT001L3,Roma,2010,8880,608336,617216,1.438718374118623
381.0,IT002L3,Milano,2010,23,384022,384045,0.005988881511281231
382.0,IT003L3,Napoli,2010,3033,149909,152942,1.9831047063592737
383.0,IT004L2,Torino,2010,55,170124,170179,0.032318911264022
384.0,IT005L3,Palermo,2010,1678,148395,150073,1.1181225137099946
385.0,IT006L3,Genova,2010,562,120202,120764,0.4653704746447617
386.0,IT007L3,Firenze,2010,85,163686,163771,0.05190174084544883
387.0,IT008L3,Bari,2010,844,112585,113429,0.7440777931569528
388.0,IT009L1,Bologna,2010,67,185190,185257,0.03616597483495901
389.0,IT010L2,Catania,2010,653,60772,61425,1.063085063085063
390.0,IT011L2,Venezia,2010,1840,65197,67037,2.7447528976535343
391.0,IT012L3,Verona,2010,54,73107,73161,0.07380981670562184
392.0,IT013L3,Cremona,2010,168,60229,60397,0.27815951123400173
393.0,IT014L3,Trento,2010,611,97576,98187,0.6222819721551732
394.0,IT015L1,Trieste,2010,372,21265,21637,1.7192771641170217
395.0,IT016L3,Perugia,2010,5787,125241,131028,4.416613242970968
396.0,IT017L3,Ancona,2010,517,43726,44243,1.1685464367244536
397.0,IT019L2,Pescara,2010,246,16197,16443,1.4960773581463238
398.0,IT020L3,Campobasso,2010,477,102358,102835,0.4638498565663441
399.0,IT021L2,Caserta,2010,1,9341,9342,0.010704345964461572
400.0,IT022L2,Taranto,2010,3425,103503,106928,3.203089929672303
401.0,IT023L2,Potenza,2010,152,138303,138455,0.10978296197320428
402.0,IT024L3,Catanzaro,2010,397,89686,90083,0.44070468345858815
403.0,IT025L3,Reggio di Calabria,2010,746,47502,48248,1.5461780799204112
404.0,IT026L3,Sassari,2010,2333,150892,153225,1.5225974873551966
405.0,IT027L2,Cagliari,2010,4919,190373,195292,2.518792372447412
406.0,IT028L3,Padova,2010,3,61442,61445,0.004882415168036456
407.0,IT029L3,Brescia,2010,78,60191,60269,0.1294197680399542
408.0,IT030L3,Modena,2010,121,69147,69268,0.1746838366922677
409.0,IT031L3,Foggia,2010,5,89706,89711,0.0055734525309047945
410.0,IT032L3,Salerno,2010,349,37490,37839,0.9223288141864214
411.0,IT033L2,Piacenza,2010,202,93925,94127,0.2146036737599201
412.0,IT034L1,Bolzano,2010,616,106140,106756,0.5770167484731538
413.0,IT035L2,Udine,2010,0,71830,71830,0.0
414.0,IT036L2,La Spezia,2010,686,42233,42919,1.5983597008317993
415.0,IT037L1,Lecce,2010,337,61173,61510,0.5478783937571127
416.0,IT038L1,Barletta,2010,233,14864,15097,1.5433529840365636
417.0,IT039L2,Pesaro,2010,143,25548,25691,0.5566151570588923
418.0,IT040L2,Como,2010,446,19295,19741,2.2592573831112914
419.0,IT041L2,Pisa,2010,523,47530,48053,1.088381578673548
420.0,IT042L1,Treviso,2010,31,24014,24045,0.1289249324183822
421.0,IT043L2,Varese,2010,479,23185,23664,2.0241717376605814
422.0,IT045L2,Asti,2010,8,54828,54836,0.014588956160186739
423.0,IT046L2,Pavia,2010,36,36168,36204,0.09943652635067948
424.0,IT047L1,Massa,2010,281,10962,11243,2.499332918260251
425.0,IT048L2,Cosenza,2010,1372,91107,92479,1.4835800560127166
426.0,IT052L1,Savona,2010,203,28502,28705,0.7071938686639958
427.0,IT054L1,Matera,2010,644,77145,77789,0.8278805486636929
428.0,IT056L1,Acireale,2010,54,5934,5988,0.9018036072144289
429.0,IT057L2,Avellino,2010,4,39755,39759,0.010060615206619885
430.0,IT058L2,Pordenone,2010,25,37025,37050,0.06747638326585695
431.0,IT060L1,Lecco,2010,1242,28970,30212,4.110949291672183
432.0,IT061L0,Altamura,2010,0,42800,42800,0.0
433.0,IT064L1,Battipaglia,2010,53,6433,6486,0.8171446191797719
434.0,IT065L0,Bisceglie,2010,87,6857,6944,1.2528801843317972
435.0,IT066L1,Carpi,2010,3,20619,20622,0.014547570555717195
436.0,IT067L0,Cerignola,2010,128,58769,58897,0.21732855663276568
437.0,IT068L1,Gallarate,2010,0,5319,5319,0.0
438.0,IT069L1,Gela,2010,425,57470,57895,0.7340875723292167
439.0,IT073L1,Sassuolo,2010,0,24062,24062,0.0
440.0,IT501L2,Messina,2010,807,33636,34443,2.3430014807072554
441.0,IT502L2,Prato,2010,5,40954,40959,0.012207329280500013
442.0,IT503L3,Parma,2010,108,113399,113507,0.09514831684389509
443.0,IT504L3,Livorno,2010,371,25443,25814,1.4372046176493374
444.0,IT505L3,Reggio nell'Emilia,2010,10,69024,69034,0.014485615783526957
445.0,IT506L2,Ravenna,2010,3404,77785,81189,4.192686201332693
446.0,IT507L2,Ferrara,2010,697,90786,91483,0.7618901872479039
447.0,IT508L3,Rimini,2010,294,32285,32579,0.9024218054575033
448.0,IT509L3,Siracusa,2010,558,33584,34142,1.6343506531544725
449.0,IT511L2,Bergamo,2010,1,18555,18556,0.0053890924768269025
450.0,IT512L3,ForlÃ¬,2010,16,72735,72751,0.02199282484089566
451.0,IT513L3,Latina,2010,528,65965,66493,0.7940685485690223
452.0,IT514L2,Vicenza,2010,1,34981,34982,0.0028586130009719286
453.0,IT515L2,Terni,2010,152,102180,102332,0.1485361372786616
454.0,IT516L2,Novara,2010,11,54154,54165,0.020308317178990124
455.0,IT518L1,Alessandria,2010,25,76889,76914,0.0325038354525834
456.0,IT519L1,Arezzo,2010,28,88599,88627,0.03159308111523577
457.0,IT520L1,Grosseto,2010,454,119145,119599,0.37960183613575366
458.0,IT521L1,Brindisi,2010,850,63137,63987,1.3283948301998842
459.0,IT522L1,Trapani,2010,968,49822,50790,1.9058869856270917
460.0,IT523L1,Ragusa,2010,263,52587,52850,0.4976348155156103
461.0,IT524L0,Andria,2010,3,39877,39880,0.0075225677031093285
462.0,IT525L0,Trani,2010,121,10258,10379,1.1658155891704403
463.0,IT526L1,L'Aquila,2010,384,139885,140269,0.27375970456765214
464.0,LT001L1,Vilnius,2010,1723,422846,424569,0.40582331729353766
465.0,LT002L1,Kaunas,2010,270,161781,162051,0.16661421404372698
466.0,LT003L1,PanevÄÅ¾ys,2010,4,222804,222808,0.0017952676744102546
467.0,LT004L0,Alytus,2010,3,3956,3959,0.07577671129072998
468.0,LT501L0,KlaipÄda,2010,87,8836,8923,0.9750084052448729
469.0,LT502L0,Å iauliai,2010,985,7060,8045,12.243629583592293
470.0,LU001L1,Luxembourg,2010,36,259679,259715,0.013861348016094564
471.0,LV001L1,RÄ«ga,2010,6348,609901,616249,1.0301030914451788
472.0,LV002L2,LiepÄja,2010,3157,268900,272057,1.160418588751622
473.0,LV003L1,Jelgava,2010,220,166239,166459,0.13216467718777597
474.0,LV501L1,Daugavpils,2010,603,259072,259675,0.23221334360258014
475.0,ME001L1,Podgorica,2010,963,183518,184481,0.5220049761222023
476.0,MK001L1,Skopje,2010,14,224339,224353,0.006240166166710496
477.0,MK003L1,Bitola,2010,321,119341,119662,0.2682555865688356
478.0,MK004L1,Tetovo,2010,6,105615,105621,0.0056806884994461335
479.0,MK005L1,Prilep,2010,48,86783,86831,0.05527979638608331
480.0,MT001L1,Valletta,2010,1071,24885,25956,4.12621359223301
481.0,NL001L3,s' Gravenhage,2010,4072,38635,42707,9.534736694218747
482.0,NL002L3,Amsterdam,2010,72902,260055,332957,21.895319816072345
483.0,NL003L3,Rotterdam,2010,28070,189101,217171,12.925298497497364
484.0,NL004L3,Utrecht,2010,628,96659,97287,0.6455127612116727
485.0,NL005L3,Eindhoven,2010,154,144252,144406,0.10664376826447655
486.0,NL006L3,Tilburg,2010,55,43179,43234,0.127214692140445
487.0,NL007L3,Groningen,2010,3223,204937,208160,1.5483282090699464
488.0,NL008L3,Enschede,2010,42,84914,84956,0.049437355807712226
489.0,NL009L3,Arnhem,2010,96,55802,55898,0.17174138609610362
490.0,NL010L3,Heerlen,2010,8,33335,33343,0.023993042017814836
491.0,NL012L3,Breda,2010,1121,72249,73370,1.5278724274226523
492.0,NL013L3,Nijmegen,2010,318,39518,39836,0.7982729189677679
493.0,NL014L3,Apeldoorn,2010,8,71116,71124,0.011247961307013105
494.0,NL015L3,Leeuwarden,2010,962,109961,110923,0.8672682852068552
495.0,NL016L3,Sittard-Geleen,2010,31,22881,22912,0.13530027932960895
496.0,NL020L3,Roosendaal,2010,0,24574,24574,0.0
497.0,NL026L0,Alphen aan den Rijn,2010,1,13209,13210,0.00757002271006813
498.0,NL028L3,Bergen op Zoom,2010,1801,32980,34781,5.17811448779506
499.0,NL030L0,Gouda,2010,4,1784,1788,0.22371364653243847
500.0,NL032L3,MiddelburgÂ Â Â Â Â Â ,2010,995,22393,23388,4.254318453907987
501.0,NL503L3,s-Hertogenbosch,2010,198,36661,36859,0.5371822350036627
502.0,NL504L3,Amersfoort,2010,0,12244,12244,0.0
503.0,NL505L3,Maastricht,2010,18,20367,20385,0.08830022075055188
504.0,NL507L3,Leiden,2010,235,19546,19781,1.1880086952125777
505.0,NL511L3,Zwolle,2010,804,122216,123020,0.6535522679239147
506.0,NL512L3,Ede,2010,8,35257,35265,0.022685382106904864
507.0,NL513L3,Deventer,2010,4,25241,25245,0.015844721727074667
508.0,NL514L3,Alkmaar,2010,494,47298,47792,1.0336457984599934
509.0,NL515L3,Venlo,2010,84,51152,51236,0.1639472246076977
510.0,NL519L3,Almelo,2010,5,42020,42025,0.01189767995240928
511.0,NL520L3,Lelystad,2010,58904,59938,118842,49.56496861378974
512.0,NL521L3,Oss,2010,82,33064,33146,0.24739033367525495
513.0,NL522L3,Assen,2010,170,70692,70862,0.23990290988117752
514.0,NL524L3,Veenendaal,2010,24,8161,8185,0.29321930360415394
515.0,NL529L3,Soest,2010,0,7942,7942,0.0
516.0,NO001L1,Oslo,2010,33712,712931,746643,4.5151431139112
517.0,NO002L1,Bergen,2010,17042,340701,357743,4.763754986121322
518.0,NO003L1,Trondheim,2010,17254,656002,673256,2.562769585417731
519.0,NO004L1,Stavanger,2010,9944,279133,289077,3.439913932965957
520.0,NO005L1,Kristiansand,2010,8988,306474,315462,2.8491545732925045
521.0,NO006L1,TromsÃ¸,2010,169082,205531,374613,45.135112769711675
522.0,PL001L2,Warszawa,2010,3170,858073,861243,0.36807265777486725
523.0,PL002L2,ÅÃ³dÅº,2010,67,169433,169500,0.03952802359882006
524.0,PL003L2,KrakÃ³w,2010,676,375072,375748,0.17990781055388186
525.0,PL004L2,WrocÅaw,2010,34,264666,264700,0.012844729882886288
526.0,PL005L2,PoznaÅ,2010,399,308929,309328,0.12898929291884342
527.0,PL006L2,GdaÅsk,2010,2239,261277,263516,0.8496637775315351
528.0,PL007L2,Szczecin,2010,2673,110387,113060,2.3642313815673095
529.0,PL008L2,Bydgoszcz,2010,1103,209033,210136,0.5248981611908479
530.0,PL009L2,Lublin,2010,40,322744,322784,0.01239218796470705
531.0,PL010L2,Katowice,2010,1171,393424,394595,0.2967599690822235
532.0,PL011L2,BiaÅystok,2010,13,223309,223322,0.005821190926106698
533.0,PL012L2,Kielce,2010,17,224212,224229,0.007581534948646251
534.0,PL013L2,ToruÅ,2010,1184,157749,158933,0.7449680053859173
535.0,PL014L2,Olsztyn,2010,2509,200035,202544,1.2387431866656136
536.0,PL015L2,RzeszÃ³w,2010,41,229308,229349,0.017876685749665357
537.0,PL016L2,Opole,2010,318,176298,176616,0.18005163745074057
538.0,PL017L2,GorzÃ³w Wielkopolski,2010,28,97392,97420,0.02874153151303634
539.0,PL018L2,Zielona GÃ³ra,2010,16,169268,169284,0.009451572505375582
540.0,PL019L2,Jelenia GÃ³ra,2010,19,83322,83341,0.022797902592961446
541.0,PL020L2,Nowy SÄcz,2010,10,130408,130418,0.0076676532380499625
542.0,PL021L2,SuwaÅki,2010,1008,71125,72133,1.3974186572026672
543.0,PL022L2,Konin,2010,405,117758,118163,0.34274688354222554
544.0,PL024L2,CzÄstochowa,2010,7,193891,193898,0.003610145540438787
545.0,PL025L2,Radom,2010,13,68009,68022,0.01911146393813766
546.0,PL026L2,PÅock,2010,3447,167628,171075,2.014905743095134
547.0,PL027L2,Kalisz,2010,2,149021,149023,0.0013420747132992894
548.0,PL028L2,Koszalin,2010,56,129615,129671,0.0431862174271811
549.0,PL029L1,SÅupsk,2010,7582,227422,235004,3.226328062501064
550.0,PL030L1,JastrzÄbie-ZdrÃ³j,2010,1,29570,29571,0.003381691522099354
551.0,PL031L1,Siedlce,2010,34,126135,126169,0.026947982467959642
552.0,PL032L1,PiotrkÃ³w Trybunalski,2010,135,116787,116922,0.11546158977780059
553.0,PL033L1,Lubin,2010,246,93060,93306,0.2636486399588451
554.0,PL034L1,PiÅa,2010,28,52164,52192,0.0536480686695279
555.0,PL035L1,InowrocÅaw,2010,1,20127,20128,0.004968203497615262
556.0,PL036L1,Ostrowiec ÅwiÄtokrzyski,2010,0,61460,61460,0.0
557.0,PL037L1,Gniezno,2010,84,66487,66571,0.12618106983521354
558.0,PL038L1,Stargard SzczeciÅski,2010,1577,35087,36664,4.301221907047785
559.0,PL039L1,OstrÃ³w Wielkopolski,2010,38,84723,84761,0.044831939217328726
560.0,PL040L1,PrzemyÅl,2010,144,84945,85089,0.1692345661601382
561.0,PL041L1,ZamoÅÄ,2010,22,112685,112707,0.019519639419024553
562.0,PL042L1,CheÅm,2010,6,46564,46570,0.012883830792355595
563.0,PL043L1,Pabianice,2010,4,32955,32959,0.012136290542795594
564.0,PL044L1,GÅogÃ³w,2010,2,64079,64081,0.0031210499211934894
565.0,PL045L1,Stalowa Wola,2010,107,190206,190313,0.05622316920021229
566.0,PL046L1,TomaszÃ³w Mazowiecki,2010,606,18557,19163,3.1623441006105515
567.0,PL047L1,ÅomÅ¼a,2010,0,56002,56002,0.0
568.0,PL048L1,Leszno,2010,94,77478,77572,0.12117774454700149
569.0,PL049L1,Åwidnica,2010,2,47988,47990,0.004167534903104814
570.0,PL051L1,Tczew,2010,130,26994,27124,0.47928034213242887
571.0,PL052L1,EÅk,2010,1209,38843,40052,3.018575851393189
572.0,PL506L2,Bielsko-BiaÅa,2010,433,73002,73435,0.5896370940287329
573.0,PL508L1,Rybnik,2010,132,14749,14881,0.8870371614810832
574.0,PL511L2,WaÅbrzych,2010,3,51507,51510,0.005824111822947
575.0,PL512L2,ElblÄg,2010,15,96460,96475,0.015548069448043534
576.0,PL513L2,WÅocÅawek,2010,1834,120645,122479,1.497399554209293
577.0,PL514L2,TarnÃ³w,2010,116,125211,125327,0.09255786861570132
578.0,PL516L2,Legnica,2010,0,56500,56500,0.0
579.0,PL517L2,GrudziÄdz,2010,705,54338,55043,1.2808168159438984
580.0,PT001L3,Lisboa,2010,7656,431625,439281,1.742847972027017
581.0,PT002L2,Porto,2010,1156,94584,95740,1.2074368080217255
582.0,PT003L1,Braga,2010,46,49303,49349,0.09321364161381183
583.0,PT004L2,Funchal,2010,23738,12224,35962,66.00856459596241
584.0,PT005L2,Coimbra,2010,448,162339,162787,0.2752062511134181
585.0,PT007L1,Ponta Delgada,2010,19723,35571,55294,35.669331211343
586.0,PT008L2,Aveiro,2010,2351,40979,43330,5.425801984768059
587.0,PT009L1,Faro,2010,2522,46628,49150,5.131230925737538
588.0,PT014L1,Viseu,2010,8,70866,70874,0.0112876372153399
589.0,PT016L0,Viana do Castelo,2010,444,31808,32252,1.376658811856629
590.0,PT019L0,PÃ³voa de Varzim,2010,37,8369,8406,0.4401617891981918
591.0,PT505L1,GuimarÃ£es,2010,0,26541,26541,0.0
592.0,RO001L1,BucureÅti,2010,523,107319,107842,0.4849687505795516
593.0,RO002L1,Cluj-Napoca,2010,15,59287,59302,0.02529425651748676
594.0,RO003L1,TimiÅoara,2010,2,23652,23654,0.00845522955948254
595.0,RO004L1,Craiova,2010,18,34378,34396,0.05233166647284568
596.0,RO005L1,BrÄila,2010,1289,22240,23529,5.478345871052744
597.0,RO006L1,Oradea,2010,34,20305,20339,0.1671665273612272
598.0,RO007L1,BacÄu,2010,187,21906,22093,0.8464219436020459
599.0,RO008L1,Arad,2010,2,51606,51608,0.0038753681599751973
600.0,RO009L1,Sibiu,2010,2,56338,56340,0.003549875754348598
601.0,RO010L1,TÃ¢rgu MureÅ,2010,21,13719,13740,0.15283842794759825
602.0,RO011L1,Piatra NeamÅ£,2010,85,14914,14999,0.5667044469631309
603.0,RO012L1,CÇlÇraÅi,2010,651,23893,24544,2.6523794002607564
604.0,RO013L1,Giurgiu,2010,545,10405,10950,4.9771689497716896
605.0,RO014L1,Alba Iulia,2010,3,25999,26002,0.01153757403276671
606.0,RO015L1,FocÅani,2010,0,27102,27102,0.0
607.0,RO016L1,TÃ¢rgu Jiu,2010,14,24508,24522,0.05709159122420683
608.0,RO017L1,Tulcea,2010,1971,38976,40947,4.813539453439812
609.0,RO018L1,TÃ¢rgoviÅte,2010,1,20256,20257,0.004936565137976996
610.0,RO019L1,Slatina,2010,143,6980,7123,2.007581075389583
611.0,RO020L1,BÃ¢rlad,2010,0,26319,26319,0.0
612.0,RO021L1,Roman,2010,0,14390,14390,0.0
613.0,RO022L1,BistriÅ£a,2010,58,42573,42631,0.1360512303253501
614.0,RO501L1,Constanta,2010,5122,54229,59351,8.630014658556721
615.0,RO502L1,Iasi,2010,86,79850,79936,0.10758606885508405
616.0,RO503L1,Galati,2010,894,40338,41232,2.168218859138533
617.0,RO504L1,Brasov,2010,81,98422,98503,0.08223099804066882
618.0,RO505L1,Ploiesti,2010,2,34335,34337,0.005824620671578763
619.0,RO506L1,Pitesti,2010,216,24668,24884,0.8680276482880566
620.0,RO507L1,Baia Mare,2010,216,52325,52541,0.4111075160350964
621.0,RO508L1,Buzau,2010,16,38524,38540,0.04151530877010898
622.0,RO509L1,Satu Mare,2010,0,70844,70844,0.0
623.0,RO510L1,Botosani,2010,64,37276,37340,0.1713979646491698
624.0,RO511L1,Ramnicu Valcea,2010,759,28414,29173,2.6017207692044013
625.0,RO512L1,Suceava,2010,18,39660,39678,0.04536518977771057
626.0,RO513L1,Drobeta-Turnu Severin,2010,2219,30715,32934,6.737717859962348
627.0,RS001L1,Beograd,2010,6015,307009,313024,1.921577898180331
628.0,RS002L1,Novi Sad,2010,2159,187284,189443,1.1396567833068523
629.0,RS003L1,NiÅ¡,2010,121,341443,341564,0.03542527901066857
630.0,RS004L1,Kragujevac,2010,0,144075,144075,0.0
631.0,RS005L1,Subotica,2010,59,160233,160292,0.036807825718064534
632.0,RS006L1,Novi Pazar,2010,1,140790,140791,0.0007102726736794256
633.0,RS008L1,Zrenjanin,2010,749,184382,185131,0.4045783796338809
634.0,RS009L1,Kraljevo,2010,2,176510,176512,0.0011330674401740391
635.0,RS011L0,ÄaÄak,2010,26,63661,63687,0.04082465809348847
636.0,RS012L1,KruÅ¡evac,2010,0,122649,122649,0.0
637.0,RS013L1,Leskovac,2010,31,166251,166282,0.018643028108875286
638.0,RS014L1,Valjevo,2010,0,141662,141662,0.0
639.0,RS015L1,Vranje,2010,10,195346,195356,0.005118859927516943
640.0,RS016L1,Smederevo,2010,2509,157715,160224,1.5659326942280807
641.0,SE001L1,Stockholm,2010,62692,693034,755726,8.295599198651363
642.0,SE002L1,GÃ¶teborg,2010,21346,413913,435259,4.904206460980704
643.0,SE003L1,MalmÃ¶,2010,2486,185530,188016,1.3222278954982556
644.0,SE004L1,JÃ¶nkÃ¶ping,2010,41950,305241,347191,12.082686475167847
645.0,SE005L1,UmeÃ¥,2010,27631,960618,988249,2.795955270382262
646.0,SE006L1,Uppsala,2010,11534,685993,697527,1.653556063062792
647.0,SE007L1,LinkÃ¶ping,2010,23140,400056,423196,5.467915575761586
648.0,SE008L1,Ãrebro,2010,24549,344048,368597,6.66011931730318
649.0,SE501L1,VÃ¤sterÃ¥s,2010,18582,271833,290415,6.398429833169775
650.0,SE502L1,NorrkÃ¶ping,2010,16099,295639,311738,5.164272562215707
651.0,SE503L1,Helsingborg,2010,1457,112965,114422,1.273356522347101
652.0,SE505L1,BorÃ¥s,2010,2295,95067,97362,2.3571824736550195
653.0,SI001L2,Ljubljana,2010,347,232940,233287,0.14874382198750896
654.0,SI002L1,Maribor,2010,756,216229,216985,0.34841118049634767
655.0,SK001L1,Bratislava,2010,1919,203022,204941,0.936367051980814
656.0,SK002L1,KoÅ¡ice,2010,18,177616,177634,0.010133195221635498
657.0,SK003L1,BanskÃ¡ Bystrica,2010,69,80811,80880,0.08531157270029674
658.0,SK004L1,Nitra,2010,2,87125,87127,0.0022954996728912964
659.0,SK005L1,PreÅ¡ov,2010,1,93298,93299,0.0010718228491194976
660.0,SK006L1,Å½ilina,2010,317,81131,81448,0.38920538257538556
661.0,SK007L1,Trnava,2010,103,74117,74220,0.13877661007814607
662.0,SK008L1,TrenÄÃ­n,2010,34,67389,67423,0.05042789552526586
739.0,UK001L3,London,2010,2352,695818,698170,0.33688070240772305
740.0,UK002L3,West Midlands urban area,2010,5,215304,215309,0.002322243844892689
741.0,UK003L2,Leeds,2010,1380,511047,512427,0.269306652459765
742.0,UK004L1,Glasgow,2010,8693,328991,337684,2.57430023335426
743.0,UK006L3,Liverpool,2010,584,99919,100503,0.5810771817756684
744.0,UK007L1,Edinburgh,2010,1072,174346,175418,0.6111117445188066
745.0,UK008L3,Greater Manchester,2010,408,311838,312246,0.13066620549182376
746.0,UK009L1,Cardiff,2010,223,84268,84491,0.2639334366973997
747.0,UK010L3,Sheffield,2010,148,125939,126087,0.11737926986921728
748.0,UK011L2,Bristol,2010,278,98107,98385,0.2825633988921075
749.0,UK012L2,Belfast,2010,20839,174306,195145,10.678726075482334
750.0,UK013L2,Newcastle upon Tyne,2010,7383,539325,546708,1.3504466735441953
751.0,UK014L1,Leicester,2010,72,139709,139781,0.051509146450519024
752.0,UK016L1,Aberdeen,2010,75399,578549,653948,11.529815826334817
753.0,UK017L2,Cambridge,2010,94,159525,159619,0.05889023236582111
754.0,UK018L3,Exeter,2010,1019,246707,247726,0.41134156285573575
755.0,UK019L3,Lincoln,2010,184,211359,211543,0.08697995206648294
756.0,UK023L1,Portsmouth,2010,295,20558,20853,1.4146645566585145
757.0,UK024L1,Worcester,2010,10,61192,61202,0.01633933531583935
758.0,UK025L3,Coventry,2010,9,81438,81447,0.011050130759880658
759.0,UK026L1,Kingston upon Hull,2010,2591,249107,251698,1.0294082591041647
760.0,UK027L1,Stoke-on-Trent,2010,3,88173,88176,0.003402286336418073
761.0,UK029L1,Nottingham,2010,39,90250,90289,0.04319463057515312
762.0,UK033L1,Guildford,2010,10,61681,61691,0.016209819908900813
763.0,UK050L1,Burnley,2010,32,27942,27974,0.11439193536855652
764.0,UK056L1,Hastings,2010,73,54677,54750,0.13333333333333333
765.0,UK515L1,Brighton and Hove,2010,342,42065,42407,0.8064706298488458
766.0,UK516L1,Plymouth,2010,1018,214757,215775,0.4717877418607346
767.0,UK517L1,Swansea,2010,373,83669,84042,0.44382570619452183
768.0,UK518L1,Derby,2010,39,68063,68102,0.05726704061554727
769.0,UK520L2,Southampton,2010,1323,152029,153352,0.862721060044864
770.0,UK528L1,Northampton,2010,642,153903,154545,0.41541298650878383
771.0,UK539L1,Bournemouth,2010,985,92808,93793,1.0501849818216713
772.0,UK546L1,Colchester,2010,627,68868,69495,0.9022231815238505
773.0,UK550L0,Dundee City,2010,15768,210648,226416,6.964172143311427
774.0,UK551L1,Falkirk,2010,343,29446,29789,1.1514317365470477
775.0,UK552L0,Reading,2010,15,21906,21921,0.06842753524018065
776.0,UK553L1,Blackpool,2010,60,48895,48955,0.12256153610458584
777.0,UK557L1,Blackburn with Darwen,2010,87,79467,79554,0.10935968021721096
778.0,UK558L1,Newport,2010,68,31632,31700,0.2145110410094637
779.0,UK559L2,Middlesbrough,2010,1596,60173,61769,2.583820362965241
780.0,UK560L1,Oxford,2010,101,192822,192923,0.05235249296351394
781.0,UK562L2,Preston,2010,30,25732,25762,0.11645058613461688
782.0,UK566L1,Norwich,2010,659,149581,150240,0.4386315228966986
783.0,UK568L1,Cheshire West and Chester,2010,313,135832,136145,0.22990194278159315
784.0,UK569L2,Ipswich,2010,1406,154240,155646,0.9033319198694474
785.0,UK571L1,Cheltenham,2010,4,46179,46183,0.008661195678063355
786.0,XK001L1,Pristina,2010,8,255799,255807,0.0031273577345420573
787.0,XK002L1,Prizren,2010,28,127605,127633,0.02193790007286517
788.0,XK003L1,MitrovicÃ«,2010,0,117914,117914,0.0
1.0,AL001L1,Tirana,2011,1627,165494,167121,0.9735461132951574
2.0,AL003L1,Elbasan,2011,670,125334,126004,0.5317291514555094
3.0,AL004L1,ShkodÃ«r,2011,7701,177628,185329,4.155312983936675
4.0,AL005L0,VlorÃ«,2011,2461,61272,63733,3.8614218693612417
5.0,AT001L3,Wien,2011,6612,911878,918490,0.7198771897353264
6.0,AT002L3,Graz,2011,56,291076,291132,0.019235260981273098
7.0,AT003L3,Linz,2011,836,358394,359230,0.23271998441110153
8.0,AT004L3,Salzburg,2011,643,136833,137476,0.46771800168756733
9.0,AT005L3,Innsbruck,2011,6172,206650,212822,2.9000761199500054
10.0,AT006L2,Klagenfurt,2011,1249,182011,183260,0.6815453454108916
11.0,BA001L1,Sarajevo,2011,1,263773,263774,0.00037911242199761917
12.0,BA002L1,Banja Luka,2011,31,275271,275302,0.011260361348628053
13.0,BA003L1,Mostar,2011,393,181954,182347,0.2155231509155621
14.0,BA004L1,Tuzla,2011,578,111683,112261,0.5148715938749877
15.0,BA005L1,Zenica,2011,1,86715,86716,0.0011531897227731907
16.0,BE001L2,Bruxelles / Brussel,2011,166,326485,326651,0.050818763757037325
17.0,BE002L2,Antwerpen,2011,4109,115103,119212,3.446800657651914
18.0,BE003L2,Gent,2011,449,101392,101841,0.4408833377519859
19.0,BE004L2,Charleroi,2011,177,109588,109765,0.16125358720903749
20.0,BE005L2,LiÃ¨ge,2011,229,141169,141398,0.1619542002008515
21.0,BE006L2,Brugge,2011,866,55673,56539,1.531686092785511
22.0,BE007L2,Namur,2011,4,84103,84107,0.004755846719060245
23.0,BE008L1,Leuven,2011,254,44822,45076,0.5634927677699885
24.0,BE009L1,Mons,2011,37,39163,39200,0.09438775510204082
25.0,BE010L1,Kortrijk,2011,8,22331,22339,0.03581180894399928
26.0,BE011L1,Oostende,2011,154,20778,20932,0.7357156506783872
27.0,BG001L2,Sofia,2011,2052,569722,571774,0.3588830551931358
28.0,BG002L2,Plovdiv,2011,201,276885,277086,0.07254065524782918
29.0,BG003L2,Varna,2011,3731,201067,204798,1.8217951347181123
30.0,BG004L2,Burgas,2011,5071,290829,295900,1.7137546468401488
31.0,BG005L1,Pleven,2011,1026,178050,179076,0.5729410976345239
32.0,BG006L2,Ruse,2011,2504,131513,134017,1.8684196781005395
33.0,BG007L2,Vidin,2011,1742,59222,60964,2.857424053539794
34.0,BG008L2,Stara Zagora,2011,8,132060,132068,0.006057485537753279
35.0,BG009L1,Sliven,2011,27,136747,136774,0.01974059397253864
36.0,BG010L1,Dobrich,2011,28,140310,140338,0.019951830580455757
37.0,BG011L1,Shumen,2011,61,94446,94507,0.06454548340334577
38.0,BG013L1,Yambol,2011,501,130305,130806,0.3830099536718499
39.0,BG014L1,Haskovo,2011,438,73530,73968,0.5921479558728099
40.0,BG015L1,Pazardzhik,2011,11,63811,63822,0.01723543605653223
41.0,BG016L1,Blagoevgrad,2011,3,135476,135479,0.0022143653259914823
42.0,BG017L1,Veliko Tarnovo,2011,0,88539,88539,0.0
43.0,BG018L1,Vratsa,2011,13,70544,70557,0.018424819649361508
44.0,CH001L2,ZÃ¼rich,2011,114,127603,127717,0.08925984794506604
45.0,CH002L2,GenÃ¨ve,2011,71,53826,53897,0.13173274950368297
46.0,CH003L2,Basel,2011,75,69345,69420,0.108038029386344
47.0,CH004L2,Bern,2011,0,78288,78288,0.0
48.0,CH005L2,Lausanne,2011,31,77474,77505,0.03999741952132121
49.0,CH006L1,Winterthur,2011,0,13291,13291,0.0
50.0,CH007L2,St. Gallen,2011,11,31898,31909,0.034473032686702806
51.0,CH008L2,Luzern,2011,15,29244,29259,0.05126627704296114
52.0,CH009L2,Lugano,2011,114,30511,30625,0.37224489795918364
53.0,CH010L1,Biel/Bienne,2011,4,9091,9095,0.0439802089059923
54.0,CY001L2,Lefkosia,2011,49,162579,162628,0.030130112895688316
55.0,CY501L2,Lemesos,2011,1108,124791,125899,0.8800705327286157
56.0,CZ001L2,Praha,2011,131,570431,570562,0.0229598185648536
57.0,CZ002L2,Brno,2011,136,267779,267915,0.05076236866170241
58.0,CZ003L2,Ostrava,2011,177,142489,142666,0.12406600030841265
59.0,CZ004L2,PlzeÅ,2011,115,195842,195957,0.058686344453119814
60.0,CZ005L2,ÃstÃ­ nad Labem,2011,163,35748,35911,0.4538999192447996
61.0,CZ006L2,Olomouc,2011,2,93562,93564,0.0021375742807062544
62.0,CZ007L2,Liberec,2011,0,61316,61316,0.0
63.0,CZ008L2,ÄeskÃ© BudÄjovice,2011,249,129155,129404,0.19242063614725974
64.0,CZ009L2,Hradec KrÃ¡lovÃ©,2011,14,79491,79505,0.017608955411609332
65.0,CZ010L2,Pardubice,2011,35,86322,86357,0.04052943015621201
66.0,CZ011L2,ZlÃ­n,2011,0,57952,57952,0.0
67.0,CZ013L2,Karlovy Vary,2011,81,46903,46984,0.1723991145922016
68.0,CZ014L2,Jihlava,2011,2,96025,96027,0.0020827475605819197
69.0,CZ016L2,Most,2011,289,27489,27778,1.040391676866585
70.0,CZ018L2,Chomutov-Jirkov,2011,704,44982,45686,1.5409534649564418
71.0,DE001L1,Berlin,2011,7239,1741026,1748265,0.41406766136712686
72.0,DE002L1,Hamburg,2011,5697,728477,734174,0.7759740878865228
73.0,DE003L1,MÃ¼nchen,2011,6627,543314,549941,1.2050383586602926
74.0,DE004L1,KÃ¶ln,2011,951,161679,162630,0.5847629588636782
75.0,DE005L1,Frankfurt am Main,2011,389,429942,430331,0.09039553274107605
76.0,DE007L1,Stuttgart,2011,89,365081,365170,0.024372210203466877
77.0,DE008L2,Leipzig,2011,3365,394324,397689,0.8461385655625375
78.0,DE009L2,Dresden,2011,4791,578405,583196,0.8215076920966535
79.0,DE011L1,DÃ¼sseldorf,2011,803,119514,120317,0.6674036088000865
80.0,DE012L1,Bremen,2011,871,588668,589539,0.14774255816833154
81.0,DE013L1,Hannover,2011,999,296313,297312,0.33601065547303843
82.0,DE014L1,NÃ¼rnberg,2011,227,293274,293501,0.07734215556335412
83.0,DE017L0,Bielefeld,2011,0,25883,25883,0.0
84.0,DE018L1,Halle an der Saale,2011,1889,155697,157586,1.1987105453530136
85.0,DE019L2,Magdeburg,2011,380,416654,417034,0.09111966889989785
86.0,DE020L1,Wiesbaden,2011,919,100519,101438,0.9059721209014373
87.0,DE021L1,GÃ¶ttingen,2011,9,238948,238957,0.0037663680076331723
88.0,DE025L1,Darmstadt,2011,50,78137,78187,0.06394924987529896
89.0,DE026L1,Trier,2011,29,121098,121127,0.023941813138276355
90.0,DE027L1,Freiburg im Breisgau,2011,1736,219460,221196,0.7848243187037741
91.0,DE028L1,Regensburg,2011,58,253604,253662,0.022865072419203505
92.0,DE029L0,Frankfurt (Oder),2011,1,14843,14844,0.006736728644570197
93.0,DE030L1,Weimar,2011,22,89006,89028,0.02471132677359932
94.0,DE031L1,Schwerin,2011,3854,486149,490003,0.786525796780836
95.0,DE032L1,Erfurt,2011,307,285205,285512,0.10752612849897727
96.0,DE033L1,Augsburg,2011,67,199867,199934,0.03351105864935429
97.0,DE034L1,Bonn,2011,469,128868,129337,0.36261858555556414
98.0,DE035L1,Karlsruhe,2011,897,124915,125812,0.7129685562585445
99.0,DE036L0,MÃ¶nchengladbach,2011,1,17022,17023,0.005874405216471833
100.0,DE037L1,Mainz,2011,760,69545,70305,1.0810041960031291
101.0,DE038L1,Ruhrgebiet,2011,2066,441686,443752,0.46557536642088376
102.0,DE039L1,Kiel,2011,2293,337469,339762,0.6748841836344265
103.0,DE040L1,SaarbrÃ¼cken,2011,13,153669,153682,0.008459025780507801
104.0,DE042L1,Koblenz,2011,616,91560,92176,0.6682867557715675
105.0,DE043L2,Rostock,2011,2660,359144,361804,0.7352046964654896
106.0,DE044L1,Kaiserslautern,2011,18,135509,135527,0.013281486345894175
107.0,DE045L1,Iserlohn,2011,178,105929,106107,0.16775519051523463
108.0,DE048L1,Wilhelmshaven,2011,631,73416,74047,0.8521614650154632
109.0,DE050L1,TÃ¼bingen,2011,3,52022,52025,0.005766458433445459
110.0,DE051L1,Villingen-Schwenningen,2011,263,102297,102560,0.25643525741029644
111.0,DE052L1,Flensburg,2011,984,204491,205475,0.47889037595814576
112.0,DE053L1,Marburg,2011,4,126238,126242,0.0031685176090366124
113.0,DE054L1,Konstanz,2011,139,81761,81900,0.16971916971916973
114.0,DE055L0,NeumÃ¼nster,2011,1,7175,7176,0.013935340022296544
115.0,DE056L0,Brandenburg an der Havel,2011,1711,21119,22830,7.4945247481384145
116.0,DE057L1,GieÃen,2011,0,85528,85528,0.0
117.0,DE058L1,LÃ¼neburg,2011,1,132501,132502,0.0007547055893495947
118.0,DE059L1,Bayreuth,2011,0,199920,199920,0.0
119.0,DE060L1,Celle,2011,3,155044,155047,0.0019348971602159346
120.0,DE061L1,Aschaffenburg,2011,305,147311,147616,0.20661716887058315
121.0,DE062L1,Bamberg,2011,29,122126,122155,0.023740329908722525
122.0,DE063L1,Plauen,2011,352,140936,141288,0.2491365154860993
123.0,DE064L1,Neubrandenburg,2011,15503,568488,583991,2.6546641985921013
124.0,DE065L1,Fulda,2011,3,138222,138225,0.002170374389582203
125.0,DE066L1,Kempten (AllgÃ¤u),2011,305,158862,159167,0.1916226353452663
126.0,DE067L1,Landshut,2011,63,141390,141453,0.04453776165934975
127.0,DE069L1,Rosenheim,2011,69,147694,147763,0.046696398963204586
128.0,DE071L1,Stralsund,2011,17079,321169,338248,5.049253801944135
129.0,DE072L1,Friedrichshafen,2011,98,66521,66619,0.14710518020384575
130.0,DE073L1,Offenburg,2011,551,185333,185884,0.29642142411396355
131.0,DE074L1,GÃ¶rlitz,2011,1754,209353,211107,0.8308582851350264
132.0,DE077L1,Schweinfurt,2011,46,201294,201340,0.022846925598490116
133.0,DE078L1,Greifswald,2011,1923,347871,349794,0.5497521398308719
134.0,DE079L1,Wetzlar,2011,3,106487,106490,0.00281716593107334
135.0,DE081L1,Passau,2011,75,159991,160066,0.04685567203528544
136.0,DE082L0,Dessau-RoÃlau,2011,0,24648,24648,0.0
137.0,DE083L1,Braunschweig-Salzgitter-Wolfsburg,2011,187,412657,412844,0.04529555958182752
138.0,DE084L1,Mannheim-Ludwigshafen,2011,531,203897,204428,0.25974915373627877
139.0,DE504L1,MÃ¼nster,2011,50,141713,141763,0.035270133955968765
140.0,DE505L0,Chemnitz,2011,0,22193,22193,0.0
141.0,DE507L1,Aachen,2011,104,70416,70520,0.1474758933635848
142.0,DE508L0,Krefeld,2011,114,13566,13680,0.8333333333333334
143.0,DE510L1,LÃ¼beck,2011,2075,160074,162149,1.279687201277837
144.0,DE513L1,Kassel,2011,68,139793,139861,0.048619700988838915
145.0,DE516L0,Solingen,2011,0,8954,8954,0.0
146.0,DE517L1,OsnabrÃ¼ck,2011,20,224110,224130,0.008923392673894616
147.0,DE520L1,Oldenburg (Oldenburg),2011,155,189814,189969,0.08159225978975518
148.0,DE522L1,Heidelberg,2011,207,116898,117105,0.17676444216728576
149.0,DE523L1,Paderborn,2011,170,124513,124683,0.13634577288002375
150.0,DE524L2,WÃ¼rzburg,2011,53,305876,305929,0.017324281124051658
151.0,DE527L1,Bremerhaven,2011,871,213608,214479,0.406100364138214
152.0,DE529L1,Heilbronn,2011,24,119960,119984,0.020002667022269636
153.0,DE530L0,Remscheid,2011,0,7369,7369,0.0
154.0,DE532L1,Ulm,2011,102,199206,199308,0.0511770726714432
155.0,DE533L1,Pforzheim,2011,32,67116,67148,0.04765592422708048
156.0,DE534L1,Ingolstadt,2011,425,284410,284835,0.1492091912861832
157.0,DE535L1,Gera,2011,3,99783,99786,0.003006433768264085
158.0,DE537L1,Reutlingen,2011,1,109281,109282,0.0009150637799454622
159.0,DE539L1,Cottbus,2011,777,181503,182280,0.42626728110599077
160.0,DE540L2,Siegen,2011,9,177555,177564,0.005068594985470028
161.0,DE542L1,Hildesheim,2011,25,120785,120810,0.02069365118781558
162.0,DE544L1,Zwickau,2011,19,94785,94804,0.02004134846630944
163.0,DE546L0,Wuppertal,2011,3,16830,16833,0.017822135091783996
164.0,DE547L2,Jena,2011,0,93068,93068,0.0
165.0,DE548L1,DÃ¼ren,2011,56,93982,94038,0.0595503945213637
166.0,DE549L1,Bocholt,2011,24,142241,142265,0.01686992584261765
167.0,DK001L2,KÃ¸benhavn,2011,12448,278775,291223,4.274387668556398
168.0,DK002L3,Ãrhus,2011,4951,457573,462524,1.0704309397998806
169.0,DK003L2,Odense,2011,7835,352004,359839,2.177362653853529
170.0,DK004L3,Aalborg,2011,3428,617031,620459,0.5524942018731294
171.0,EE001L1,Tallinn,2011,5584,433477,439061,1.2718050567005497
172.0,EE002L1,Tartu,2011,444,299198,299642,0.14817682434371682
173.0,EE003L0,Narva,2011,160,6729,6889,2.3225431847873423
174.0,EL001L1,Athina,2011,5180,304207,309387,1.674278492632205
175.0,EL002L1,Thessaloniki,2011,1540,140579,142119,1.0835989558046426
176.0,EL003L1,Patra,2011,671,50919,51590,1.300639658848614
177.0,EL004L1,Irakleio,2011,1081,60303,61384,1.7610452235110128
178.0,EL005L1,Larisa,2011,164,155355,155519,0.10545335296651857
179.0,EL006L1,Volos,2011,277,30539,30816,0.8988836967808931
180.0,EL007L1,Ioannina,2011,2007,130634,132641,1.513106807095845
181.0,EL008L1,Kavala,2011,326,35242,35568,0.9165542060278902
182.0,EL009L1,Kalamata,2011,270,44182,44452,0.6073967425537659
183.0,ES001L3,Madrid,2011,2282,785321,787603,0.28973988164087744
184.0,ES002L2,Barcelona,2011,1329,263278,264607,0.5022542865457074
185.0,ES003L3,Valencia,2011,3164,171956,175120,1.806761078117862
186.0,ES004L3,Sevilla,2011,4841,463585,468426,1.033460994906346
187.0,ES005L2,Zaragoza,2011,161,275977,276138,0.05830418124271198
188.0,ES006L2,MÃ¡laga,2011,939,151803,152742,0.6147621479357348
189.0,ES007L2,Murcia,2011,99,120037,120136,0.08240660584670706
190.0,ES008L2,Las Palmas,2011,3613,72983,76596,4.716956499033892
191.0,ES009L2,Valladolid,2011,230,115299,115529,0.1990842126219391
192.0,ES010L2,Palma de Mallorca,2011,2209,202025,204234,1.0816024755917233
193.0,ES011L2,Santiago de Compostela,2011,11,126245,126256,0.008712457229755418
194.0,ES012L2,Vitoria/Gasteiz,2011,549,158772,159321,0.34458734253488243
195.0,ES013L2,Oviedo,2011,0,93487,93487,0.0
196.0,ES014L3,Pamplona/IruÃ±a,2011,19,169495,169514,0.011208513751076607
197.0,ES015L2,Santander,2011,529,68954,69483,0.7613373055279709
198.0,ES016L2,Toledo,2011,458,92940,93398,0.49037452622111827
199.0,ES017L2,Badajoz,2011,874,217875,218749,0.3995446836328394
200.0,ES018L2,LogroÃ±o,2011,73,46065,46138,0.15822098920629415
201.0,ES019L3,Bilbao,2011,847,152474,153321,0.5524357393964298
202.0,ES020L2,CÃ³rdoba,2011,1346,185556,186902,0.7201635081486554
203.0,ES021L2,Alicante/Alacant,2011,418,35640,36058,1.1592434411226358
204.0,ES022L2,Vigo,2011,1096,135375,136471,0.8031010251262173
205.0,ES023L2,GijÃ³n,2011,656,52746,53402,1.228418411295457
206.0,ES025L3,Santa Cruz de Tenerife,2011,64689,2294,66983,96.57525043667796
207.0,ES026L2,CoruÃ±a (A),2011,825,75150,75975,1.085883514313919
208.0,ES028L1,Reus,2011,0,11534,11534,0.0
209.0,ES031L1,Lugo,2011,16,133995,134011,0.011939318414160032
210.0,ES033L1,Girona,2011,3,39618,39621,0.007571742257893541
211.0,ES034L1,CÃ¡ceres,2011,2066,236207,238273,0.8670726435643148
212.0,ES035L1,Torrevieja,2011,1721,7117,8838,19.472731387191672
213.0,ES039L1,AvilÃ©s,2011,306,18836,19142,1.5985790408525755
214.0,ES040L1,Talavera de la Reina,2011,556,82710,83266,0.6677395335431029
215.0,ES041L1,Palencia,2011,4,28377,28381,0.014093936083999859
216.0,ES043L1,Ferrol,2011,1105,45865,46970,2.3525654673195655
217.0,ES044L1,Pontevedra,2011,248,51368,51616,0.4804711717296962
218.0,ES046L1,Gandia,2011,253,17084,17337,1.4593066851243006
219.0,ES048L1,Guadalajara,2011,3,45380,45383,0.006610404777119186
220.0,ES050L1,Manresa,2011,3,29600,29603,0.010134108029591596
221.0,ES053L1,Ciudad Real,2011,641,95704,96345,0.6653173491099694
222.0,ES054L1,Benidorm,2011,333,20340,20673,1.610796691336526
223.0,ES057L1,Ponferrada,2011,255,62088,62343,0.40902747702227993
224.0,ES059L1,Zamora,2011,432,33748,34180,1.2638970157987126
225.0,ES070L1,Irun,2011,58,7184,7242,0.8008837337752003
226.0,ES072L1,Arrecife,2011,8368,50566,58934,14.198934401194558
227.0,ES501L3,Granada,2011,875,161749,162624,0.5380509641873278
228.0,ES505L1,Elche/Elx,2011,835,37983,38818,2.151063939409552
229.0,ES506L1,Cartagena,2011,1541,59407,60948,2.528384852661285
230.0,ES508L1,Jerez de la Frontera,2011,211,125895,126106,0.16731955656352593
231.0,ES510L1,Donostia-San SebastiÃ¡n,2011,186,33134,33320,0.5582232893157263
232.0,ES514L1,AlmerÃ­a,2011,744,39986,40730,1.8266633930763565
233.0,ES515L1,Burgos,2011,4,149387,149391,0.002677537468789954
234.0,ES516L1,Salamanca,2011,19,45625,45644,0.04162650074489528
235.0,ES519L1,Albacete,2011,23,245302,245325,0.009375318455110568
236.0,ES520L1,CastellÃ³n/CastellÃ³,2011,350,32444,32794,1.067268402756602
237.0,ES521L1,Huelva,2011,3908,93512,97420,4.011496612605214
238.0,ES522L1,CÃ¡diz,2011,1033,23800,24833,4.159787379696372
239.0,ES523L1,LeÃ³n,2011,3,118884,118887,0.0025234045774559033
240.0,ES525L1,Tarragona,2011,472,21268,21740,2.171113155473781
241.0,ES527L1,JaÃ©n,2011,31,99900,99931,0.03102140476929081
242.0,ES528L1,Lleida,2011,111,70564,70675,0.1570569508312699
243.0,ES529L1,Ourense,2011,343,64825,65168,0.5263319420574515
244.0,ES532L1,Algeciras,2011,613,41681,42294,1.4493781623870998
245.0,ES533L1,Marbella,2011,582,68623,69205,0.8409796979986995
246.0,ES537L1,Alcoy,2011,0,20529,20529,0.0
247.0,ES538L1,Ãvila,2011,472,53174,53646,0.8798419267046936
248.0,ES542L1,Cuenca,2011,78,164504,164582,0.047392789004872954
249.0,ES543L1,Eivissa,2011,2127,57275,59402,3.580687518938756
250.0,ES544L1,Linares,2011,13,25763,25776,0.05043451272501552
251.0,ES545L1,Lorca,2011,197,182010,182207,0.10811878797192204
252.0,ES546L1,MÃ©rida,2011,1081,127218,128299,0.8425630753162534
253.0,ES547L1,Sagunto,2011,206,15322,15528,1.3266357547655847
254.0,ES550L1,Puerto de la Cruz,2011,22063,5409,27472,80.3108619685498
255.0,ES552L1,Igualada,2011,0,25426,25426,0.0
256.0,FI001L3,Helsinki,2011,16606,474912,491518,3.3785130961633145
257.0,FI002L3,Tampere,2011,82198,606445,688643,11.936228205325545
258.0,FI003L4,Turku,2011,18928,447516,466444,4.057936215279862
259.0,FI004L4,Oulu,2011,8474,715347,723821,1.1707314377449674
260.0,FI007L2,Lahti,2011,30895,304508,335403,9.21130699486886
261.0,FI008L2,Kuopio,2011,129105,791301,920406,14.026962014589214
262.0,FI009L2,JyvÃ¤skylÃ¤,2011,48264,428678,476942,10.119469453308788
263.0,FR001L1,Paris,2011,1161,1208791,1209952,0.09595421967152416
264.0,FR003L2,Lyon,2011,231,367000,367231,0.06290318627784691
265.0,FR004L2,Toulouse,2011,538,524134,524672,0.10254025372041962
266.0,FR006L2,Strasbourg,2011,881,203002,203883,0.4321105732209159
267.0,FR007L2,Bordeaux,2011,4875,550879,555754,0.877186668921861
268.0,FR008L2,Nantes,2011,2315,314304,316619,0.731162690805037
269.0,FR009L2,Lille,2011,35,144418,144453,0.024229334108672024
270.0,FR010L2,Montpellier,2011,7319,216599,223918,3.268607258014095
271.0,FR011L2,Saint-Etienne,2011,97,180958,181055,0.053574880561155454
272.0,FR012L2,Le Havre,2011,1181,75257,76438,1.5450430414191894
273.0,FR013L2,Rennes,2011,175,381962,382137,0.04579509442948471
274.0,FR014L2,Amiens,2011,4,244791,244795,0.0016340203027022612
275.0,FR016L2,Nancy,2011,38,283471,283509,0.013403454564052642
276.0,FR017L2,Metz,2011,0,176930,176930,0.0
277.0,FR018L2,Reims,2011,45,243106,243151,0.01850701827259604
278.0,FR019L2,OrlÃ©ans,2011,805,291162,291967,0.2757160912020879
279.0,FR020L2,Dijon,2011,5,385756,385761,0.001296139319423166
280.0,FR021L2,Poitiers,2011,9,250433,250442,0.0035936464331062686
281.0,FR022L2,Clermont-Ferrand,2011,84,266042,266126,0.03156399600189384
282.0,FR023L2,Caen,2011,900,225373,226273,0.39774962103299993
283.0,FR024L2,Limoges,2011,70,317764,317834,0.022024075460775124
284.0,FR025L2,BesanÃ§on,2011,2,239034,239036,0.0008366940544520491
285.0,FR026L2,Grenoble,2011,1249,264599,265848,0.4698173392314405
286.0,FR027L2,Ajaccio,2011,1504,145505,147009,1.0230666149691516
289.0,FR032L2,Toulon,2011,2278,104778,107056,2.1278583171424303
290.0,FR034L2,Valenciennes,2011,27,78419,78446,0.03441858093465568
291.0,FR035L2,Tours,2011,242,284606,284848,0.08495759141717688
292.0,FR036L2,Angers,2011,308,230943,231251,0.13318861323842923
293.0,FR037L2,Brest,2011,620,134374,134994,0.4592796716891121
294.0,FR038L2,Le Mans,2011,20,224091,224111,0.008924149193926225
295.0,FR039L1,Avignon,2011,1502,85723,87225,1.721983376325595
296.0,FR040L2,Mulhouse,2011,79,129687,129766,0.06087881263196831
297.0,FR042L2,Dunkerque,2011,799,90326,91125,0.8768175582990398
298.0,FR043L2,Perpignan,2011,1490,181540,183030,0.8140741954870787
299.0,FR044L2,NÃ®mes,2011,1358,149133,150491,0.9023795442916852
300.0,FR045L2,Pau,2011,0,201759,201759,0.0
301.0,FR046L2,Bayonne,2011,775,101855,102630,0.7551398226639384
302.0,FR047L0,Annemasse,2011,2,7798,7800,0.02564102564102564
303.0,FR048L2,Annecy,2011,1819,117224,119043,1.5280192871483413
304.0,FR049L2,Lorient,2011,808,112374,113182,0.713894435510947
305.0,FR050L2,MontbÃ©liard,2011,15,123042,123057,0.01218947317096955
306.0,FR051L2,Troyes,2011,204,260746,260950,0.0781758957654723
307.0,FR052L2,Saint-Nazaire,2011,787,106348,107135,0.7345872030615579
308.0,FR053L2,La Rochelle,2011,283,111057,111340,0.2541763966229567
309.0,FR056L2,AngoulÃªme,2011,31,214261,214292,0.014466242323558507
310.0,FR057L2,Boulogne-sur-Mer,2011,173,68365,68538,0.2524147188421022
311.0,FR058L2,ChambÃ©ry,2011,2225,99464,101689,2.188043937889054
312.0,FR059L2,Chalon-sur-SaÃ´ne,2011,3,156355,156358,0.001918673812660689
313.0,FR060L2,Chartres,2011,18,161342,161360,0.01115518096182449
314.0,FR061L2,Niort,2011,15,178904,178919,0.008383682001352567
315.0,FR062L2,Calais,2011,102,50128,50230,0.20306589687437787
316.0,FR063L2,BÃ©ziers,2011,402,84741,85143,0.4721468588139953
317.0,FR064L2,Arras,2011,4,107559,107563,0.003718750871582236
318.0,FR065L2,Bourges,2011,117,250202,250319,0.04674035930153125
319.0,FR066L2,Saint-Brieuc,2011,9552,105629,115181,8.293034441444336
320.0,FR067L2,Quimper,2011,582,121340,121922,0.4773543741080363
321.0,FR068L2,Vannes,2011,39616,81418,121034,32.73129864335641
322.0,FR069L2,Cherbourg,2011,660,90058,90718,0.7275292665182214
323.0,FR073L2,Tarbes,2011,1,104328,104329,0.0009585062638384341
324.0,FR074L2,CompiÃ¨gne,2011,77,98660,98737,0.0779849499174575
325.0,FR076L2,Belfort,2011,10,65609,65619,0.015239488562763834
326.0,FR077L2,Roanne,2011,1,123199,123200,0.0008116883116883117
327.0,FR079L2,Saint-Quentin,2011,32,99342,99374,0.03220158190271097
328.0,FR082L2,Beauvais,2011,2,131140,131142,0.0015250644339723353
329.0,FR084L2,Creil,2011,20,29623,29643,0.06746955436359342
330.0,FR086L2,Evreux,2011,11,126559,126570,0.008690843011772142
331.0,FR090L2,ChÃ¢teauroux,2011,39,261138,261177,0.014932402164049669
332.0,FR093L2,Brive-la-Gaillarde,2011,6,132576,132582,0.004525501199257818
333.0,FR096L2,Albi,2011,69,134169,134238,0.0514012425691682
334.0,FR099L2,FrÃ©jus,2011,456,43957,44413,1.0267264089343209
335.0,FR104L2,ChÃ¢lons-en-Champagne,2011,45,152764,152809,0.029448527246431818
336.0,FR203L2,Marseille,2011,3111,422665,425776,0.7306658900454699
337.0,FR205L2,Nice,2011,1368,305972,307340,0.4451096505498796
338.0,FR207L2,Lens - LiÃ©vin,2011,20,25288,25308,0.0790263948158685
339.0,FR208L1,HÃ©nin - Carvin,2011,4,11594,11598,0.03448870494912916
340.0,FR209L2,Douai,2011,20,45064,45084,0.044361636057137784
341.0,FR214L1,Valence,2011,146,90815,90961,0.16050834973230285
342.0,FR215L2,Rouen,2011,1851,285275,287126,0.6446647116596895
343.0,FR304L1,Melun,2011,3,44833,44836,0.006691051833348202
344.0,FR324L1,Martigues,2011,1853,18603,20456,9.058466953461087
345.0,FR505L1,Charleville-MÃ©ziÃ¨res,2011,105,135264,135369,0.07756576468763159
346.0,FR506L1,Colmar,2011,97,101888,101985,0.09511202627837427
347.0,FR519L1,Cannes,2011,522,19614,20136,2.592371871275328
348.0,HR001L2,Grad Zagreb,2011,119,505749,505868,0.023523923236891838
349.0,HR002L2,Rijeka,2011,593,106641,107234,0.5529962511889885
350.0,HR003L2,Slavonski Brod,2011,430,97400,97830,0.4395379740365941
351.0,HR004L2,Osijek,2011,1312,171622,172934,0.7586709380457284
352.0,HR005L2,Split,2011,3119,335951,339070,0.9198690535877548
353.0,HR006L1,Pula - Pola,2011,1335,57562,58897,2.2666689305057983
354.0,HR007L1,Zadar,2011,2488,154012,156500,1.589776357827476
355.0,HU001L2,Budapest,2011,5751,633383,639134,0.8998113071750212
356.0,HU002L2,Miskolc,2011,29,164640,164669,0.017611086482580206
357.0,HU003L2,NyÃ­regyhÃ¡za,2011,52,168173,168225,0.030910982315351464
358.0,HU004L2,PÃ©cs,2011,204,185284,185488,0.10998016044164581
359.0,HU005L2,Debrecen,2011,377,201201,201578,0.18702437766026056
360.0,HU006L2,Szeged,2011,582,160351,160933,0.36164117986988376
361.0,HU007L2,GyÃµr,2011,126,204514,204640,0.061571540265832676
362.0,HU008L2,KecskemÃ©t,2011,79,182060,182139,0.04337346751656702
363.0,HU009L2,SzÃ©kesfehÃ©rvÃ¡r,2011,1271,299852,301123,0.4220866556191324
364.0,HU010L1,Szombathely,2011,12,134265,134277,0.008936750150807658
365.0,HU011L1,Szolnok,2011,692,143283,143975,0.48063899982635877
366.0,HU012L1,TatabÃ¡nya,2011,41,69789,69830,0.05871401976227982
367.0,HU013L1,VeszprÃ©m,2011,7147,124173,131320,5.4424307036247335
368.0,HU014L1,BÃ©kÃ©scsaba,2011,31,106132,106163,0.029200380546894868
369.0,HU015L1,KaposvÃ¡r,2011,118,145442,145560,0.08106622698543556
370.0,HU016L1,Eger,2011,63,100515,100578,0.06263795263377676
371.0,HU017L1,DunaÃºjvÃ¡ros,2011,724,60946,61670,1.1739905951029674
372.0,HU018L1,Zalaegerszeg,2011,120,139859,139979,0.08572714478600361
373.0,HU019L1,Sopron,2011,844,79826,80670,1.0462377587702987
374.0,IE001L1,Dublin,2011,6744,696858,703602,0.9584964226935114
375.0,IE002L1,Cork,2011,2682,326981,329663,0.813558088108159
376.0,IE003L1,Limerick,2011,95,156363,156458,0.06071917064004397
377.0,IE004L1,Galway,2011,1070,225213,226283,0.47285920727584485
378.0,IE005L1,Waterford,2011,1790,94067,95857,1.867364929008836
379.0,IS001L1,ReykjavÃ­k,2011,1297230,0,1297230,100.0
380.0,IT001L3,Roma,2011,8996,608220,617216,1.4575124429697222
381.0,IT002L3,Milano,2011,84,383961,384045,0.02187243682380971
382.0,IT003L3,Napoli,2011,3062,149880,152942,2.00206614272077
383.0,IT004L2,Torino,2011,161,170018,170179,0.09460626751831894
384.0,IT005L3,Palermo,2011,1832,148241,150073,1.2207392402364183
385.0,IT006L3,Genova,2011,752,120012,120764,0.6227021297737736
386.0,IT007L3,Firenze,2011,90,163681,163771,0.054954784424592874
387.0,IT008L3,Bari,2011,771,112658,113429,0.6797203537014344
388.0,IT009L1,Bologna,2011,47,185210,185257,0.02537016145138915
389.0,IT010L2,Catania,2011,873,60552,61425,1.4212454212454213
390.0,IT011L2,Venezia,2011,1863,65174,67037,2.7790623088742037
391.0,IT012L3,Verona,2011,57,73104,73161,0.0779103620781564
392.0,IT013L3,Cremona,2011,193,60204,60397,0.31955229564382337
393.0,IT014L3,Trento,2011,610,97577,98187,0.6212635073889619
394.0,IT015L1,Trieste,2011,350,21287,21637,1.6175994823681656
395.0,IT016L3,Perugia,2011,5691,125337,131028,4.343346460298562
396.0,IT017L3,Ancona,2011,583,43660,44243,1.3177225775828945
397.0,IT019L2,Pescara,2011,260,16183,16443,1.5812199720245699
398.0,IT020L3,Campobasso,2011,519,102316,102835,0.5046919823017455
399.0,IT021L2,Caserta,2011,1,9341,9342,0.010704345964461572
400.0,IT022L2,Taranto,2011,3464,103464,106928,3.23956307047733
401.0,IT023L2,Potenza,2011,91,138364,138455,0.06572532591816836
402.0,IT024L3,Catanzaro,2011,278,89805,90083,0.3086042871573993
403.0,IT025L3,Reggio di Calabria,2011,618,47630,48248,1.280882109102968
404.0,IT026L3,Sassari,2011,2350,150875,153225,1.5336922825909611
405.0,IT027L2,Cagliari,2011,4996,190296,195292,2.558220510824816
406.0,IT028L3,Padova,2011,14,61431,61445,0.02278460411750346
407.0,IT029L3,Brescia,2011,73,60196,60269,0.12112362906303406
408.0,IT030L3,Modena,2011,128,69140,69268,0.18478951319512618
409.0,IT031L3,Foggia,2011,4,89707,89711,0.004458762024723836
410.0,IT032L3,Salerno,2011,349,37490,37839,0.9223288141864214
411.0,IT033L2,Piacenza,2011,240,93887,94127,0.25497466189297435
412.0,IT034L1,Bolzano,2011,705,106051,106756,0.6603844280415152
413.0,IT035L2,Udine,2011,0,71830,71830,0.0
414.0,IT036L2,La Spezia,2011,687,42232,42919,1.6006896712411751
415.0,IT037L1,Lecce,2011,326,61184,61510,0.5299951227442692
416.0,IT038L1,Barletta,2011,228,14869,15097,1.5102338212889979
417.0,IT039L2,Pesaro,2011,141,25550,25691,0.5488303296874392
418.0,IT040L2,Como,2011,423,19318,19741,2.142748594296135
419.0,IT041L2,Pisa,2011,490,47563,48053,1.0197074064054272
420.0,IT042L1,Treviso,2011,34,24011,24045,0.14140153878145145
421.0,IT043L2,Varese,2011,469,23195,23664,1.981913455037187
422.0,IT045L2,Asti,2011,6,54830,54836,0.010941717120140054
423.0,IT046L2,Pavia,2011,21,36183,36204,0.058004640371229696
424.0,IT047L1,Massa,2011,234,11009,11243,2.081295028017433
425.0,IT048L2,Cosenza,2011,109,92370,92479,0.11786459628672455
426.0,IT052L1,Savona,2011,213,28492,28705,0.7420310050513848
427.0,IT054L1,Matera,2011,686,77103,77789,0.881872758359151
428.0,IT056L1,Acireale,2011,53,5935,5988,0.8851035404141616
429.0,IT057L2,Avellino,2011,4,39755,39759,0.010060615206619885
430.0,IT058L2,Pordenone,2011,39,37011,37050,0.10526315789473684
431.0,IT060L1,Lecco,2011,1404,28808,30212,4.647160068846816
432.0,IT061L0,Altamura,2011,0,42800,42800,0.0
433.0,IT064L1,Battipaglia,2011,54,6432,6486,0.8325624421831638
434.0,IT065L0,Bisceglie,2011,87,6857,6944,1.2528801843317972
435.0,IT066L1,Carpi,2011,4,20618,20622,0.01939676074095626
436.0,IT067L0,Cerignola,2011,128,58769,58897,0.21732855663276568
437.0,IT068L1,Gallarate,2011,0,5319,5319,0.0
438.0,IT069L1,Gela,2011,430,57465,57895,0.7427238967095604
439.0,IT073L1,Sassuolo,2011,0,24062,24062,0.0
440.0,IT501L2,Messina,2011,814,33629,34443,2.36332491362541
441.0,IT502L2,Prato,2011,8,40951,40959,0.01953172684880002
442.0,IT503L3,Parma,2011,113,113394,113507,0.09955333151259393
443.0,IT504L3,Livorno,2011,366,25448,25814,1.41783528317967
444.0,IT505L3,Reggio nell'Emilia,2011,2,69032,69034,0.0028971231567053914
445.0,IT506L2,Ravenna,2011,3440,77749,81189,4.237027183485448
446.0,IT507L2,Ferrara,2011,793,90690,91483,0.8668277166249467
447.0,IT508L3,Rimini,2011,296,32283,32579,0.9085607293041529
448.0,IT509L3,Siracusa,2011,554,33588,34142,1.6226348778630426
449.0,IT511L2,Bergamo,2011,1,18555,18556,0.0053890924768269025
450.0,IT512L3,ForlÃ¬,2011,4,72747,72751,0.005498206210223915
451.0,IT513L3,Latina,2011,533,65960,66493,0.801588137097138
452.0,IT514L2,Vicenza,2011,1,34981,34982,0.0028586130009719286
453.0,IT515L2,Terni,2011,151,102181,102332,0.14755892584919672
454.0,IT516L2,Novara,2011,2,54163,54165,0.0036924213052709313
455.0,IT518L1,Alessandria,2011,21,76893,76914,0.02730322178017006
456.0,IT519L1,Arezzo,2011,1,88626,88627,0.0011283243255441344
457.0,IT520L1,Grosseto,2011,436,119163,119599,0.3645515430731026
458.0,IT521L1,Brindisi,2011,832,63155,63987,1.3002641161485928
459.0,IT522L1,Trapani,2011,1016,49774,50790,2.0003937783028154
460.0,IT523L1,Ragusa,2011,272,52578,52850,0.5146641438032167
461.0,IT524L0,Andria,2011,0,39880,39880,0.0
462.0,IT525L0,Trani,2011,124,10255,10379,1.1947201079102032
463.0,IT526L1,L'Aquila,2011,469,139800,140269,0.3343575558391377
464.0,LT001L1,Vilnius,2011,1290,423279,424569,0.30383753877461617
465.0,LT002L1,Kaunas,2011,126,161925,162051,0.0777532998870726
466.0,LT003L1,PanevÄÅ¾ys,2011,37,222771,222808,0.016606225988294854
467.0,LT004L0,Alytus,2011,0,3959,3959,0.0
468.0,LT501L0,KlaipÄda,2011,97,8826,8923,1.0870783368822146
469.0,LT502L0,Å iauliai,2011,530,7515,8045,6.587942821628341
470.0,LU001L1,Luxembourg,2011,70,259645,259715,0.0269526211424061
471.0,LV001L1,RÄ«ga,2011,7900,608349,616249,1.2819493419056258
472.0,LV002L2,LiepÄja,2011,2072,269985,272057,0.7616051048125945
473.0,LV003L1,Jelgava,2011,9,166450,166459,0.00540673679404538
474.0,LV501L1,Daugavpils,2011,792,258883,259675,0.30499663040338887
475.0,ME001L1,Podgorica,2011,1008,183473,184481,0.5463977320157631
476.0,MK001L1,Skopje,2011,4,224349,224353,0.0017829046190601418
477.0,MK003L1,Bitola,2011,7,119655,119662,0.0058498102990088745
478.0,MK004L1,Tetovo,2011,0,105621,105621,0.0
479.0,MK005L1,Prilep,2011,58,86773,86831,0.066796420633184
480.0,MT001L1,Valletta,2011,1090,24866,25956,4.199414393589151
481.0,NL001L3,s' Gravenhage,2011,4012,38695,42707,9.394244503243028
482.0,NL002L3,Amsterdam,2011,70251,262706,332957,21.099120907504574
483.0,NL003L3,Rotterdam,2011,29885,187286,217171,13.761045443452394
484.0,NL004L3,Utrecht,2011,288,96999,97287,0.29603132998242315
485.0,NL005L3,Eindhoven,2011,146,144260,144406,0.1011038322507375
486.0,NL006L3,Tilburg,2011,64,43170,43234,0.14803164176342692
487.0,NL007L3,Groningen,2011,2651,205509,208160,1.2735395849346656
488.0,NL008L3,Enschede,2011,62,84894,84956,0.07297895381138472
489.0,NL009L3,Arnhem,2011,564,55334,55898,1.008980643314609
490.0,NL010L3,Heerlen,2011,8,33335,33343,0.023993042017814836
491.0,NL012L3,Breda,2011,1127,72243,73370,1.536050156739812
492.0,NL013L3,Nijmegen,2011,614,39222,39836,1.541319409579275
493.0,NL014L3,Apeldoorn,2011,9,71115,71124,0.012653956470389742
494.0,NL015L3,Leeuwarden,2011,566,110357,110923,0.5102638767433264
495.0,NL016L3,Sittard-Geleen,2011,8,22904,22912,0.034916201117318434
496.0,NL020L3,Roosendaal,2011,1,24573,24574,0.0040693415805322704
497.0,NL026L0,Alphen aan den Rijn,2011,8,13202,13210,0.06056018168054504
498.0,NL028L3,Bergen op Zoom,2011,1829,32952,34781,5.258618211092263
499.0,NL030L0,Gouda,2011,2,1786,1788,0.11185682326621924
500.0,NL032L3,MiddelburgÂ Â Â Â Â Â ,2011,1218,22170,23388,5.207798871216008
501.0,NL503L3,s-Hertogenbosch,2011,194,36665,36859,0.5263300686399522
502.0,NL504L3,Amersfoort,2011,2,12242,12244,0.01633453119895459
503.0,NL505L3,Maastricht,2011,23,20362,20385,0.11282805984792739
504.0,NL507L3,Leiden,2011,204,19577,19781,1.0312926545675143
505.0,NL511L3,Zwolle,2011,616,122404,123020,0.5007315883596163
506.0,NL512L3,Ede,2011,8,35257,35265,0.022685382106904864
507.0,NL513L3,Deventer,2011,8,25237,25245,0.031689443454149334
508.0,NL514L3,Alkmaar,2011,536,47256,47792,1.12152661533311
509.0,NL515L3,Venlo,2011,134,51102,51236,0.2615348583027559
510.0,NL519L3,Almelo,2011,1,42024,42025,0.002379535990481856
511.0,NL520L3,Lelystad,2011,58796,60046,118842,49.474091651099776
512.0,NL521L3,Oss,2011,45,33101,33146,0.13576298799251796
513.0,NL522L3,Assen,2011,139,70723,70862,0.196155908667551
514.0,NL524L3,Veenendaal,2011,1,8184,8185,0.012217470983506415
515.0,NL529L3,Soest,2011,5,7937,7942,0.06295643414756988
516.0,NO001L1,Oslo,2011,31312,715331,746643,4.193704354021936
517.0,NO002L1,Bergen,2011,30396,327347,357743,8.496602309479151
518.0,NO003L1,Trondheim,2011,13001,660255,673256,1.9310633696543364
519.0,NO004L1,Stavanger,2011,13007,276070,289077,4.49949321461064
520.0,NO005L1,Kristiansand,2011,7841,307621,315462,2.485560859945096
521.0,NO006L1,TromsÃ¸,2011,41082,333531,374613,10.966517446004275
522.0,PL001L2,Warszawa,2011,564,860679,861243,0.06548674415931392
523.0,PL002L2,ÅÃ³dÅº,2011,10,169490,169500,0.0058997050147492625
524.0,PL003L2,KrakÃ³w,2011,73,375675,375748,0.01942791445330381
525.0,PL004L2,WrocÅaw,2011,238,264462,264700,0.08991310918020401
526.0,PL005L2,PoznaÅ,2011,570,308758,309328,0.1842704184554906
527.0,PL006L2,GdaÅsk,2011,1390,262126,263516,0.52748220221922
528.0,PL007L2,Szczecin,2011,248,112812,113060,0.2193525561648682
529.0,PL008L2,Bydgoszcz,2011,1000,209136,210136,0.475882285757795
530.0,PL009L2,Lublin,2011,9,322775,322784,0.002788242292059086
531.0,PL010L2,Katowice,2011,152,394443,394595,0.03852050836934071
532.0,PL011L2,BiaÅystok,2011,0,223322,223322,0.0
533.0,PL012L2,Kielce,2011,9,224220,224229,0.004013753796342133
534.0,PL013L2,ToruÅ,2011,74,158859,158933,0.046560500336619834
535.0,PL014L2,Olsztyn,2011,2061,200483,202544,1.0175566790425785
536.0,PL015L2,RzeszÃ³w,2011,40,229309,229349,0.01744066902406376
537.0,PL016L2,Opole,2011,21,176595,176616,0.011890202473162114
538.0,PL017L2,GorzÃ³w Wielkopolski,2011,126,97294,97420,0.1293368918086635
539.0,PL018L2,Zielona GÃ³ra,2011,108,169176,169284,0.06379811441128518
540.0,PL019L2,Jelenia GÃ³ra,2011,100,83241,83341,0.11998896101558656
541.0,PL020L2,Nowy SÄcz,2011,339,130079,130418,0.2599334447698937
542.0,PL021L2,SuwaÅki,2011,658,71475,72133,0.9122038456739633
543.0,PL022L2,Konin,2011,569,117594,118163,0.48153821416179343
544.0,PL024L2,CzÄstochowa,2011,0,193898,193898,0.0
545.0,PL025L2,Radom,2011,0,68022,68022,0.0
546.0,PL026L2,PÅock,2011,1000,170075,171075,0.5845389449072045
547.0,PL027L2,Kalisz,2011,1,149022,149023,0.0006710373566496447
548.0,PL028L2,Koszalin,2011,113,129558,129671,0.08714361730841899
549.0,PL029L1,SÅupsk,2011,7656,227348,235004,3.257816888223179
550.0,PL030L1,JastrzÄbie-ZdrÃ³j,2011,1,29570,29571,0.003381691522099354
551.0,PL031L1,Siedlce,2011,9,126160,126169,0.007133289476812846
552.0,PL032L1,PiotrkÃ³w Trybunalski,2011,12,116910,116922,0.010263252424693385
553.0,PL033L1,Lubin,2011,255,93051,93306,0.27329432190855896
554.0,PL034L1,PiÅa,2011,95,52097,52192,0.18202023298589823
555.0,PL035L1,InowrocÅaw,2011,1,20127,20128,0.004968203497615262
556.0,PL036L1,Ostrowiec ÅwiÄtokrzyski,2011,0,61460,61460,0.0
557.0,PL037L1,Gniezno,2011,72,66499,66571,0.10815520271589732
558.0,PL038L1,Stargard SzczeciÅski,2011,38,36626,36664,0.10364390137464544
559.0,PL039L1,OstrÃ³w Wielkopolski,2011,9,84752,84761,0.010618090867262066
560.0,PL040L1,PrzemyÅl,2011,62,85027,85089,0.07286488265228172
561.0,PL041L1,ZamoÅÄ,2011,4,112703,112707,0.0035490253489135547
562.0,PL042L1,CheÅm,2011,0,46570,46570,0.0
563.0,PL043L1,Pabianice,2011,0,32959,32959,0.0
564.0,PL044L1,GÅogÃ³w,2011,107,63974,64081,0.16697617078385169
565.0,PL045L1,Stalowa Wola,2011,10,190303,190313,0.005254501794412363
566.0,PL046L1,TomaszÃ³w Mazowiecki,2011,267,18896,19163,1.3933100245264312
567.0,PL047L1,ÅomÅ¼a,2011,0,56002,56002,0.0
568.0,PL048L1,Leszno,2011,244,77328,77572,0.3145464858454081
569.0,PL049L1,Åwidnica,2011,5,47985,47990,0.010418837257762034
570.0,PL051L1,Tczew,2011,25,27099,27124,0.09216929656392862
571.0,PL052L1,EÅk,2011,12,40040,40052,0.02996105063417557
572.0,PL506L2,Bielsko-BiaÅa,2011,151,73284,73435,0.20562402124327636
573.0,PL508L1,Rybnik,2011,68,14813,14881,0.45695853773267925
574.0,PL511L2,WaÅbrzych,2011,1,51509,51510,0.0019413706076490003
575.0,PL512L2,ElblÄg,2011,18,96457,96475,0.01865768333765224
576.0,PL513L2,WÅocÅawek,2011,963,121516,122479,0.7862572359343234
577.0,PL514L2,TarnÃ³w,2011,121,125206,125327,0.09654743191810225
578.0,PL516L2,Legnica,2011,65,56435,56500,0.1150442477876106
579.0,PL517L2,GrudziÄdz,2011,76,54967,55043,0.1380738695201933
580.0,PT001L3,Lisboa,2011,7597,431684,439281,1.7294169335801004
581.0,PT002L2,Porto,2011,1212,94528,95740,1.265928556507207
582.0,PT003L1,Braga,2011,44,49305,49349,0.08916087458712435
583.0,PT004L2,Funchal,2011,35962,0,35962,100.0
584.0,PT005L2,Coimbra,2011,436,162351,162787,0.2678346551014516
585.0,PT007L1,Ponta Delgada,2011,55294,0,55294,100.0
586.0,PT008L2,Aveiro,2011,2141,41189,43330,4.941149319178399
587.0,PT009L1,Faro,2011,2533,46617,49150,5.153611393692778
588.0,PT014L1,Viseu,2011,5,70869,70874,0.007054773259587437
589.0,PT016L0,Viana do Castelo,2011,430,31822,32252,1.3332506511224111
590.0,PT019L0,PÃ³voa de Varzim,2011,58,8348,8406,0.6899833452295978
591.0,PT505L1,GuimarÃ£es,2011,0,26541,26541,0.0
592.0,RO001L1,BucureÅti,2011,513,107329,107842,0.47569592552066914
593.0,RO002L1,Cluj-Napoca,2011,8,59294,59302,0.013490270142659607
594.0,RO003L1,TimiÅoara,2011,34,23620,23654,0.1437389025112032
595.0,RO004L1,Craiova,2011,64,34332,34396,0.18606814745900685
596.0,RO005L1,BrÄila,2011,1228,22301,23529,5.219091334098347
597.0,RO006L1,Oradea,2011,18,20321,20339,0.08849992625006146
598.0,RO007L1,BacÄu,2011,117,21976,22093,0.5295795048205314
599.0,RO008L1,Arad,2011,8,51600,51608,0.015501472639900789
600.0,RO009L1,Sibiu,2011,0,56340,56340,0.0
601.0,RO010L1,TÃ¢rgu MureÅ,2011,9,13731,13740,0.06550218340611354
602.0,RO011L1,Piatra NeamÅ£,2011,16,14983,14999,0.10667377825188346
603.0,RO012L1,CÇlÇraÅi,2011,493,24051,24544,2.008637548891786
604.0,RO013L1,Giurgiu,2011,543,10407,10950,4.958904109589041
605.0,RO014L1,Alba Iulia,2011,2,26000,26002,0.007691716021844474
606.0,RO015L1,FocÅani,2011,0,27102,27102,0.0
607.0,RO016L1,TÃ¢rgu Jiu,2011,14,24508,24522,0.05709159122420683
608.0,RO017L1,Tulcea,2011,1417,39530,40947,3.4605709820011232
609.0,RO018L1,TÃ¢rgoviÅte,2011,1,20256,20257,0.004936565137976996
610.0,RO019L1,Slatina,2011,114,7009,7123,1.6004492489119753
611.0,RO020L1,BÃ¢rlad,2011,74,26245,26319,0.28116569778487027
612.0,RO021L1,Roman,2011,0,14390,14390,0.0
613.0,RO022L1,BistriÅ£a,2011,0,42631,42631,0.0
614.0,RO501L1,Constanta,2011,4703,54648,59351,7.924045087698607
615.0,RO502L1,Iasi,2011,70,79866,79936,0.08757005604483586
616.0,RO503L1,Galati,2011,1043,40189,41232,2.5295886689949554
617.0,RO504L1,Brasov,2011,1243,97260,98503,1.26189050079693
618.0,RO505L1,Ploiesti,2011,3,34334,34337,0.008736931007368144
619.0,RO506L1,Pitesti,2011,24,24860,24884,0.09644751647645072
620.0,RO507L1,Baia Mare,2011,10,52531,52541,0.019032755371995204
621.0,RO508L1,Buzau,2011,17,38523,38540,0.04411001556824079
622.0,RO509L1,Satu Mare,2011,1,70843,70844,0.0014115521427361527
623.0,RO510L1,Botosani,2011,19,37321,37340,0.05088377075522228
624.0,RO511L1,Ramnicu Valcea,2011,505,28668,29173,1.7310526857025332
625.0,RO512L1,Suceava,2011,42,39636,39678,0.10585210948132466
626.0,RO513L1,Drobeta-Turnu Severin,2011,2075,30859,32934,6.300479747373535
627.0,RS001L1,Beograd,2011,5877,307147,313024,1.8774918217133512
628.0,RS002L1,Novi Sad,2011,2223,187220,189443,1.1734400320940863
629.0,RS003L1,NiÅ¡,2011,4,341560,341564,0.0011710836036584653
630.0,RS004L1,Kragujevac,2011,352,143723,144075,0.24431719590491063
631.0,RS005L1,Subotica,2011,67,160225,160292,0.04179871734085294
632.0,RS006L1,Novi Pazar,2011,7,140784,140791,0.0049719087157559785
633.0,RS008L1,Zrenjanin,2011,699,184432,185131,0.3775704771216058
634.0,RS009L1,Kraljevo,2011,0,176512,176512,0.0
635.0,RS011L0,ÄaÄak,2011,1,63686,63687,0.0015701791574418641
636.0,RS012L1,KruÅ¡evac,2011,1,122648,122649,0.0008153348172427007
637.0,RS013L1,Leskovac,2011,0,166282,166282,0.0
638.0,RS014L1,Valjevo,2011,0,141662,141662,0.0
639.0,RS015L1,Vranje,2011,1,195355,195356,0.0005118859927516943
640.0,RS016L1,Smederevo,2011,1940,158284,160224,1.2108048731775516
641.0,SE001L1,Stockholm,2011,65613,690113,755726,8.68211494642238
642.0,SE002L1,GÃ¶teborg,2011,15384,419875,435259,3.534447306086721
643.0,SE003L1,MalmÃ¶,2011,2726,185290,188016,1.449876606246277
644.0,SE004L1,JÃ¶nkÃ¶ping,2011,41883,305308,347191,12.063388739915492
645.0,SE005L1,UmeÃ¥,2011,25083,963166,988249,2.5381255129021127
646.0,SE006L1,Uppsala,2011,12725,684802,697527,1.8243021417092098
647.0,SE007L1,LinkÃ¶ping,2011,22430,400766,423196,5.300144613843231
648.0,SE008L1,Ãrebro,2011,25885,342712,368597,7.022574790353693
649.0,SE501L1,VÃ¤sterÃ¥s,2011,18603,271812,290415,6.405660864624761
650.0,SE502L1,NorrkÃ¶ping,2011,15563,296175,311738,4.99233330553221
651.0,SE503L1,Helsingborg,2011,615,113807,114422,0.537484050270053
652.0,SE505L1,BorÃ¥s,2011,1370,95992,97362,1.4071198208746738
653.0,SI001L2,Ljubljana,2011,353,232934,233287,0.15131576127259555
654.0,SI002L1,Maribor,2011,443,216542,216985,0.20416157798926193
655.0,SK001L1,Bratislava,2011,934,204007,204941,0.45574092055762394
656.0,SK002L1,KoÅ¡ice,2011,9,177625,177634,0.005066597610817749
657.0,SK003L1,BanskÃ¡ Bystrica,2011,1,80879,80880,0.0012363996043521265
658.0,SK004L1,Nitra,2011,0,87127,87127,0.0
659.0,SK005L1,PreÅ¡ov,2011,4,93295,93299,0.0042872913964779906
660.0,SK006L1,Å½ilina,2011,15,81433,81448,0.01841665848148512
661.0,SK007L1,Trnava,2011,18,74202,74220,0.024252223120452707
662.0,SK008L1,TrenÄÃ­n,2011,0,67423,67423,0.0
739.0,UK001L3,London,2011,754,697416,698170,0.10799661973444864
740.0,UK002L3,West Midlands urban area,2011,57,215252,215309,0.026473579831776655
741.0,UK003L2,Leeds,2011,393,512034,512427,0.07669385102658524
742.0,UK004L1,Glasgow,2011,2367,335317,337684,0.7009511851316615
743.0,UK006L3,Liverpool,2011,743,99760,100503,0.7392814144851397
744.0,UK007L1,Edinburgh,2011,1546,173872,175418,0.88132346737507
745.0,UK008L3,Greater Manchester,2011,982,311264,312246,0.3144956220415954
746.0,UK009L1,Cardiff,2011,152,84339,84491,0.17990081783858636
747.0,UK010L3,Sheffield,2011,91,125996,126087,0.07217238890607279
748.0,UK011L2,Bristol,2011,190,98195,98385,0.19311886974640444
749.0,UK012L2,Belfast,2011,20562,174583,195145,10.536780342822004
750.0,UK013L2,Newcastle upon Tyne,2011,2529,544179,546708,0.46258697513114866
751.0,UK014L1,Leicester,2011,695,139086,139781,0.49720634420987114
752.0,UK016L1,Aberdeen,2011,27130,626818,653948,4.14864790472637
753.0,UK017L2,Cambridge,2011,0,159619,159619,0.0
754.0,UK018L3,Exeter,2011,1585,246141,247726,0.6398198009090689
755.0,UK019L3,Lincoln,2011,577,210966,211543,0.2727577844693514
756.0,UK023L1,Portsmouth,2011,388,20465,20853,1.8606435524864529
757.0,UK024L1,Worcester,2011,2,61200,61202,0.0032678670631678705
758.0,UK025L3,Coventry,2011,28,81419,81447,0.03437818458629538
759.0,UK026L1,Kingston upon Hull,2011,381,251317,251698,0.15137188217625885
760.0,UK027L1,Stoke-on-Trent,2011,6,88170,88176,0.006804572672836146
761.0,UK029L1,Nottingham,2011,20,90269,90289,0.022151092602642627
762.0,UK033L1,Guildford,2011,0,61691,61691,0.0
763.0,UK050L1,Burnley,2011,70,27904,27974,0.2502323586187174
764.0,UK056L1,Hastings,2011,118,54632,54750,0.21552511415525114
765.0,UK515L1,Brighton and Hove,2011,316,42091,42407,0.7451599971702785
766.0,UK516L1,Plymouth,2011,1105,214670,215775,0.5121075194067894
767.0,UK517L1,Swansea,2011,437,83605,84042,0.5199781061850027
768.0,UK518L1,Derby,2011,61,68041,68102,0.08957152506534316
769.0,UK520L2,Southampton,2011,8249,145103,153352,5.379127758359852
770.0,UK528L1,Northampton,2011,86,154459,154545,0.055647222491830864
771.0,UK539L1,Bournemouth,2011,1374,92419,93793,1.4649280863177423
772.0,UK546L1,Colchester,2011,576,68919,69495,0.8288366069501403
773.0,UK550L0,Dundee City,2011,1107,225309,226416,0.48892304430782274
774.0,UK551L1,Falkirk,2011,49,29740,29789,0.16449024807814966
775.0,UK552L0,Reading,2011,0,21921,21921,0.0
776.0,UK553L1,Blackpool,2011,66,48889,48955,0.13481768971504443
777.0,UK557L1,Blackburn with Darwen,2011,96,79458,79554,0.12067275058450865
778.0,UK558L1,Newport,2011,78,31622,31700,0.24605678233438488
779.0,UK559L2,Middlesbrough,2011,918,60851,61769,1.4861823892243682
780.0,UK560L1,Oxford,2011,35,192888,192923,0.018141953007158297
781.0,UK562L2,Preston,2011,38,25724,25762,0.1475040757705147
782.0,UK566L1,Norwich,2011,19,150221,150240,0.012646432374866878
783.0,UK568L1,Cheshire West and Chester,2011,501,135644,136145,0.3679900106504095
784.0,UK569L2,Ipswich,2011,1451,154195,155646,0.9322436811739461
785.0,UK571L1,Cheltenham,2011,8,46175,46183,0.01732239135612671
786.0,XK001L1,Pristina,2011,1,255806,255807,0.00039091971681775716
787.0,XK002L1,Prizren,2011,1,127632,127633,0.0007834964311737559
788.0,XK003L1,MitrovicÃ«,2011,0,117914,117914,0.0
1.0,AL001L1,Tirana,2014,1621,165500,167121,0.9699559002160112
2.0,AL003L1,Elbasan,2014,619,125385,126004,0.49125424589695565
3.0,AL004L1,ShkodÃ«r,2014,7630,177699,185329,4.117002735675475
4.0,AL005L0,VlorÃ«,2014,2540,61193,63733,3.985376492554878
5.0,AT001L3,Wien,2014,6042,912448,918490,0.6578188113098673
6.0,AT002L3,Graz,2014,306,290826,291132,0.105106961790528
7.0,AT003L3,Linz,2014,2124,357106,359230,0.5912646493889708
8.0,AT004L3,Salzburg,2014,2851,134625,137476,2.073816520701795
9.0,AT005L3,Innsbruck,2014,31316,181506,212822,14.714644162727538
10.0,AT006L2,Klagenfurt,2014,4143,179117,183260,2.2607224708065043
11.0,BA001L1,Sarajevo,2014,15,263759,263774,0.0056866863299642875
12.0,BA002L1,Banja Luka,2014,363,274939,275302,0.1318551990178059
13.0,BA003L1,Mostar,2014,1967,180380,182347,1.078712564506134
14.0,BA004L1,Tuzla,2014,365,111896,112261,0.3251351760629248
15.0,BA005L1,Zenica,2014,4,86712,86716,0.004612758891092763
16.0,BE001L2,Bruxelles / Brussel,2014,92,326559,326651,0.028164616058117074
17.0,BE002L2,Antwerpen,2014,4504,114708,119212,3.7781431399523537
18.0,BE003L2,Gent,2014,368,101473,101841,0.3613475908524072
19.0,BE004L2,Charleroi,2014,331,109434,109765,0.3015533184530588
20.0,BE005L2,LiÃ¨ge,2014,115,141283,141398,0.0813307118912573
21.0,BE006L2,Brugge,2014,894,55645,56539,1.5812094306584836
22.0,BE007L2,Namur,2014,17,84090,84107,0.02021234855600604
23.0,BE008L1,Leuven,2014,3,45073,45076,0.006655426390984115
24.0,BE009L1,Mons,2014,62,39138,39200,0.15816326530612246
25.0,BE010L1,Kortrijk,2014,32,22307,22339,0.14324723577599713
26.0,BE011L1,Oostende,2014,185,20747,20932,0.8838142556850755
27.0,BG001L2,Sofia,2014,2944,568830,571774,0.5148887497507757
28.0,BG002L2,Plovdiv,2014,212,276874,277086,0.07651054185343178
29.0,BG003L2,Varna,2014,3736,201062,204798,1.8242365648102035
30.0,BG004L2,Burgas,2014,5129,290771,295900,1.7333558634673876
31.0,BG005L1,Pleven,2014,1040,178036,179076,0.5807590073488351
32.0,BG006L2,Ruse,2014,2485,131532,134017,1.8542423722363581
33.0,BG007L2,Vidin,2014,1817,59147,60964,2.9804474771996587
34.0,BG008L2,Stara Zagora,2014,0,132068,132068,0.0
35.0,BG009L1,Sliven,2014,15,136759,136774,0.010966996651410356
36.0,BG010L1,Dobrich,2014,17,140321,140338,0.012113611423848139
37.0,BG011L1,Shumen,2014,43,94464,94507,0.04549927518596506
38.0,BG013L1,Yambol,2014,187,130619,130806,0.14295980306713757
39.0,BG014L1,Haskovo,2014,381,73587,73968,0.5150876054510058
40.0,BG015L1,Pazardzhik,2014,19,63803,63822,0.029770298643101125
41.0,BG016L1,Blagoevgrad,2014,47,135432,135479,0.03469172344053322
42.0,BG017L1,Veliko Tarnovo,2014,5,88534,88539,0.005647228904776426
43.0,BG018L1,Vratsa,2014,147,70410,70557,0.2083421914197032
44.0,CH001L2,ZÃ¼rich,2014,104,127613,127717,0.08143003672181465
45.0,CH002L2,GenÃ¨ve,2014,192,53705,53897,0.356235040911368
46.0,CH003L2,Basel,2014,40,69380,69420,0.05762028233938346
47.0,CH004L2,Bern,2014,5,78283,78288,0.006386674841610465
48.0,CH005L2,Lausanne,2014,2,77503,77505,0.0025804786787949167
49.0,CH006L1,Winterthur,2014,0,13291,13291,0.0
50.0,CH007L2,St. Gallen,2014,57,31852,31909,0.17863298755836912
51.0,CH008L2,Luzern,2014,1,29258,29259,0.0034177518028640757
52.0,CH009L2,Lugano,2014,85,30540,30625,0.27755102040816326
53.0,CH010L1,Biel/Bienne,2014,3,9092,9095,0.032985156679494226
54.0,CY001L2,Lefkosia,2014,38,162590,162628,0.02336621000073788
55.0,CY501L2,Lemesos,2014,1008,124891,125899,0.800641784287405
56.0,CZ001L2,Praha,2014,415,570147,570562,0.07273530308713164
57.0,CZ002L2,Brno,2014,1047,266868,267915,0.3907955881529589
58.0,CZ003L2,Ostrava,2014,577,142089,142666,0.4044411422483282
59.0,CZ004L2,PlzeÅ,2014,315,195642,195957,0.16074955219767603
60.0,CZ005L2,ÃstÃ­ nad Labem,2014,92,35819,35911,0.2561889114755924
61.0,CZ006L2,Olomouc,2014,94,93470,93564,0.10046599119319397
62.0,CZ007L2,Liberec,2014,40,61276,61316,0.06523582751647204
63.0,CZ008L2,ÄeskÃ© BudÄjovice,2014,964,128440,129404,0.7449537881363791
64.0,CZ009L2,Hradec KrÃ¡lovÃ©,2014,52,79453,79505,0.06540469152883467
65.0,CZ010L2,Pardubice,2014,29,86328,86357,0.03358152784371852
66.0,CZ011L2,ZlÃ­n,2014,68,57884,57952,0.11733848702374379
67.0,CZ013L2,Karlovy Vary,2014,71,46913,46984,0.1511152732845224
68.0,CZ014L2,Jihlava,2014,36,95991,96027,0.03748945609047455
69.0,CZ016L2,Most,2014,25,27753,27778,0.08999928000575995
70.0,CZ018L2,Chomutov-Jirkov,2014,401,45285,45686,0.8777305958061551
71.0,DE001L1,Berlin,2014,12714,1735551,1748265,0.7272352875565203
72.0,DE002L1,Hamburg,2014,11249,722925,734174,1.5321980892812874
73.0,DE003L1,MÃ¼nchen,2014,4244,545697,549941,0.771719148054064
74.0,DE004L1,KÃ¶ln,2014,727,161903,162630,0.4470269937895837
75.0,DE005L1,Frankfurt am Main,2014,320,430011,430331,0.07436136369445845
76.0,DE007L1,Stuttgart,2014,48,365122,365170,0.01314456280636416
77.0,DE008L2,Leipzig,2014,2464,395225,397689,0.6195796212618403
78.0,DE009L2,Dresden,2014,7691,575505,583196,1.3187676184335968
79.0,DE011L1,DÃ¼sseldorf,2014,1055,119262,120317,0.8768503204036006
80.0,DE012L1,Bremen,2014,1612,587927,589539,0.27343398825183746
81.0,DE013L1,Hannover,2014,2652,294660,297312,0.8919922505650629
82.0,DE014L1,NÃ¼rnberg,2014,125,293376,293501,0.04258929271109809
83.0,DE017L0,Bielefeld,2014,0,25883,25883,0.0
84.0,DE018L1,Halle an der Saale,2014,835,156751,157586,0.5298694046425444
85.0,DE019L2,Magdeburg,2014,243,416791,417034,0.05826863037546099
86.0,DE020L1,Wiesbaden,2014,569,100869,101438,0.5609337723535559
87.0,DE021L1,GÃ¶ttingen,2014,5,238952,238957,0.002092426670907318
88.0,DE025L1,Darmstadt,2014,7,78180,78187,0.008952894982541855
89.0,DE026L1,Trier,2014,59,121068,121127,0.04870920603994155
90.0,DE027L1,Freiburg im Breisgau,2014,149,221047,221196,0.06736107343713268
91.0,DE028L1,Regensburg,2014,325,253337,253662,0.12812325062484725
92.0,DE029L0,Frankfurt (Oder),2014,0,14844,14844,0.0
93.0,DE030L1,Weimar,2014,25,89003,89028,0.028081053151817408
94.0,DE031L1,Schwerin,2014,7536,482467,490003,1.5379497676544838
95.0,DE032L1,Erfurt,2014,347,285165,285512,0.12153604752164532
96.0,DE033L1,Augsburg,2014,54,199880,199934,0.02700891294127062
97.0,DE034L1,Bonn,2014,566,128771,129337,0.43761645932718407
98.0,DE035L1,Karlsruhe,2014,386,125426,125812,0.3068069818459288
99.0,DE036L0,MÃ¶nchengladbach,2014,0,17023,17023,0.0
100.0,DE037L1,Mainz,2014,441,69864,70305,0.6272669084702368
101.0,DE038L1,Ruhrgebiet,2014,1902,441850,443752,0.4286177865113847
102.0,DE039L1,Kiel,2014,11307,328455,339762,3.3279177777385343
103.0,DE040L1,SaarbrÃ¼cken,2014,28,153654,153682,0.01821944014263219
104.0,DE042L1,Koblenz,2014,710,91466,92176,0.7702655788925533
105.0,DE043L2,Rostock,2014,2101,359703,361804,0.580701153110524
106.0,DE044L1,Kaiserslautern,2014,3,135524,135527,0.0022135810576490297
107.0,DE045L1,Iserlohn,2014,171,105936,106107,0.16115807628148945
108.0,DE048L1,Wilhelmshaven,2014,553,73494,74047,0.7468229637932664
109.0,DE050L1,TÃ¼bingen,2014,1,52024,52025,0.0019221528111484862
110.0,DE051L1,Villingen-Schwenningen,2014,3,102557,102560,0.0029251170046801873
111.0,DE052L1,Flensburg,2014,1251,204224,205475,0.6088331913858134
112.0,DE053L1,Marburg,2014,6,126236,126242,0.004752776413554918
113.0,DE054L1,Konstanz,2014,139,81761,81900,0.16971916971916973
114.0,DE055L0,NeumÃ¼nster,2014,94,7082,7176,1.309921962095875
115.0,DE056L0,Brandenburg an der Havel,2014,617,22213,22830,2.7025843188786687
116.0,DE057L1,GieÃen,2014,0,85528,85528,0.0
117.0,DE058L1,LÃ¼neburg,2014,72,132430,132502,0.054338802433170824
118.0,DE059L1,Bayreuth,2014,4,199916,199920,0.0020008003201280513
119.0,DE060L1,Celle,2014,26,155021,155047,0.016769108721871432
120.0,DE061L1,Aschaffenburg,2014,110,147506,147616,0.07451766746152177
121.0,DE062L1,Bamberg,2014,78,122077,122155,0.06385330113380541
122.0,DE063L1,Plauen,2014,217,141071,141288,0.15358699960364644
123.0,DE064L1,Neubrandenburg,2014,14170,569821,583991,2.42640725627621
124.0,DE065L1,Fulda,2014,0,138225,138225,0.0
125.0,DE066L1,Kempten (AllgÃ¤u),2014,826,158341,159167,0.5189517927711146
126.0,DE067L1,Landshut,2014,118,141335,141453,0.08341993453655985
127.0,DE069L1,Rosenheim,2014,14,147749,147763,0.009474631673693685
128.0,DE071L1,Stralsund,2014,18350,319898,338248,5.425013599489132
129.0,DE072L1,Friedrichshafen,2014,97,66522,66619,0.14560410693645956
130.0,DE073L1,Offenburg,2014,287,185597,185884,0.15439736609928773
131.0,DE074L1,GÃ¶rlitz,2014,1831,209276,211107,0.867332679636393
132.0,DE077L1,Schweinfurt,2014,47,201293,201340,0.023343597894109464
133.0,DE078L1,Greifswald,2014,4136,345658,349794,1.1824102185857963
134.0,DE079L1,Wetzlar,2014,83,106407,106490,0.07794159075969574
135.0,DE081L1,Passau,2014,851,159215,160066,0.5316556920270389
136.0,DE082L0,Dessau-RoÃlau,2014,0,24648,24648,0.0
137.0,DE083L1,Braunschweig-Salzgitter-Wolfsburg,2014,218,412626,412844,0.05280444913817326
138.0,DE084L1,Mannheim-Ludwigshafen,2014,406,204022,204428,0.198602931105328
139.0,DE504L1,MÃ¼nster,2014,32,141731,141763,0.022572885731820008
140.0,DE505L0,Chemnitz,2014,0,22193,22193,0.0
141.0,DE507L1,Aachen,2014,56,70464,70520,0.07941009642654566
142.0,DE508L0,Krefeld,2014,93,13587,13680,0.6798245614035088
143.0,DE510L1,LÃ¼beck,2014,4393,157756,162149,2.70923656636797
144.0,DE513L1,Kassel,2014,13,139848,139861,0.009294942836101558
145.0,DE516L0,Solingen,2014,1,8953,8954,0.011168192986374805
146.0,DE517L1,OsnabrÃ¼ck,2014,47,224083,224130,0.020969972783652344
147.0,DE520L1,Oldenburg (Oldenburg),2014,199,189770,189969,0.10475393353652437
148.0,DE522L1,Heidelberg,2014,113,116992,117105,0.09649459886426712
149.0,DE523L1,Paderborn,2014,83,124600,124683,0.0665688185237763
150.0,DE524L2,WÃ¼rzburg,2014,45,305884,305929,0.014709295294006126
151.0,DE527L1,Bremerhaven,2014,955,213524,214479,0.44526503760274905
152.0,DE529L1,Heilbronn,2014,12,119972,119984,0.010001333511134818
153.0,DE530L0,Remscheid,2014,0,7369,7369,0.0
154.0,DE532L1,Ulm,2014,143,199165,199308,0.07174824894133702
155.0,DE533L1,Pforzheim,2014,0,67148,67148,0.0
156.0,DE534L1,Ingolstadt,2014,737,284098,284835,0.258746291712746
157.0,DE535L1,Gera,2014,42,99744,99786,0.04209007275569719
158.0,DE537L1,Reutlingen,2014,1,109281,109282,0.0009150637799454622
159.0,DE539L1,Cottbus,2014,1020,181260,182280,0.5595786701777485
160.0,DE540L2,Siegen,2014,94,177470,177564,0.0529386587371314
161.0,DE542L1,Hildesheim,2014,4,120806,120810,0.003310984190050492
162.0,DE544L1,Zwickau,2014,24,94780,94804,0.025315387536390867
163.0,DE546L0,Wuppertal,2014,17,16816,16833,0.10099209885344265
164.0,DE547L2,Jena,2014,0,93068,93068,0.0
165.0,DE548L1,DÃ¼ren,2014,3,94035,94038,0.003190199706501627
166.0,DE549L1,Bocholt,2014,7,142258,142265,0.0049203950374301485
167.0,DK001L2,KÃ¸benhavn,2014,10952,280271,291223,3.7606919783121526
168.0,DK002L3,Ãrhus,2014,6640,455884,462524,1.4356011796144632
169.0,DK003L2,Odense,2014,7090,352749,359839,1.9703256178457589
170.0,DK004L3,Aalborg,2014,2783,617676,620459,0.4485389042628119
171.0,EE001L1,Tallinn,2014,5881,433180,439061,1.3394494159125954
172.0,EE002L1,Tartu,2014,1424,298218,299642,0.47523377897624497
173.0,EE003L0,Narva,2014,320,6569,6889,4.645086369574685
174.0,EL001L1,Athina,2014,5126,304261,309387,1.6568246241761935
175.0,EL002L1,Thessaloniki,2014,1500,140619,142119,1.0554535283811455
176.0,EL003L1,Patra,2014,667,50923,51590,1.2928862182593526
177.0,EL004L1,Irakleio,2014,1087,60297,61384,1.7708197575915547
178.0,EL005L1,Larisa,2014,62,155457,155519,0.03986651148734238
179.0,EL006L1,Volos,2014,274,30542,30816,0.8891484942886811
180.0,EL007L1,Ioannina,2014,2018,130623,132641,1.521399868818842
181.0,EL008L1,Kavala,2014,310,35258,35568,0.871569950517319
182.0,EL009L1,Kalamata,2014,269,44183,44452,0.6051471249887519
183.0,ES001L3,Madrid,2014,2647,784956,787603,0.33608302660096523
184.0,ES002L2,Barcelona,2014,1191,263416,264607,0.45010147123847816
185.0,ES003L3,Valencia,2014,3112,172008,175120,1.777067153951576
186.0,ES004L3,Sevilla,2014,4665,463761,468426,0.9958883580330724
187.0,ES005L2,Zaragoza,2014,155,275983,276138,0.0561313546125488
188.0,ES006L2,MÃ¡laga,2014,989,151753,152742,0.6474970865904597
189.0,ES007L2,Murcia,2014,91,120045,120136,0.0757474861823267
190.0,ES008L2,Las Palmas,2014,844,75752,76596,1.1018852159381691
191.0,ES009L2,Valladolid,2014,158,115371,115529,0.13676219823594077
192.0,ES010L2,Palma de Mallorca,2014,2182,202052,204234,1.06838234574067
193.0,ES011L2,Santiago de Compostela,2014,11,126245,126256,0.008712457229755418
194.0,ES012L2,Vitoria/Gasteiz,2014,688,158633,159321,0.4318325895519109
195.0,ES013L2,Oviedo,2014,24,93463,93487,0.025672018569426764
196.0,ES014L3,Pamplona/IruÃ±a,2014,72,169442,169514,0.04247436789881662
197.0,ES015L2,Santander,2014,310,69173,69483,0.4461522962451247
198.0,ES016L2,Toledo,2014,469,92929,93398,0.5021520803443328
199.0,ES017L2,Badajoz,2014,882,217867,218749,0.40320184320842606
200.0,ES018L2,LogroÃ±o,2014,39,46099,46138,0.0845290216307599
201.0,ES019L3,Bilbao,2014,1003,152318,153321,0.6541830538543317
202.0,ES020L2,CÃ³rdoba,2014,2230,184672,186902,1.19313865020171
203.0,ES021L2,Alicante/Alacant,2014,407,35651,36058,1.1287370347773031
204.0,ES022L2,Vigo,2014,1059,135412,136471,0.7759890379641096
205.0,ES023L2,GijÃ³n,2014,434,52968,53402,0.812703644058275
206.0,ES025L3,Santa Cruz de Tenerife,2014,1199,65784,66983,1.7900064195392862
207.0,ES026L2,CoruÃ±a (A),2014,698,75277,75975,0.9187232642316551
208.0,ES028L1,Reus,2014,0,11534,11534,0.0
209.0,ES031L1,Lugo,2014,42,133969,134011,0.03134071083717008
210.0,ES033L1,Girona,2014,2,39619,39621,0.005047828171929028
211.0,ES034L1,CÃ¡ceres,2014,1952,236321,238273,0.8192283641033604
212.0,ES035L1,Torrevieja,2014,1712,7126,8838,19.37089839330165
213.0,ES039L1,AvilÃ©s,2014,163,18979,19142,0.8515306655521889
214.0,ES040L1,Talavera de la Reina,2014,551,82715,83266,0.6617346816227512
215.0,ES041L1,Palencia,2014,6,28375,28381,0.02114090412599979
216.0,ES043L1,Ferrol,2014,956,46014,46970,2.0353417074728553
217.0,ES044L1,Pontevedra,2014,198,51418,51616,0.38360198388096717
218.0,ES046L1,Gandia,2014,246,17091,17337,1.418930610832324
219.0,ES048L1,Guadalajara,2014,3,45380,45383,0.006610404777119186
220.0,ES050L1,Manresa,2014,3,29600,29603,0.010134108029591596
221.0,ES053L1,Ciudad Real,2014,851,95494,96345,0.8832840313456847
222.0,ES054L1,Benidorm,2014,315,20358,20673,1.52372659991293
223.0,ES057L1,Ponferrada,2014,247,62096,62343,0.396195242449032
224.0,ES059L1,Zamora,2014,369,33811,34180,1.0795787009947337
225.0,ES070L1,Irun,2014,86,7156,7242,1.1875172604252968
226.0,ES072L1,Arrecife,2014,2194,56740,58934,3.7228085655139647
227.0,ES501L3,Granada,2014,430,162194,162624,0.264413616686344
228.0,ES505L1,Elche/Elx,2014,709,38109,38818,1.8264722551393684
229.0,ES506L1,Cartagena,2014,1518,59430,60948,2.4906477653081316
230.0,ES508L1,Jerez de la Frontera,2014,231,125875,126106,0.18317923017144305
231.0,ES510L1,Donostia-San SebastiÃ¡n,2014,203,33117,33320,0.6092436974789917
232.0,ES514L1,AlmerÃ­a,2014,737,39993,40730,1.8094770439479497
233.0,ES515L1,Burgos,2014,4,149387,149391,0.002677537468789954
234.0,ES516L1,Salamanca,2014,20,45624,45644,0.043817369205152924
235.0,ES519L1,Albacete,2014,10,245315,245325,0.0040762254152654645
236.0,ES520L1,CastellÃ³n/CastellÃ³,2014,344,32450,32794,1.0489723729950602
237.0,ES521L1,Huelva,2014,3814,93606,97420,3.915007185382878
238.0,ES522L1,CÃ¡diz,2014,1015,23818,24833,4.087303185277655
239.0,ES523L1,LeÃ³n,2014,1,118886,118887,0.0008411348591519679
240.0,ES525L1,Tarragona,2014,445,21295,21740,2.046918123275069
241.0,ES527L1,JaÃ©n,2014,32,99899,99931,0.03202209524571955
242.0,ES528L1,Lleida,2014,110,70565,70675,0.1556420233463035
243.0,ES529L1,Ourense,2014,144,65024,65168,0.220967345936656
244.0,ES532L1,Algeciras,2014,502,41792,42294,1.1869295881212465
245.0,ES533L1,Marbella,2014,572,68633,69205,0.8265298750090312
246.0,ES537L1,Alcoy,2014,0,20529,20529,0.0
247.0,ES538L1,Ãvila,2014,537,53109,53646,1.0010065988144503
248.0,ES542L1,Cuenca,2014,72,164510,164582,0.04374718985065196
249.0,ES543L1,Eivissa,2014,2107,57295,59402,3.5470186189017205
250.0,ES544L1,Linares,2014,13,25763,25776,0.05043451272501552
251.0,ES545L1,Lorca,2014,227,181980,182207,0.12458357801840765
252.0,ES546L1,MÃ©rida,2014,1065,127234,128299,0.8300922064864106
253.0,ES547L1,Sagunto,2014,207,15321,15528,1.3330757341576507
254.0,ES550L1,Puerto de la Cruz,2014,1335,26137,27472,4.859493302271404
255.0,ES552L1,Igualada,2014,0,25426,25426,0.0
256.0,FI001L3,Helsinki,2014,19231,472287,491518,3.9125728864456644
257.0,FI002L3,Tampere,2014,78714,609929,688643,11.430305688143203
258.0,FI003L4,Turku,2014,19405,447039,466444,4.160199295092229
259.0,FI004L4,Oulu,2014,7958,715863,723821,1.0994430943562012
260.0,FI007L2,Lahti,2014,26402,309001,335403,7.87172446281041
261.0,FI008L2,Kuopio,2014,116792,803614,920406,12.689182817148085
262.0,FI009L2,JyvÃ¤skylÃ¤,2014,54804,422138,476942,11.49070536878698
263.0,FR001L1,Paris,2014,1565,1208387,1209952,0.12934397397582714
264.0,FR003L2,Lyon,2014,1046,366185,367231,0.2848343413273934
265.0,FR004L2,Toulouse,2014,1192,523480,524672,0.2271895584288851
266.0,FR006L2,Strasbourg,2014,703,203180,203883,0.3448055992897887
267.0,FR007L2,Bordeaux,2014,5503,550251,555754,0.9901863054516926
268.0,FR008L2,Nantes,2014,1425,315194,316619,0.4500677470398176
269.0,FR009L2,Lille,2014,77,144376,144453,0.053304535039078456
270.0,FR010L2,Montpellier,2014,7346,216572,223918,3.280665243526648
271.0,FR011L2,Saint-Etienne,2014,94,180961,181055,0.051917925492253734
272.0,FR012L2,Le Havre,2014,1117,75321,76438,1.4613150527224679
273.0,FR013L2,Rennes,2014,142,381995,382137,0.03715944805135331
274.0,FR014L2,Amiens,2014,42,244753,244795,0.017157213178373744
275.0,FR016L2,Nancy,2014,159,283350,283509,0.056082875675904476
276.0,FR017L2,Metz,2014,9,176921,176930,0.005086757474707511
277.0,FR018L2,Reims,2014,34,243117,243151,0.01398308047262812
278.0,FR019L2,OrlÃ©ans,2014,1234,290733,291967,0.4226505050228279
279.0,FR020L2,Dijon,2014,78,385683,385761,0.02021977338300139
280.0,FR021L2,Poitiers,2014,62,250380,250442,0.02475623098362096
281.0,FR022L2,Clermont-Ferrand,2014,160,265966,266126,0.06012189714646446
282.0,FR023L2,Caen,2014,551,225722,226273,0.24351115687687
283.0,FR024L2,Limoges,2014,309,317525,317834,0.09722056167685018
284.0,FR025L2,BesanÃ§on,2014,0,239036,239036,0.0
285.0,FR026L2,Grenoble,2014,1653,264195,265848,0.6217838765008576
286.0,FR027L2,Ajaccio,2014,1472,145537,147009,1.001299240182574
289.0,FR032L2,Toulon,2014,2190,104866,107056,2.0456583470333283
290.0,FR034L2,Valenciennes,2014,72,78374,78446,0.09178288249241516
291.0,FR035L2,Tours,2014,1216,283632,284848,0.42689434364994666
292.0,FR036L2,Angers,2014,974,230277,231251,0.4211873678384093
293.0,FR037L2,Brest,2014,478,134516,134994,0.3540898113990251
294.0,FR038L2,Le Mans,2014,92,224019,224111,0.04105108629206063
295.0,FR039L1,Avignon,2014,1481,85744,87225,1.6979077099455433
296.0,FR040L2,Mulhouse,2014,48,129718,129766,0.03698965830803138
297.0,FR042L2,Dunkerque,2014,731,90394,91125,0.8021947873799725
298.0,FR043L2,Perpignan,2014,1416,181614,183030,0.7736436649729552
299.0,FR044L2,NÃ®mes,2014,1369,149122,150491,0.9096889514987607
300.0,FR045L2,Pau,2014,31,201728,201759,0.015364866003499225
301.0,FR046L2,Bayonne,2014,976,101654,102630,0.9509889895741986
302.0,FR047L0,Annemasse,2014,2,7798,7800,0.02564102564102564
303.0,FR048L2,Annecy,2014,1728,117315,119043,1.4515763211612611
304.0,FR049L2,Lorient,2014,523,112659,113182,0.4620876111042392
305.0,FR050L2,MontbÃ©liard,2014,31,123026,123057,0.025191577886670407
306.0,FR051L2,Troyes,2014,645,260305,260950,0.24717378808200804
307.0,FR052L2,Saint-Nazaire,2014,300,106835,107135,0.2800205348392215
308.0,FR053L2,La Rochelle,2014,265,111075,111340,0.238009700017963
309.0,FR056L2,AngoulÃªme,2014,23,214269,214292,0.010733018498124055
310.0,FR057L2,Boulogne-sur-Mer,2014,187,68351,68538,0.27284134348828387
311.0,FR058L2,ChambÃ©ry,2014,1843,99846,101689,1.8123887539458545
312.0,FR059L2,Chalon-sur-SaÃ´ne,2014,51,156307,156358,0.03261745481523171
313.0,FR060L2,Chartres,2014,47,161313,161360,0.029127416955875063
314.0,FR061L2,Niort,2014,34,178885,178919,0.019003012536399154
315.0,FR062L2,Calais,2014,92,50138,50230,0.18315747561218396
316.0,FR063L2,BÃ©ziers,2014,369,84774,85143,0.43338853458299564
317.0,FR064L2,Arras,2014,11,107552,107563,0.010226564896851148
318.0,FR065L2,Bourges,2014,320,249999,250319,0.12783688014094016
319.0,FR066L2,Saint-Brieuc,2014,54,115127,115181,0.04688273239509989
320.0,FR067L2,Quimper,2014,552,121370,121922,0.45274847853545713
321.0,FR068L2,Vannes,2014,692,120342,121034,0.571740172183023
322.0,FR069L2,Cherbourg,2014,433,90285,90718,0.47730329151877243
323.0,FR073L2,Tarbes,2014,68,104261,104329,0.06517842594101353
324.0,FR074L2,CompiÃ¨gne,2014,92,98645,98737,0.09317682327800116
325.0,FR076L2,Belfort,2014,145,65474,65619,0.22097258416007556
326.0,FR077L2,Roanne,2014,1,123199,123200,0.0008116883116883117
327.0,FR079L2,Saint-Quentin,2014,35,99339,99374,0.03522048020609013
328.0,FR082L2,Beauvais,2014,21,131121,131142,0.016013176556709523
329.0,FR084L2,Creil,2014,27,29616,29643,0.09108389839085113
330.0,FR086L2,Evreux,2014,150,126420,126570,0.11851149561507467
331.0,FR090L2,ChÃ¢teauroux,2014,256,260921,261177,0.0980178193332491
332.0,FR093L2,Brive-la-Gaillarde,2014,32,132550,132582,0.024136006396041694
333.0,FR096L2,Albi,2014,166,134072,134238,0.12366096038379595
334.0,FR099L2,FrÃ©jus,2014,430,43983,44413,0.9681849908810483
335.0,FR104L2,ChÃ¢lons-en-Champagne,2014,55,152754,152809,0.03599264441230556
336.0,FR203L2,Marseille,2014,2907,422869,425776,0.6827533726654391
337.0,FR205L2,Nice,2014,1107,306233,307340,0.3601874145897052
338.0,FR207L2,Lens - LiÃ©vin,2014,38,25270,25308,0.15015015015015015
339.0,FR208L1,HÃ©nin - Carvin,2014,12,11586,11598,0.10346611484738748
340.0,FR209L2,Douai,2014,136,44948,45084,0.301659125188537
341.0,FR214L1,Valence,2014,549,90412,90961,0.6035553698837963
342.0,FR215L2,Rouen,2014,2313,284813,287126,0.8055696802100819
343.0,FR304L1,Melun,2014,87,44749,44836,0.19404050316709787
344.0,FR324L1,Martigues,2014,1708,18748,20456,8.349628470864294
345.0,FR505L1,Charleville-MÃ©ziÃ¨res,2014,52,135317,135369,0.03841352155958897
346.0,FR506L1,Colmar,2014,31,101954,101985,0.030396626954944356
347.0,FR519L1,Cannes,2014,494,19642,20136,2.4533174413984904
348.0,HR001L2,Grad Zagreb,2014,240,505628,505868,0.04744320652818522
349.0,HR002L2,Rijeka,2014,601,106633,107234,0.5604565716097507
350.0,HR003L2,Slavonski Brod,2014,960,96870,97830,0.9812940815700706
351.0,HR004L2,Osijek,2014,1794,171140,172934,1.0373899869314305
352.0,HR005L2,Split,2014,3044,336026,339070,0.8977497271949745
353.0,HR006L1,Pula - Pola,2014,1262,57635,58897,2.142723738051174
354.0,HR007L1,Zadar,2014,2475,154025,156500,1.5814696485623003
355.0,HU001L2,Budapest,2014,6894,632240,639134,1.0786470442817937
356.0,HU002L2,Miskolc,2014,414,164255,164669,0.2514134415099381
357.0,HU003L2,NyÃ­regyhÃ¡za,2014,256,167969,168225,0.15217714370634566
358.0,HU004L2,PÃ©cs,2014,158,185330,185488,0.08518071249892177
359.0,HU005L2,Debrecen,2014,606,200972,201578,0.30062804472710314
360.0,HU006L2,Szeged,2014,834,160099,160933,0.518228082493957
361.0,HU007L2,GyÃµr,2014,525,204115,204640,0.2565480844409695
362.0,HU008L2,KecskemÃ©t,2014,68,182071,182139,0.03733412393831085
363.0,HU009L2,SzÃ©kesfehÃ©rvÃ¡r,2014,1807,299316,301123,0.6000870076347539
364.0,HU010L1,Szombathely,2014,53,134224,134277,0.03947064649940049
365.0,HU011L1,Szolnok,2014,718,143257,143975,0.4986976905712797
366.0,HU012L1,TatabÃ¡nya,2014,108,69722,69830,0.15466132034942004
367.0,HU013L1,VeszprÃ©m,2014,7146,124174,131320,5.4416692049954305
368.0,HU014L1,BÃ©kÃ©scsaba,2014,40,106123,106163,0.03767791038309015
369.0,HU015L1,KaposvÃ¡r,2014,0,145560,145560,0.0
370.0,HU016L1,Eger,2014,132,100446,100578,0.13124142456600849
371.0,HU017L1,DunaÃºjvÃ¡ros,2014,793,60877,61670,1.2858764391113993
372.0,HU018L1,Zalaegerszeg,2014,237,139742,139979,0.16931111095235712
373.0,HU019L1,Sopron,2014,609,80061,80670,0.7549274823354407
374.0,IE001L1,Dublin,2014,4676,698926,703602,0.6645802598628202
375.0,IE002L1,Cork,2014,2062,327601,329663,0.625487239999636
376.0,IE003L1,Limerick,2014,2053,154405,156458,1.312173234989582
377.0,IE004L1,Galway,2014,9604,216679,226283,4.244242828670294
378.0,IE005L1,Waterford,2014,1222,94635,95857,1.2748156107535182
379.0,IS001L1,ReykjavÃ­k,2014,199194,1098036,1297230,15.355334057954256
380.0,IT001L3,Roma,2014,9006,608210,617216,1.4591326213189548
381.0,IT002L3,Milano,2014,36,384009,384045,0.009373901495918447
382.0,IT003L3,Napoli,2014,2956,149986,152942,1.9327588236063347
383.0,IT004L2,Torino,2014,73,170106,170179,0.04289600949588374
384.0,IT005L3,Palermo,2014,1553,148520,150073,1.0348297162047804
385.0,IT006L3,Genova,2014,723,120041,120764,0.5986883508330297
386.0,IT007L3,Firenze,2014,105,163666,163771,0.06411391516202503
387.0,IT008L3,Bari,2014,713,112716,113429,0.6285870456408855
388.0,IT009L1,Bologna,2014,58,185199,185257,0.03130785881235257
389.0,IT010L2,Catania,2014,494,60931,61425,0.8042328042328042
390.0,IT011L2,Venezia,2014,1806,65231,67037,2.6940346375881976
391.0,IT012L3,Verona,2014,54,73107,73161,0.07380981670562184
392.0,IT013L3,Cremona,2014,369,60028,60397,0.610957497888968
393.0,IT014L3,Trento,2014,639,97548,98187,0.6507989856090929
394.0,IT015L1,Trieste,2014,395,21242,21637,1.8255765586726442
395.0,IT016L3,Perugia,2014,5805,125223,131028,4.430350764722045
396.0,IT017L3,Ancona,2014,535,43708,44243,1.2092308387767556
397.0,IT019L2,Pescara,2014,253,16190,16443,1.5386486650854467
398.0,IT020L3,Campobasso,2014,518,102317,102835,0.5037195507366169
399.0,IT021L2,Caserta,2014,6,9336,9342,0.06422607578676942
400.0,IT022L2,Taranto,2014,3476,103452,106928,3.2507855753404162
401.0,IT023L2,Potenza,2014,77,138378,138455,0.055613737315373224
402.0,IT024L3,Catanzaro,2014,322,89761,90083,0.35744813116792296
403.0,IT025L3,Reggio di Calabria,2014,586,47662,48248,1.2145581163986072
404.0,IT026L3,Sassari,2014,2308,150917,153225,1.5062816120084843
405.0,IT027L2,Cagliari,2014,4910,190382,195292,2.514183888740962
406.0,IT028L3,Padova,2014,4,61441,61445,0.0065098868907152736
407.0,IT029L3,Brescia,2014,76,60193,60269,0.12610131244918615
408.0,IT030L3,Modena,2014,144,69124,69268,0.20788820234451696
409.0,IT031L3,Foggia,2014,4,89707,89711,0.004458762024723836
410.0,IT032L3,Salerno,2014,321,37518,37839,0.8483310869737573
411.0,IT033L2,Piacenza,2014,528,93599,94127,0.5609442561645437
412.0,IT034L1,Bolzano,2014,602,106154,106756,0.5639027314624002
413.0,IT035L2,Udine,2014,0,71830,71830,0.0
414.0,IT036L2,La Spezia,2014,658,42261,42919,1.5331205293692771
415.0,IT037L1,Lecce,2014,306,61204,61510,0.4974800845390993
416.0,IT038L1,Barletta,2014,228,14869,15097,1.5102338212889979
417.0,IT039L2,Pesaro,2014,111,25580,25691,0.4320579191156436
418.0,IT040L2,Como,2014,567,19174,19741,2.8721949242692872
419.0,IT041L2,Pisa,2014,473,47580,48053,0.9843298025097289
420.0,IT042L1,Treviso,2014,45,24000,24045,0.18714909544603867
421.0,IT043L2,Varese,2014,464,23200,23664,1.9607843137254901
422.0,IT045L2,Asti,2014,17,54819,54836,0.03100153184039682
423.0,IT046L2,Pavia,2014,206,35998,36204,0.5689979007844437
424.0,IT047L1,Massa,2014,209,11034,11243,1.8589344481010406
425.0,IT048L2,Cosenza,2014,429,92050,92479,0.46388909914683335
426.0,IT052L1,Savona,2014,197,28508,28705,0.6862915868315624
427.0,IT054L1,Matera,2014,649,77140,77789,0.834308192675057
428.0,IT056L1,Acireale,2014,52,5936,5988,0.8684034736138945
429.0,IT057L2,Avellino,2014,7,39752,39759,0.0176060766115848
430.0,IT058L2,Pordenone,2014,11,37039,37050,0.02968960863697706
431.0,IT060L1,Lecco,2014,1243,28969,30212,4.114259234741162
432.0,IT061L0,Altamura,2014,0,42800,42800,0.0
433.0,IT064L1,Battipaglia,2014,53,6433,6486,0.8171446191797719
434.0,IT065L0,Bisceglie,2014,84,6860,6944,1.2096774193548387
435.0,IT066L1,Carpi,2014,3,20619,20622,0.014547570555717195
436.0,IT067L0,Cerignola,2014,127,58770,58897,0.21563067728407218
437.0,IT068L1,Gallarate,2014,0,5319,5319,0.0
438.0,IT069L1,Gela,2014,406,57489,57895,0.7012695396839105
439.0,IT073L1,Sassuolo,2014,1,24061,24062,0.004155930512841825
440.0,IT501L2,Messina,2014,776,33667,34443,2.252997706355428
441.0,IT502L2,Prato,2014,8,40951,40959,0.01953172684880002
442.0,IT503L3,Parma,2014,188,113319,113507,0.16562855154307665
443.0,IT504L3,Livorno,2014,352,25462,25814,1.3636011466646007
444.0,IT505L3,Reggio nell'Emilia,2014,1,69033,69034,0.0014485615783526957
445.0,IT506L2,Ravenna,2014,3558,77631,81189,4.382367069430588
446.0,IT507L2,Ferrara,2014,1002,90481,91483,1.0952854628728834
447.0,IT508L3,Rimini,2014,282,32297,32579,0.8655882623776052
448.0,IT509L3,Siracusa,2014,543,33599,34142,1.5904164958116103
449.0,IT511L2,Bergamo,2014,0,18556,18556,0.0
450.0,IT512L3,ForlÃ¬,2014,6,72745,72751,0.008247309315335872
451.0,IT513L3,Latina,2014,529,65964,66493,0.7955724662746454
452.0,IT514L2,Vicenza,2014,1,34981,34982,0.0028586130009719286
453.0,IT515L2,Terni,2014,157,102175,102332,0.153422194425986
454.0,IT516L2,Novara,2014,0,54165,54165,0.0
455.0,IT518L1,Alessandria,2014,102,76812,76914,0.1326156486465403
456.0,IT519L1,Arezzo,2014,32,88595,88627,0.0361063784174123
457.0,IT520L1,Grosseto,2014,454,119145,119599,0.37960183613575366
458.0,IT521L1,Brindisi,2014,819,63168,63987,1.279947489333771
459.0,IT522L1,Trapani,2014,941,49849,50790,1.8527269147469974
460.0,IT523L1,Ragusa,2014,255,52595,52850,0.48249763481551566
461.0,IT524L0,Andria,2014,0,39880,39880,0.0
462.0,IT525L0,Trani,2014,111,10268,10379,1.0694671933712303
463.0,IT526L1,L'Aquila,2014,555,139714,140269,0.3956683230079348
464.0,LT001L1,Vilnius,2014,2677,421892,424569,0.630521776201277
465.0,LT002L1,Kaunas,2014,858,161193,162051,0.5294629468500657
466.0,LT003L1,PanevÄÅ¾ys,2014,126,222682,222808,0.056550931743923026
467.0,LT004L0,Alytus,2014,9,3950,3959,0.22733013387218998
468.0,LT501L0,KlaipÄda,2014,90,8833,8923,1.0086293847360752
469.0,LT502L0,Å iauliai,2014,1024,7021,8045,12.728402734617775
470.0,LU001L1,Luxembourg,2014,204,259511,259715,0.0785476387578692
471.0,LV001L1,RÄ«ga,2014,10982,605267,616249,1.7820718573174157
472.0,LV002L2,LiepÄja,2014,3025,269032,272057,1.1118993446226344
473.0,LV003L1,Jelgava,2014,136,166323,166459,0.08170180044335242
474.0,LV501L1,Daugavpils,2014,1606,258069,259675,0.6184653894290941
475.0,ME001L1,Podgorica,2014,1226,183255,184481,0.6645670827890136
476.0,MK001L1,Skopje,2014,12,224341,224353,0.005348713857180425
477.0,MK003L1,Bitola,2014,124,119538,119662,0.10362521101101435
478.0,MK004L1,Tetovo,2014,9,105612,105621,0.008521032749169198
479.0,MK005L1,Prilep,2014,93,86738,86831,0.10710460549803642
480.0,MT001L1,Valletta,2014,987,24969,25956,3.802588996763754
481.0,NL001L3,s' Gravenhage,2014,2383,40324,42707,5.579881518252277
482.0,NL002L3,Amsterdam,2014,62398,270559,332957,18.740558090083702
483.0,NL003L3,Rotterdam,2014,29171,188000,217171,13.43227226471306
484.0,NL004L3,Utrecht,2014,558,96729,97287,0.5735607018409449
485.0,NL005L3,Eindhoven,2014,59,144347,144406,0.04085702810132543
486.0,NL006L3,Tilburg,2014,68,43166,43234,0.15728361937364113
487.0,NL007L3,Groningen,2014,2783,205377,208160,1.3369523443504996
488.0,NL008L3,Enschede,2014,69,84887,84956,0.08121851311267009
489.0,NL009L3,Arnhem,2014,598,55300,55898,1.0698057175569788
490.0,NL010L3,Heerlen,2014,16,33327,33343,0.04798608403562967
491.0,NL012L3,Breda,2014,1730,71640,73370,2.357911953114352
492.0,NL013L3,Nijmegen,2014,763,39073,39836,1.9153529470830404
493.0,NL014L3,Apeldoorn,2014,4,71120,71124,0.0056239806535065525
494.0,NL015L3,Leeuwarden,2014,528,110395,110923,0.47600587795137167
495.0,NL016L3,Sittard-Geleen,2014,22,22890,22912,0.09601955307262569
496.0,NL020L3,Roosendaal,2014,0,24574,24574,0.0
497.0,NL026L0,Alphen aan den Rijn,2014,29,13181,13210,0.21953065859197576
498.0,NL028L3,Bergen op Zoom,2014,1652,33129,34781,4.749719674534948
499.0,NL030L0,Gouda,2014,6,1782,1788,0.33557046979865773
500.0,NL032L3,MiddelburgÂ Â Â Â Â Â ,2014,952,22436,23388,4.070463485548145
501.0,NL503L3,s-Hertogenbosch,2014,270,36589,36859,0.732521229550449
502.0,NL504L3,Amersfoort,2014,0,12244,12244,0.0
503.0,NL505L3,Maastricht,2014,20,20365,20385,0.09811135638950208
504.0,NL507L3,Leiden,2014,162,19619,19781,0.8189676962742025
505.0,NL511L3,Zwolle,2014,807,122213,123020,0.6559908957893026
506.0,NL512L3,Ede,2014,59,35206,35265,0.16730469303842338
507.0,NL513L3,Deventer,2014,21,25224,25245,0.08318478906714201
508.0,NL514L3,Alkmaar,2014,106,47686,47792,0.22179444258453299
509.0,NL515L3,Venlo,2014,243,50993,51236,0.4742758997579827
510.0,NL519L3,Almelo,2014,4,42021,42025,0.009518143961927425
511.0,NL520L3,Lelystad,2014,49860,68982,118842,41.95486444186399
512.0,NL521L3,Oss,2014,9,33137,33146,0.02715259759850359
513.0,NL522L3,Assen,2014,57,70805,70862,0.08043803448957128
514.0,NL524L3,Veenendaal,2014,16,8169,8185,0.19547953573610263
515.0,NL529L3,Soest,2014,0,7942,7942,0.0
516.0,NO001L1,Oslo,2014,22239,724404,746643,2.978531908823896
517.0,NO002L1,Bergen,2014,10040,347703,357743,2.8064839843127607
518.0,NO003L1,Trondheim,2014,9171,664085,673256,1.3621861520729113
519.0,NO004L1,Stavanger,2014,18014,271063,289077,6.231557681863309
520.0,NO005L1,Kristiansand,2014,5558,309904,315462,1.7618603825500376
521.0,NO006L1,TromsÃ¸,2014,37901,336712,374613,10.117374463779955
522.0,PL001L2,Warszawa,2014,3660,857583,861243,0.424967169544484
523.0,PL002L2,ÅÃ³dÅº,2014,36,169464,169500,0.021238938053097345
524.0,PL003L2,KrakÃ³w,2014,952,374796,375748,0.25336129533623597
525.0,PL004L2,WrocÅaw,2014,637,264063,264700,0.24064979221760482
526.0,PL005L2,PoznaÅ,2014,686,308642,309328,0.22177106501836238
527.0,PL006L2,GdaÅsk,2014,2189,261327,263516,0.8306895975955918
528.0,PL007L2,Szczecin,2014,1841,111219,113060,1.6283389350787194
529.0,PL008L2,Bydgoszcz,2014,1927,208209,210136,0.9170251646552708
530.0,PL009L2,Lublin,2014,343,322441,322784,0.10626301179736296
531.0,PL010L2,Katowice,2014,2408,392187,394595,0.6102459483774503
532.0,PL011L2,BiaÅystok,2014,42,223280,223322,0.01880692453049856
533.0,PL012L2,Kielce,2014,190,224039,224229,0.08473480236722279
534.0,PL013L2,ToruÅ,2014,1946,156987,158933,1.2244153196630028
535.0,PL014L2,Olsztyn,2014,4198,198346,202544,2.072636069199779
536.0,PL015L2,RzeszÃ³w,2014,98,229251,229349,0.04272963910895622
537.0,PL016L2,Opole,2014,1102,175514,176616,0.6239525297821261
538.0,PL017L2,GorzÃ³w Wielkopolski,2014,78,97342,97420,0.08006569492917266
539.0,PL018L2,Zielona GÃ³ra,2014,261,169023,169284,0.15417877649393918
540.0,PL019L2,Jelenia GÃ³ra,2014,868,82473,83341,1.0415041816152915
541.0,PL020L2,Nowy SÄcz,2014,254,130164,130418,0.19475839224646904
542.0,PL021L2,SuwaÅki,2014,1770,70363,72133,2.453800618302303
543.0,PL022L2,Konin,2014,1679,116484,118163,1.4209185616478932
544.0,PL024L2,CzÄstochowa,2014,29,193869,193898,0.01495631723896069
545.0,PL025L2,Radom,2014,8,68014,68022,0.011760900885007792
546.0,PL026L2,PÅock,2014,3248,167827,171075,1.8985824930586
547.0,PL027L2,Kalisz,2014,123,148900,149023,0.0825375948679063
548.0,PL028L2,Koszalin,2014,67,129604,129671,0.05166922442180595
549.0,PL029L1,SÅupsk,2014,8088,226916,235004,3.4416435464928257
550.0,PL030L1,JastrzÄbie-ZdrÃ³j,2014,11,29560,29571,0.037198606743092895
551.0,PL031L1,Siedlce,2014,47,126122,126169,0.03725162282335597
552.0,PL032L1,PiotrkÃ³w Trybunalski,2014,116,116806,116922,0.09921144010536938
553.0,PL033L1,Lubin,2014,378,92928,93306,0.40511864188798147
554.0,PL034L1,PiÅa,2014,116,52076,52192,0.22225628448804416
555.0,PL035L1,InowrocÅaw,2014,52,20076,20128,0.25834658187599363
556.0,PL036L1,Ostrowiec ÅwiÄtokrzyski,2014,0,61460,61460,0.0
557.0,PL037L1,Gniezno,2014,80,66491,66571,0.12017244746210813
558.0,PL038L1,Stargard SzczeciÅski,2014,1131,35533,36664,3.0847698014401046
559.0,PL039L1,OstrÃ³w Wielkopolski,2014,84,84677,84761,0.0991021814277793
560.0,PL040L1,PrzemyÅl,2014,194,84895,85089,0.22799656829907508
561.0,PL041L1,ZamoÅÄ,2014,287,112420,112707,0.25464256878454755
562.0,PL042L1,CheÅm,2014,8,46562,46570,0.017178441056474123
563.0,PL043L1,Pabianice,2014,0,32959,32959,0.0
564.0,PL044L1,GÅogÃ³w,2014,716,63365,64081,1.1173358717872692
565.0,PL045L1,Stalowa Wola,2014,315,189998,190313,0.16551680652398942
566.0,PL046L1,TomaszÃ³w Mazowiecki,2014,508,18655,19163,2.6509419193236967
567.0,PL047L1,ÅomÅ¼a,2014,1,56001,56002,0.001785650512481697
568.0,PL048L1,Leszno,2014,400,77172,77572,0.515649976795751
569.0,PL049L1,Åwidnica,2014,12,47978,47990,0.025005209418628882
570.0,PL051L1,Tczew,2014,145,26979,27124,0.534581920070786
571.0,PL052L1,EÅk,2014,1514,38538,40052,3.7800858883451514
572.0,PL506L2,Bielsko-BiaÅa,2014,557,72878,73435,0.7584939061755294
573.0,PL508L1,Rybnik,2014,120,14761,14881,0.8063974195282575
574.0,PL511L2,WaÅbrzych,2014,4,51506,51510,0.007765482430596001
575.0,PL512L2,ElblÄg,2014,34,96441,96475,0.03524229074889868
576.0,PL513L2,WÅocÅawek,2014,3474,119005,122479,2.836404608136905
577.0,PL514L2,TarnÃ³w,2014,379,124948,125327,0.3024088983219897
578.0,PL516L2,Legnica,2014,116,56384,56500,0.20530973451327433
579.0,PL517L2,GrudziÄdz,2014,775,54268,55043,1.4079901168177607
580.0,PT001L3,Lisboa,2014,8235,431046,439281,1.8746542645823518
581.0,PT002L2,Porto,2014,1168,94572,95740,1.2199707541257572
582.0,PT003L1,Braga,2014,51,49298,49349,0.1033455591805305
583.0,PT004L2,Funchal,2014,779,35183,35962,2.166175407374451
584.0,PT005L2,Coimbra,2014,450,162337,162787,0.2764348504487459
585.0,PT007L1,Ponta Delgada,2014,1340,53954,55294,2.423409411509386
586.0,PT008L2,Aveiro,2014,1934,41396,43330,4.463420263097161
587.0,PT009L1,Faro,2014,2506,46644,49150,5.0986775178026456
588.0,PT014L1,Viseu,2014,6,70868,70874,0.008465727911504925
589.0,PT016L0,Viana do Castelo,2014,423,31829,32252,1.311546570755302
590.0,PT019L0,PÃ³voa de Varzim,2014,38,8368,8406,0.45205805377111585
591.0,PT505L1,GuimarÃ£es,2014,1,26540,26541,0.0037677555480200445
592.0,RO001L1,BucureÅti,2014,362,107480,107842,0.3356762671315443
593.0,RO002L1,Cluj-Napoca,2014,10,59292,59302,0.016862837678324506
594.0,RO003L1,TimiÅoara,2014,5,23649,23654,0.02113807389870635
595.0,RO004L1,Craiova,2014,106,34290,34396,0.3081753692289801
596.0,RO005L1,BrÄila,2014,1185,22344,23529,5.0363381359173784
597.0,RO006L1,Oradea,2014,31,20308,20339,0.15241653965288363
598.0,RO007L1,BacÄu,2014,93,22000,22093,0.4209478115240121
599.0,RO008L1,Arad,2014,152,51456,51608,0.29452798015811504
600.0,RO009L1,Sibiu,2014,21,56319,56340,0.03727369542066027
601.0,RO010L1,TÃ¢rgu MureÅ,2014,31,13709,13740,0.22561863173216884
602.0,RO011L1,Piatra NeamÅ£,2014,85,14914,14999,0.5667044469631309
603.0,RO012L1,CÇlÇraÅi,2014,570,23974,24544,2.322359843546284
604.0,RO013L1,Giurgiu,2014,534,10416,10950,4.876712328767123
605.0,RO014L1,Alba Iulia,2014,21,25981,26002,0.08076301822936696
606.0,RO015L1,FocÅani,2014,1,27101,27102,0.0036897645930189654
607.0,RO016L1,TÃ¢rgu Jiu,2014,40,24482,24522,0.1631188320691624
608.0,RO017L1,Tulcea,2014,1408,39539,40947,3.4385913497936356
609.0,RO018L1,TÃ¢rgoviÅte,2014,1,20256,20257,0.004936565137976996
610.0,RO019L1,Slatina,2014,167,6956,7123,2.3445177593710516
611.0,RO020L1,BÃ¢rlad,2014,95,26224,26319,0.36095596337246855
612.0,RO021L1,Roman,2014,8,14382,14390,0.05559416261292564
613.0,RO022L1,BistriÅ£a,2014,0,42631,42631,0.0
614.0,RO501L1,Constanta,2014,5582,53769,59351,9.405064784081144
615.0,RO502L1,Iasi,2014,214,79722,79936,0.26771417133706965
616.0,RO503L1,Galati,2014,2126,39106,41232,5.156189367481568
617.0,RO504L1,Brasov,2014,203,98300,98503,0.20608509385500948
618.0,RO505L1,Ploiesti,2014,2,34335,34337,0.005824620671578763
619.0,RO506L1,Pitesti,2014,190,24694,24884,0.7635428387719017
620.0,RO507L1,Baia Mare,2014,18,52523,52541,0.03425895966959137
621.0,RO508L1,Buzau,2014,0,38540,38540,0.0
622.0,RO509L1,Satu Mare,2014,35,70809,70844,0.049404324995765345
623.0,RO510L1,Botosani,2014,110,37230,37340,0.2945902517407606
624.0,RO511L1,Ramnicu Valcea,2014,720,28453,29173,2.46803551228876
625.0,RO512L1,Suceava,2014,108,39570,39678,0.27219113866626343
626.0,RO513L1,Drobeta-Turnu Severin,2014,2345,30589,32934,7.120301208477561
627.0,RS001L1,Beograd,2014,7044,305980,313024,2.2503066857493357
628.0,RS002L1,Novi Sad,2014,2770,186673,189443,1.4621812365724784
629.0,RS003L1,NiÅ¡,2014,120,341444,341564,0.035132508109753956
630.0,RS004L1,Kragujevac,2014,20,144055,144075,0.013881658858233559
631.0,RS005L1,Subotica,2014,146,160146,160292,0.0910837721158885
632.0,RS006L1,Novi Pazar,2014,6,140785,140791,0.004261636042076553
633.0,RS008L1,Zrenjanin,2014,1452,183679,185131,0.7843094889564686
634.0,RS009L1,Kraljevo,2014,14,176498,176512,0.007931472081218274
635.0,RS011L0,ÄaÄak,2014,71,63616,63687,0.11148272017837235
636.0,RS012L1,KruÅ¡evac,2014,4,122645,122649,0.003261339268970803
637.0,RS013L1,Leskovac,2014,35,166247,166282,0.021048580122923707
638.0,RS014L1,Valjevo,2014,9,141653,141662,0.006353150456720928
639.0,RS015L1,Vranje,2014,5,195351,195356,0.0025594299637584717
640.0,RS016L1,Smederevo,2014,2623,157601,160224,1.6370830836828438
641.0,SE001L1,Stockholm,2014,59421,696305,755726,7.862770369154958
642.0,SE002L1,GÃ¶teborg,2014,15084,420175,435259,3.465522826638852
643.0,SE003L1,MalmÃ¶,2014,2573,185443,188016,1.3685005531444132
644.0,SE004L1,JÃ¶nkÃ¶ping,2014,44756,302435,347191,12.8908871485724
645.0,SE005L1,UmeÃ¥,2014,24989,963260,988249,2.5286137400594386
646.0,SE006L1,Uppsala,2014,13395,684132,697527,1.9203557711744492
647.0,SE007L1,LinkÃ¶ping,2014,17039,406157,423196,4.026266788911048
648.0,SE008L1,Ãrebro,2014,16762,351835,368597,4.547513951551423
649.0,SE501L1,VÃ¤sterÃ¥s,2014,17886,272529,290415,6.158772790661639
650.0,SE502L1,NorrkÃ¶ping,2014,11192,300546,311738,3.5901943298539156
651.0,SE503L1,Helsingborg,2014,1293,113129,114422,1.130027442275087
652.0,SE505L1,BorÃ¥s,2014,1049,96313,97362,1.0774224029908999
653.0,SI001L2,Ljubljana,2014,1320,231967,233287,0.5658266427190541
654.0,SI002L1,Maribor,2014,778,216207,216985,0.3585501301933314
655.0,SK001L1,Bratislava,2014,1952,202989,204941,0.9524692472467686
656.0,SK002L1,KoÅ¡ice,2014,300,177334,177634,0.16888658702725828
657.0,SK003L1,BanskÃ¡ Bystrica,2014,1,80879,80880,0.0012363996043521265
658.0,SK004L1,Nitra,2014,7,87120,87127,0.008034248855119538
659.0,SK005L1,PreÅ¡ov,2014,5,93294,93299,0.0053591142455974876
660.0,SK006L1,Å½ilina,2014,374,81074,81448,0.45918868480502895
661.0,SK007L1,Trnava,2014,134,74086,74220,0.18054432767448128
662.0,SK008L1,TrenÄÃ­n,2014,42,67381,67423,0.062293282707681356
739.0,UK001L3,London,2014,1612,696558,698170,0.2308893249495109
740.0,UK002L3,West Midlands urban area,2014,3153,212156,215309,1.4644069685893297
741.0,UK003L2,Leeds,2014,18016,494411,512427,3.515817862837048
742.0,UK004L1,Glasgow,2014,3144,334540,337684,0.9310479619999763
743.0,UK006L3,Liverpool,2014,502,100001,100503,0.49948757748524925
744.0,UK007L1,Edinburgh,2014,1213,174205,175418,0.691491181064657
745.0,UK008L3,Greater Manchester,2014,921,311325,312246,0.29495974327933744
746.0,UK009L1,Cardiff,2014,153,84338,84491,0.18108437585068232
747.0,UK010L3,Sheffield,2014,5625,120462,126087,4.461205358205049
748.0,UK011L2,Bristol,2014,280,98105,98385,0.2845962290999644
749.0,UK012L2,Belfast,2014,23774,171371,195145,12.182735914320121
750.0,UK013L2,Newcastle upon Tyne,2014,1306,545402,546708,0.23888437703490714
751.0,UK014L1,Leicester,2014,1265,138516,139781,0.9049870869431468
752.0,UK016L1,Aberdeen,2014,1594,652354,653948,0.24375026760537535
753.0,UK017L2,Cambridge,2014,70,159549,159619,0.043854428357526364
754.0,UK018L3,Exeter,2014,1159,246567,247726,0.46785561467104786
755.0,UK019L3,Lincoln,2014,4059,207484,211543,1.918758833901382
756.0,UK023L1,Portsmouth,2014,330,20523,20853,1.5825061142281687
757.0,UK024L1,Worcester,2014,34,61168,61202,0.0555537400738538
758.0,UK025L3,Coventry,2014,465,80982,81447,0.5709234225938341
759.0,UK026L1,Kingston upon Hull,2014,17221,234477,251698,6.8419296140612955
760.0,UK027L1,Stoke-on-Trent,2014,365,87811,88176,0.41394483759753226
761.0,UK029L1,Nottingham,2014,1979,88310,90289,2.191850613031488
762.0,UK033L1,Guildford,2014,0,61691,61691,0.0
763.0,UK050L1,Burnley,2014,0,27974,27974,0.0
764.0,UK056L1,Hastings,2014,90,54660,54750,0.16438356164383564
765.0,UK515L1,Brighton and Hove,2014,324,42083,42407,0.7640248072252223
766.0,UK516L1,Plymouth,2014,1010,214765,215775,0.46808017610937314
767.0,UK517L1,Swansea,2014,367,83675,84042,0.4366864186954142
768.0,UK518L1,Derby,2014,766,67336,68102,1.1247834131156207
769.0,UK520L2,Southampton,2014,2181,151171,153352,1.4222181647451615
770.0,UK528L1,Northampton,2014,18825,135720,154545,12.180918179171115
771.0,UK539L1,Bournemouth,2014,1024,92769,93793,1.0917659100359303
772.0,UK546L1,Colchester,2014,714,68781,69495,1.0274120440319447
773.0,UK550L0,Dundee City,2014,414,226002,226416,0.18284926860292558
774.0,UK551L1,Falkirk,2014,152,29637,29789,0.5102554634260968
775.0,UK552L0,Reading,2014,16,21905,21921,0.07298937092285936
776.0,UK553L1,Blackpool,2014,17,48938,48955,0.03472576856296599
777.0,UK557L1,Blackburn with Darwen,2014,1,79553,79554,0.0012570078185886316
778.0,UK558L1,Newport,2014,59,31641,31700,0.1861198738170347
779.0,UK559L2,Middlesbrough,2014,1417,60352,61769,2.294030986417135
780.0,UK560L1,Oxford,2014,4940,187983,192923,2.560607081581771
781.0,UK562L2,Preston,2014,13,25749,25762,0.050461920658333985
782.0,UK566L1,Norwich,2014,24,150216,150240,0.01597444089456869
783.0,UK568L1,Cheshire West and Chester,2014,327,135818,136145,0.24018509677182415
784.0,UK569L2,Ipswich,2014,1510,154136,155646,0.9701502126620665
785.0,UK571L1,Cheltenham,2014,5,46178,46183,0.010826494597579195
786.0,XK001L1,Pristina,2014,5,255802,255807,0.0019545985840887857
787.0,XK002L1,Prizren,2014,15,127618,127633,0.011752446467606339
788.0,XK003L1,MitrovicÃ«,2014,1,117913,117914,0.0008480757161999422
1.0,AL001L1,Tirana,2015,1610,165511,167121,0.9633738429042431
2.0,AL003L1,Elbasan,2015,635,125369,126004,0.5039522554839528
3.0,AL004L1,ShkodÃ«r,2015,5627,179702,185329,3.036222069940484
4.0,AL005L0,VlorÃ«,2015,2175,61558,63733,3.412674752483015
5.0,AT001L3,Wien,2015,5603,912887,918490,0.6100229724874522
6.0,AT002L3,Graz,2015,353,290779,291132,0.12125084154266794
7.0,AT003L3,Linz,2015,2386,356844,359230,0.6641984244077611
8.0,AT004L3,Salzburg,2015,1773,135703,137476,1.2896796531758272
9.0,AT005L3,Innsbruck,2015,10178,202644,212822,4.78240031575683
10.0,AT006L2,Klagenfurt,2015,2984,180276,183260,1.6282876787078466
11.0,BA001L1,Sarajevo,2015,0,263774,263774,0.0
12.0,BA002L1,Banja Luka,2015,34,275268,275302,0.012350073737204962
13.0,BA003L1,Mostar,2015,1562,180785,182347,0.856608554020631
14.0,BA004L1,Tuzla,2015,814,111447,112261,0.7250959816855365
15.0,BA005L1,Zenica,2015,2,86714,86716,0.0023063794455463814
16.0,BE001L2,Bruxelles / Brussel,2015,86,326565,326651,0.026327793271718133
17.0,BE002L2,Antwerpen,2015,4320,114892,119212,3.623796262121263
18.0,BE003L2,Gent,2015,526,101315,101841,0.5164913934466472
19.0,BE004L2,Charleroi,2015,341,109424,109765,0.31066369061176147
20.0,BE005L2,LiÃ¨ge,2015,175,141223,141398,0.12376412679104372
21.0,BE006L2,Brugge,2015,713,55826,56539,1.261076425122482
22.0,BE007L2,Namur,2015,3,84104,84107,0.0035668850392951835
23.0,BE008L1,Leuven,2015,2,45074,45076,0.004436950927322744
24.0,BE009L1,Mons,2015,149,39051,39200,0.38010204081632654
25.0,BE010L1,Kortrijk,2015,57,22282,22339,0.25515913872599494
26.0,BE011L1,Oostende,2015,155,20777,20932,0.7404930250334416
27.0,BG001L2,Sofia,2015,2654,569120,571774,0.46416940959190167
28.0,BG002L2,Plovdiv,2015,224,276862,277086,0.0808413272413619
29.0,BG003L2,Varna,2015,3925,200873,204798,1.916522622291233
30.0,BG004L2,Burgas,2015,5041,290859,295900,1.7036160865157148
31.0,BG005L1,Pleven,2015,1015,178061,179076,0.566798454287565
32.0,BG006L2,Ruse,2015,2460,131557,134017,1.835588022415067
33.0,BG007L2,Vidin,2015,1741,59223,60964,2.855783741224329
34.0,BG008L2,Stara Zagora,2015,14,132054,132068,0.010600599691068238
35.0,BG009L1,Sliven,2015,107,136667,136774,0.07823124278006054
36.0,BG010L1,Dobrich,2015,6,140332,140338,0.004275392267240519
37.0,BG011L1,Shumen,2015,90,94417,94507,0.09523104108690361
38.0,BG013L1,Yambol,2015,548,130258,130806,0.4189410271700075
39.0,BG014L1,Haskovo,2015,462,73506,73968,0.6245944192083063
40.0,BG015L1,Pazardzhik,2015,10,63812,63822,0.01566857823321112
41.0,BG016L1,Blagoevgrad,2015,71,135408,135479,0.05240664604846507
42.0,BG017L1,Veliko Tarnovo,2015,9,88530,88539,0.010165012028597566
43.0,BG018L1,Vratsa,2015,52,70505,70557,0.07369927859744603
44.0,CH001L2,ZÃ¼rich,2015,82,127635,127717,0.06420445203066154
45.0,CH002L2,GenÃ¨ve,2015,86,53811,53897,0.15956361207488357
46.0,CH003L2,Basel,2015,136,69284,69420,0.19590895995390376
47.0,CH004L2,Bern,2015,50,78238,78288,0.06386674841610464
48.0,CH005L2,Lausanne,2015,2,77503,77505,0.0025804786787949167
49.0,CH006L1,Winterthur,2015,0,13291,13291,0.0
50.0,CH007L2,St. Gallen,2015,97,31812,31909,0.3039894700554702
51.0,CH008L2,Luzern,2015,22,29237,29259,0.07519053966300968
52.0,CH009L2,Lugano,2015,34,30591,30625,0.11102040816326532
53.0,CH010L1,Biel/Bienne,2015,7,9088,9095,0.07696536558548653
54.0,CY001L2,Lefkosia,2015,28,162600,162628,0.017217207368964753
55.0,CY501L2,Lemesos,2015,964,124935,125899,0.7656931349732723
56.0,CZ001L2,Praha,2015,1112,569450,570562,0.1948955591153985
57.0,CZ002L2,Brno,2015,884,267031,267915,0.32995539630106563
58.0,CZ003L2,Ostrava,2015,675,141991,142666,0.4731330520236076
59.0,CZ004L2,PlzeÅ,2015,382,195575,195957,0.19494072679210234
60.0,CZ005L2,ÃstÃ­ nad Labem,2015,82,35829,35911,0.22834229066302805
61.0,CZ006L2,Olomouc,2015,33,93531,93564,0.035269975631653204
62.0,CZ007L2,Liberec,2015,5,61311,61316,0.008154478439559005
63.0,CZ008L2,ÄeskÃ© BudÄjovice,2015,1782,127622,129404,1.3770826249574974
64.0,CZ009L2,Hradec KrÃ¡lovÃ©,2015,75,79430,79505,0.09433368970505
65.0,CZ010L2,Pardubice,2015,66,86291,86357,0.07642692543742835
66.0,CZ011L2,ZlÃ­n,2015,14,57938,57952,0.024157923799006074
67.0,CZ013L2,Karlovy Vary,2015,19,46965,46984,0.0404392984845905
68.0,CZ014L2,Jihlava,2015,114,95913,96027,0.11871661095316942
69.0,CZ016L2,Most,2015,78,27700,27778,0.28079775361797105
70.0,CZ018L2,Chomutov-Jirkov,2015,112,45574,45686,0.24515168760670664
71.0,DE001L1,Berlin,2015,13042,1735223,1748265,0.7459967453446703
72.0,DE002L1,Hamburg,2015,11382,722792,734174,1.5503136858564863
73.0,DE003L1,MÃ¼nchen,2015,4070,545871,549941,0.7400793903345996
74.0,DE004L1,KÃ¶ln,2015,1051,161579,162630,0.646252228986042
75.0,DE005L1,Frankfurt am Main,2015,866,429465,430331,0.20124044049812817
76.0,DE007L1,Stuttgart,2015,96,365074,365170,0.02628912561272832
77.0,DE008L2,Leipzig,2015,3180,394509,397689,0.7996198034142257
78.0,DE009L2,Dresden,2015,5628,577568,583196,0.9650271949739023
79.0,DE011L1,DÃ¼sseldorf,2015,1324,118993,120317,1.1004263736629072
80.0,DE012L1,Bremen,2015,1905,587634,589539,0.32313383847379057
81.0,DE013L1,Hannover,2015,2640,294672,297312,0.8879560865353568
82.0,DE014L1,NÃ¼rnberg,2015,170,293331,293501,0.057921438087093394
83.0,DE017L0,Bielefeld,2015,9,25874,25883,0.03477185797627787
84.0,DE018L1,Halle an der Saale,2015,2439,155147,157586,1.5477263208660668
85.0,DE019L2,Magdeburg,2015,380,416654,417034,0.09111966889989785
86.0,DE020L1,Wiesbaden,2015,788,100650,101438,0.7768291961592302
87.0,DE021L1,GÃ¶ttingen,2015,65,238892,238957,0.027201546721795134
88.0,DE025L1,Darmstadt,2015,61,78126,78187,0.07801808484786474
89.0,DE026L1,Trier,2015,101,121026,121127,0.08338355610227281
90.0,DE027L1,Freiburg im Breisgau,2015,528,220668,221196,0.23870232734769162
91.0,DE028L1,Regensburg,2015,240,253422,253662,0.09461409276911796
92.0,DE029L0,Frankfurt (Oder),2015,56,14788,14844,0.37725680409593104
93.0,DE030L1,Weimar,2015,2,89026,89028,0.0022464842521453922
94.0,DE031L1,Schwerin,2015,5739,484264,490003,1.1712173190776383
95.0,DE032L1,Erfurt,2015,529,284983,285512,0.18528117907478495
96.0,DE033L1,Augsburg,2015,89,199845,199934,0.044514689847649724
97.0,DE034L1,Bonn,2015,668,128669,129337,0.5164802028808462
98.0,DE035L1,Karlsruhe,2015,898,124914,125812,0.713763392999078
99.0,DE036L0,MÃ¶nchengladbach,2015,0,17023,17023,0.0
100.0,DE037L1,Mainz,2015,916,69389,70305,1.3028945309721924
101.0,DE038L1,Ruhrgebiet,2015,3225,440527,443752,0.7267572878544772
102.0,DE039L1,Kiel,2015,7256,332506,339762,2.1356125758619267
103.0,DE040L1,SaarbrÃ¼cken,2015,20,153662,153682,0.013013885816165848
104.0,DE042L1,Koblenz,2015,451,91725,92176,0.48928137476132616
105.0,DE043L2,Rostock,2015,2899,358905,361804,0.8012625620501708
106.0,DE044L1,Kaiserslautern,2015,1,135526,135527,0.0007378603525496764
107.0,DE045L1,Iserlohn,2015,3,106104,106107,0.002827334671605078
108.0,DE048L1,Wilhelmshaven,2015,633,73414,74047,0.8548624522262886
109.0,DE050L1,TÃ¼bingen,2015,3,52022,52025,0.005766458433445459
110.0,DE051L1,Villingen-Schwenningen,2015,25,102535,102560,0.02437597503900156
111.0,DE052L1,Flensburg,2015,1335,204140,205475,0.6497140771383381
112.0,DE053L1,Marburg,2015,58,126184,126242,0.04594350533103088
113.0,DE054L1,Konstanz,2015,84,81816,81900,0.10256410256410256
114.0,DE055L0,NeumÃ¼nster,2015,67,7109,7176,0.9336677814938684
115.0,DE056L0,Brandenburg an der Havel,2015,2038,20792,22830,8.926850635129217
116.0,DE057L1,GieÃen,2015,61,85467,85528,0.0713216724347582
117.0,DE058L1,LÃ¼neburg,2015,100,132402,132502,0.07547055893495946
118.0,DE059L1,Bayreuth,2015,0,199920,199920,0.0
119.0,DE060L1,Celle,2015,14,155033,155047,0.009029520081007695
120.0,DE061L1,Aschaffenburg,2015,425,147191,147616,0.2879091697376978
121.0,DE062L1,Bamberg,2015,62,122093,122155,0.05075518808071712
122.0,DE063L1,Plauen,2015,162,141126,141288,0.11465941905894343
123.0,DE064L1,Neubrandenburg,2015,17891,566100,583991,3.0635746098826866
124.0,DE065L1,Fulda,2015,3,138222,138225,0.002170374389582203
125.0,DE066L1,Kempten (AllgÃ¤u),2015,291,158876,159167,0.1828268422474508
126.0,DE067L1,Landshut,2015,123,141330,141453,0.08695467752539712
127.0,DE069L1,Rosenheim,2015,13,147750,147763,0.00879787226842985
128.0,DE071L1,Stralsund,2015,19391,318857,338248,5.7327759513729575
129.0,DE072L1,Friedrichshafen,2015,82,66537,66619,0.12308800792566685
130.0,DE073L1,Offenburg,2015,442,185442,185884,0.23778270319123754
131.0,DE074L1,GÃ¶rlitz,2015,1389,209718,211107,0.6579601813298469
132.0,DE077L1,Schweinfurt,2015,94,201246,201340,0.04668719578821893
133.0,DE078L1,Greifswald,2015,4316,345478,349794,1.2338690772283116
134.0,DE079L1,Wetzlar,2015,20,106470,106490,0.0187811062071556
135.0,DE081L1,Passau,2015,714,159352,160066,0.44606599777591743
136.0,DE082L0,Dessau-RoÃlau,2015,24,24624,24648,0.09737098344693282
137.0,DE083L1,Braunschweig-Salzgitter-Wolfsburg,2015,476,412368,412844,0.11529778802647005
138.0,DE084L1,Mannheim-Ludwigshafen,2015,679,203749,204428,0.33214628133132446
139.0,DE504L1,MÃ¼nster,2015,74,141689,141763,0.05219979825483377
140.0,DE505L0,Chemnitz,2015,2,22191,22193,0.009011850583517325
141.0,DE507L1,Aachen,2015,143,70377,70520,0.20277935337492908
142.0,DE508L0,Krefeld,2015,104,13576,13680,0.7602339181286549
143.0,DE510L1,LÃ¼beck,2015,3477,158672,162149,2.1443240476352
144.0,DE513L1,Kassel,2015,16,139845,139861,0.011439929644432686
145.0,DE516L0,Solingen,2015,1,8953,8954,0.011168192986374805
146.0,DE517L1,OsnabrÃ¼ck,2015,15,224115,224130,0.00669254450542096
147.0,DE520L1,Oldenburg (Oldenburg),2015,506,189463,189969,0.26635924808784595
148.0,DE522L1,Heidelberg,2015,341,116764,117105,0.29119166559924853
149.0,DE523L1,Paderborn,2015,196,124487,124683,0.1571986557910862
150.0,DE524L2,WÃ¼rzburg,2015,162,305767,305929,0.05295346305842205
151.0,DE527L1,Bremerhaven,2015,975,213504,214479,0.45458995985620976
152.0,DE529L1,Heilbronn,2015,62,119922,119984,0.05167355647419656
153.0,DE530L0,Remscheid,2015,0,7369,7369,0.0
154.0,DE532L1,Ulm,2015,115,199193,199308,0.057699640757019284
155.0,DE533L1,Pforzheim,2015,10,67138,67148,0.01489247632096265
156.0,DE534L1,Ingolstadt,2015,208,284627,284835,0.07302473361770849
157.0,DE535L1,Gera,2015,18,99768,99786,0.018038602609584512
158.0,DE537L1,Reutlingen,2015,2,109280,109282,0.0018301275598909244
159.0,DE539L1,Cottbus,2015,1228,181052,182280,0.673688830370858
160.0,DE540L2,Siegen,2015,8,177556,177564,0.004505417764862247
161.0,DE542L1,Hildesheim,2015,20,120790,120810,0.01655492095025246
162.0,DE544L1,Zwickau,2015,6,94798,94804,0.006328846884097717
163.0,DE546L0,Wuppertal,2015,2,16831,16833,0.011881423394522663
164.0,DE547L2,Jena,2015,0,93068,93068,0.0
165.0,DE548L1,DÃ¼ren,2015,280,93758,94038,0.2977519726068185
166.0,DE549L1,Bocholt,2015,106,142159,142265,0.07450883913822795
167.0,DK001L2,KÃ¸benhavn,2015,15063,276160,291223,5.1723249880675635
168.0,DK002L3,Ãrhus,2015,5845,456679,462524,1.2637182070552013
169.0,DK003L2,Odense,2015,8730,351109,359839,2.4260849991246087
170.0,DK004L3,Aalborg,2015,3312,617147,620459,0.533798365403677
171.0,EE001L1,Tallinn,2015,5877,433184,439061,1.3385383807716924
172.0,EE002L1,Tartu,2015,720,298922,299642,0.24028674217900026
173.0,EE003L0,Narva,2015,291,6598,6889,4.224125417331979
174.0,EL001L1,Athina,2015,5110,304277,309387,1.6516531075966345
175.0,EL002L1,Thessaloniki,2015,2128,139991,142119,1.4973367389300516
176.0,EL003L1,Patra,2015,663,50927,51590,1.2851327776700912
177.0,EL004L1,Irakleio,2015,1072,60312,61384,1.7463834223901995
178.0,EL005L1,Larisa,2015,121,155398,155519,0.07780399822529724
179.0,EL006L1,Volos,2015,267,30549,30816,0.8664330218068536
180.0,EL007L1,Ioannina,2015,2075,130566,132641,1.5643730068380064
181.0,EL008L1,Kavala,2015,307,35261,35568,0.8631354026090868
182.0,EL009L1,Kalamata,2015,269,44183,44452,0.6051471249887519
183.0,ES001L3,Madrid,2015,2277,785326,787603,0.2891050440386845
184.0,ES002L2,Barcelona,2015,1323,263284,264607,0.4999867728366974
185.0,ES003L3,Valencia,2015,3090,172030,175120,1.7645043398812243
186.0,ES004L3,Sevilla,2015,4329,464097,468426,0.9241587785477321
187.0,ES005L2,Zaragoza,2015,163,275975,276138,0.0590284567860997
188.0,ES006L2,MÃ¡laga,2015,936,151806,152742,0.6127980516164513
189.0,ES007L2,Murcia,2015,88,120048,120136,0.07325031630818406
190.0,ES008L2,Las Palmas,2015,831,75765,76596,1.0849130502898323
191.0,ES009L2,Valladolid,2015,207,115322,115529,0.17917579135974518
192.0,ES010L2,Palma de Mallorca,2015,2249,201985,204234,1.101187853148839
193.0,ES011L2,Santiago de Compostela,2015,1,126255,126256,0.0007920415663414017
194.0,ES012L2,Vitoria/Gasteiz,2015,476,158845,159321,0.2987678962597523
195.0,ES013L2,Oviedo,2015,23,93464,93487,0.024602351129033983
196.0,ES014L3,Pamplona/IruÃ±a,2015,93,169421,169514,0.05486272520263813
197.0,ES015L2,Santander,2015,278,69205,69483,0.4000978656649828
198.0,ES016L2,Toledo,2015,465,92933,93398,0.4978693333904366
199.0,ES017L2,Badajoz,2015,764,217985,218749,0.3492587394685233
200.0,ES018L2,LogroÃ±o,2015,3,46135,46138,0.006502232433135377
201.0,ES019L3,Bilbao,2015,765,152556,153321,0.49895317666855815
202.0,ES020L2,CÃ³rdoba,2015,1749,185153,186902,0.9357845287904891
203.0,ES021L2,Alicante/Alacant,2015,412,35646,36058,1.1426035831160908
204.0,ES022L2,Vigo,2015,926,135545,136471,0.6785324354624792
205.0,ES023L2,GijÃ³n,2015,595,52807,53402,1.1141904797573126
206.0,ES025L3,Santa Cruz de Tenerife,2015,1114,65869,66983,1.6631085499305795
207.0,ES026L2,CoruÃ±a (A),2015,384,75591,75975,0.5054294175715697
208.0,ES028L1,Reus,2015,0,11534,11534,0.0
209.0,ES031L1,Lugo,2015,16,133995,134011,0.011939318414160032
210.0,ES033L1,Girona,2015,2,39619,39621,0.005047828171929028
211.0,ES034L1,CÃ¡ceres,2015,1952,236321,238273,0.8192283641033604
212.0,ES035L1,Torrevieja,2015,1700,7138,8838,19.235121068114957
213.0,ES039L1,AvilÃ©s,2015,256,18886,19142,1.3373733152230698
214.0,ES040L1,Talavera de la Reina,2015,551,82715,83266,0.6617346816227512
215.0,ES041L1,Palencia,2015,2,28379,28381,0.007046968041999929
216.0,ES043L1,Ferrol,2015,501,46469,46970,1.0666382797530338
217.0,ES044L1,Pontevedra,2015,114,51502,51616,0.2208617482951023
218.0,ES046L1,Gandia,2015,243,17094,17337,1.4016265789929052
219.0,ES048L1,Guadalajara,2015,3,45380,45383,0.006610404777119186
220.0,ES050L1,Manresa,2015,4,29599,29603,0.01351214403945546
221.0,ES053L1,Ciudad Real,2015,629,95716,96345,0.6528621101250713
222.0,ES054L1,Benidorm,2015,314,20359,20673,1.518889372611619
223.0,ES057L1,Ponferrada,2015,247,62096,62343,0.396195242449032
224.0,ES059L1,Zamora,2015,351,33829,34180,1.0269163253364542
225.0,ES070L1,Irun,2015,44,7198,7242,0.607566970450152
226.0,ES072L1,Arrecife,2015,2992,55942,58934,5.076865646316218
227.0,ES501L3,Granada,2015,324,162300,162624,0.19923258559622195
228.0,ES505L1,Elche/Elx,2015,798,38020,38818,2.055747333711165
229.0,ES506L1,Cartagena,2015,1502,59446,60948,2.464395878453764
230.0,ES508L1,Jerez de la Frontera,2015,198,125908,126106,0.15701076871837977
231.0,ES510L1,Donostia-San SebastiÃ¡n,2015,131,33189,33320,0.3931572629051621
232.0,ES514L1,AlmerÃ­a,2015,738,39992,40730,1.8119322366805795
233.0,ES515L1,Burgos,2015,5,149386,149391,0.0033469218359874426
234.0,ES516L1,Salamanca,2015,20,45624,45644,0.043817369205152924
235.0,ES519L1,Albacete,2015,1,245324,245325,0.0004076225415265464
236.0,ES520L1,CastellÃ³n/CastellÃ³,2015,351,32443,32794,1.0703177410501923
237.0,ES521L1,Huelva,2015,3810,93610,97420,3.910901252309587
238.0,ES522L1,CÃ¡diz,2015,988,23845,24833,3.978576893649579
239.0,ES523L1,LeÃ³n,2015,1,118886,118887,0.0008411348591519679
240.0,ES525L1,Tarragona,2015,450,21290,21740,2.0699172033118676
241.0,ES527L1,JaÃ©n,2015,31,99900,99931,0.03102140476929081
242.0,ES528L1,Lleida,2015,111,70564,70675,0.1570569508312699
243.0,ES529L1,Ourense,2015,228,64940,65168,0.3498649643997054
244.0,ES532L1,Algeciras,2015,540,41754,42294,1.276776847779827
245.0,ES533L1,Marbella,2015,574,68631,69205,0.8294198396069649
246.0,ES537L1,Alcoy,2015,0,20529,20529,0.0
247.0,ES538L1,Ãvila,2015,473,53173,53646,0.8817059985833055
248.0,ES542L1,Cuenca,2015,64,164518,164582,0.0388863909783573
249.0,ES543L1,Eivissa,2015,2075,57327,59402,3.493148378842463
250.0,ES544L1,Linares,2015,13,25763,25776,0.05043451272501552
251.0,ES545L1,Lorca,2015,159,182048,182207,0.08726338724637363
252.0,ES546L1,MÃ©rida,2015,1001,127298,128299,0.7802087311670395
253.0,ES547L1,Sagunto,2015,200,15328,15528,1.287995878413189
254.0,ES550L1,Puerto de la Cruz,2015,1278,26194,27472,4.652009318578917
255.0,ES552L1,Igualada,2015,1,25425,25426,0.003932981986942499
256.0,FI001L3,Helsinki,2015,19596,471922,491518,3.9868326287134956
257.0,FI002L3,Tampere,2015,88566,600077,688643,12.860945366467094
258.0,FI003L4,Turku,2015,18033,448411,466444,3.866058948126678
259.0,FI004L4,Oulu,2015,7874,715947,723821,1.0878380151998908
260.0,FI007L2,Lahti,2015,36022,299381,335403,10.739915862410294
261.0,FI008L2,Kuopio,2015,153357,767049,920406,16.661886167626026
262.0,FI009L2,JyvÃ¤skylÃ¤,2015,61681,415261,476942,12.932599771041343
263.0,FR001L1,Paris,2015,661,1209291,1209952,0.05463026632461453
264.0,FR003L2,Lyon,2015,492,366739,367231,0.13397561752684278
265.0,FR004L2,Toulouse,2015,989,523683,524672,0.18849871919980485
266.0,FR006L2,Strasbourg,2015,915,202968,203883,0.44878680419652445
267.0,FR007L2,Bordeaux,2015,4908,550846,555754,0.883124547911486
268.0,FR008L2,Nantes,2015,2826,313793,316619,0.8925554057084383
269.0,FR009L2,Lille,2015,72,144381,144453,0.04984320159498245
270.0,FR010L2,Montpellier,2015,7283,216635,223918,3.2525299439973567
271.0,FR011L2,Saint-Etienne,2015,35,181020,181055,0.019331142470520007
272.0,FR012L2,Le Havre,2015,907,75531,76438,1.1865825898113505
273.0,FR013L2,Rennes,2015,38,382099,382137,0.009944077647545253
274.0,FR014L2,Amiens,2015,136,244659,244795,0.055556690291876876
275.0,FR016L2,Nancy,2015,84,283425,283509,0.02962868903632689
276.0,FR017L2,Metz,2015,233,176697,176930,0.1316904990674278
277.0,FR018L2,Reims,2015,13,243138,243151,0.005346471945416634
278.0,FR019L2,OrlÃ©ans,2015,832,291135,291967,0.2849637116523443
279.0,FR020L2,Dijon,2015,96,385665,385761,0.024885874932924792
280.0,FR021L2,Poitiers,2015,31,250411,250442,0.01237811549181048
281.0,FR022L2,Clermont-Ferrand,2015,83,266043,266126,0.03118823414472844
282.0,FR023L2,Caen,2015,270,226003,226273,0.11932488630989999
283.0,FR024L2,Limoges,2015,8,317826,317834,0.0025170371955171565
284.0,FR025L2,BesanÃ§on,2015,10,239026,239036,0.0041834702722602455
285.0,FR026L2,Grenoble,2015,669,265179,265848,0.2516475580030694
286.0,FR027L2,Ajaccio,2015,1485,145524,147009,1.010142236189621
289.0,FR032L2,Toulon,2015,2192,104864,107056,2.0475265281721713
290.0,FR034L2,Valenciennes,2015,170,78276,78446,0.2167095836626469
291.0,FR035L2,Tours,2015,322,284526,284848,0.11304274560467337
292.0,FR036L2,Angers,2015,447,230804,231251,0.1932964614207074
293.0,FR037L2,Brest,2015,350,134644,134994,0.2592707824051439
294.0,FR038L2,Le Mans,2015,14,224097,224111,0.006246904435748356
295.0,FR039L1,Avignon,2015,1468,85757,87225,1.6830037259959876
296.0,FR040L2,Mulhouse,2015,7,129759,129766,0.005394325169921243
297.0,FR042L2,Dunkerque,2015,799,90326,91125,0.8768175582990398
298.0,FR043L2,Perpignan,2015,1524,181506,183030,0.8326503851827569
299.0,FR044L2,NÃ®mes,2015,1374,149117,150491,0.9130114093201587
300.0,FR045L2,Pau,2015,15,201744,201759,0.007434612582338334
301.0,FR046L2,Bayonne,2015,620,102010,102630,0.6041118581311508
302.0,FR047L0,Annemasse,2015,2,7798,7800,0.02564102564102564
303.0,FR048L2,Annecy,2015,1527,117516,119043,1.2827297699150726
304.0,FR049L2,Lorient,2015,541,112641,113182,0.47799120001413653
305.0,FR050L2,MontbÃ©liard,2015,29,123028,123057,0.023566314797207798
306.0,FR051L2,Troyes,2015,40,260910,260950,0.015328607012837708
307.0,FR052L2,Saint-Nazaire,2015,393,106742,107135,0.3668269006393802
308.0,FR053L2,La Rochelle,2015,247,111093,111340,0.2218430034129693
309.0,FR056L2,AngoulÃªme,2015,15,214277,214292,0.006999794672689602
310.0,FR057L2,Boulogne-sur-Mer,2015,156,68382,68538,0.22761096034316727
311.0,FR058L2,ChambÃ©ry,2015,1845,99844,101689,1.81435553501362
312.0,FR059L2,Chalon-sur-SaÃ´ne,2015,262,156096,156358,0.1675641796390335
313.0,FR060L2,Chartres,2015,10,161350,161360,0.006197322756569161
314.0,FR061L2,Niort,2015,17,178902,178919,0.009501506268199577
315.0,FR062L2,Calais,2015,152,50078,50230,0.30260800318534736
316.0,FR063L2,BÃ©ziers,2015,395,84748,85143,0.4639253960983287
317.0,FR064L2,Arras,2015,25,107538,107563,0.02324219294738897
318.0,FR065L2,Bourges,2015,83,250236,250319,0.03315769078655635
319.0,FR066L2,Saint-Brieuc,2015,81,115100,115181,0.07032409859264982
320.0,FR067L2,Quimper,2015,411,121511,121922,0.33710076934433486
321.0,FR068L2,Vannes,2015,769,120265,121034,0.635358659550209
322.0,FR069L2,Cherbourg,2015,491,90227,90718,0.5412376816067374
323.0,FR073L2,Tarbes,2015,69,104260,104329,0.06613693220485195
324.0,FR074L2,CompiÃ¨gne,2015,34,98703,98737,0.034434912950565645
325.0,FR076L2,Belfort,2015,36,65583,65619,0.054862158825949796
326.0,FR077L2,Roanne,2015,5,123195,123200,0.004058441558441558
327.0,FR079L2,Saint-Quentin,2015,32,99342,99374,0.03220158190271097
328.0,FR082L2,Beauvais,2015,13,131129,131142,0.009912918820820179
329.0,FR084L2,Creil,2015,56,29587,29643,0.1889147522180616
330.0,FR086L2,Evreux,2015,11,126559,126570,0.008690843011772142
331.0,FR090L2,ChÃ¢teauroux,2015,315,260862,261177,0.12060786363270884
332.0,FR093L2,Brive-la-Gaillarde,2015,4,132578,132582,0.0030170007995052118
333.0,FR096L2,Albi,2015,254,133984,134238,0.18921616829809743
334.0,FR099L2,FrÃ©jus,2015,428,43985,44413,0.9636818048769504
335.0,FR104L2,ChÃ¢lons-en-Champagne,2015,2,152807,152809,0.0013088234331747476
336.0,FR203L2,Marseille,2015,2820,422956,425776,0.6623200931945435
337.0,FR205L2,Nice,2015,863,306477,307340,0.28079651200624717
338.0,FR207L2,Lens - LiÃ©vin,2015,31,25277,25308,0.12249091196459617
339.0,FR208L1,HÃ©nin - Carvin,2015,3,11595,11598,0.02586652871184687
340.0,FR209L2,Douai,2015,211,44873,45084,0.46801526040280367
341.0,FR214L1,Valence,2015,368,90593,90961,0.4045689911060784
342.0,FR215L2,Rouen,2015,1137,285989,287126,0.3959933966272647
343.0,FR304L1,Melun,2015,5,44831,44836,0.011151753055580338
344.0,FR324L1,Martigues,2015,1717,18739,20456,8.393625342197888
345.0,FR505L1,Charleville-MÃ©ziÃ¨res,2015,6,135363,135369,0.004432329410721804
346.0,FR506L1,Colmar,2015,53,101932,101985,0.051968426729420994
347.0,FR519L1,Cannes,2015,495,19641,20136,2.458283671036949
348.0,HR001L2,Grad Zagreb,2015,208,505660,505868,0.04111744565776052
349.0,HR002L2,Rijeka,2015,590,106644,107234,0.5501986310312028
350.0,HR003L2,Slavonski Brod,2015,291,97539,97830,0.2974547684759276
351.0,HR004L2,Osijek,2015,1579,171355,172934,0.9130650999803394
352.0,HR005L2,Split,2015,2980,336090,339070,0.8788745686731353
353.0,HR006L1,Pula - Pola,2015,1295,57602,58897,2.1987537565580593
354.0,HR007L1,Zadar,2015,2452,154048,156500,1.5667731629392971
355.0,HU001L2,Budapest,2015,7087,632047,639134,1.108844154746892
356.0,HU002L2,Miskolc,2015,594,164075,164669,0.3607236334707808
357.0,HU003L2,NyÃ­regyhÃ¡za,2015,237,167988,168225,0.14088274632189032
358.0,HU004L2,PÃ©cs,2015,200,185288,185488,0.1078236867074959
359.0,HU005L2,Debrecen,2015,324,201254,201578,0.16073182589369872
360.0,HU006L2,Szeged,2015,890,160043,160933,0.5530251719659734
361.0,HU007L2,GyÃµr,2015,525,204115,204640,0.2565480844409695
362.0,HU008L2,KecskemÃ©t,2015,131,182008,182139,0.07192309170468708
363.0,HU009L2,SzÃ©kesfehÃ©rvÃ¡r,2015,1480,299643,301123,0.4914935092968654
364.0,HU010L1,Szombathely,2015,31,134246,134277,0.02308660455625312
365.0,HU011L1,Szolnok,2015,765,143210,143975,0.5313422469178677
366.0,HU012L1,TatabÃ¡nya,2015,107,69723,69830,0.15322927108692538
367.0,HU013L1,VeszprÃ©m,2015,7147,124173,131320,5.4424307036247335
368.0,HU014L1,BÃ©kÃ©scsaba,2015,140,106023,106163,0.13187268634081553
369.0,HU015L1,KaposvÃ¡r,2015,234,145326,145560,0.16075845012366036
370.0,HU016L1,Eger,2015,109,100469,100578,0.10837360058859791
371.0,HU017L1,DunaÃºjvÃ¡ros,2015,777,60893,61670,1.2599318955732122
372.0,HU018L1,Zalaegerszeg,2015,213,139766,139979,0.15216568199515643
373.0,HU019L1,Sopron,2015,535,80135,80670,0.6631957357134003
374.0,IE001L1,Dublin,2015,2912,700690,703602,0.41387034147145685
375.0,IE002L1,Cork,2015,2685,326978,329663,0.8144681083409421
376.0,IE003L1,Limerick,2015,9376,147082,156458,5.992662567590024
377.0,IE004L1,Galway,2015,8043,218240,226283,3.554398695438897
378.0,IE005L1,Waterford,2015,978,94879,95857,1.020269776855107
379.0,IS001L1,ReykjavÃ­k,2015,214908,1082322,1297230,16.566684396753082
380.0,IT001L3,Roma,2015,8837,608379,617216,1.4317516072169225
381.0,IT002L3,Milano,2015,15,384030,384045,0.0039057922899660195
382.0,IT003L3,Napoli,2015,2992,149950,152942,1.9562971583999162
383.0,IT004L2,Torino,2015,62,170117,170179,0.036432227243079346
384.0,IT005L3,Palermo,2015,1684,148389,150073,1.1221205679902448
385.0,IT006L3,Genova,2015,658,120106,120764,0.5448643635520519
386.0,IT007L3,Firenze,2015,88,163683,163771,0.05373356699293526
387.0,IT008L3,Bari,2015,707,112722,113429,0.6232973930828977
388.0,IT009L1,Bologna,2015,62,185195,185257,0.03346702148906654
389.0,IT010L2,Catania,2015,525,60900,61425,0.8547008547008548
390.0,IT011L2,Venezia,2015,1819,65218,67037,2.7134269134955322
391.0,IT012L3,Verona,2015,54,73107,73161,0.07380981670562184
392.0,IT013L3,Cremona,2015,144,60253,60397,0.23842243820057285
393.0,IT014L3,Trento,2015,616,97571,98187,0.6273742959862304
394.0,IT015L1,Trieste,2015,337,21300,21637,1.557517215880205
395.0,IT016L3,Perugia,2015,5950,125078,131028,4.541014134383491
396.0,IT017L3,Ancona,2015,483,43760,44243,1.0916981217367718
397.0,IT019L2,Pescara,2015,255,16188,16443,1.5508118956394819
398.0,IT020L3,Campobasso,2015,463,102372,102835,0.4502358146545437
399.0,IT021L2,Caserta,2015,1,9341,9342,0.010704345964461572
400.0,IT022L2,Taranto,2015,3415,103513,106928,3.1937378422863985
401.0,IT023L2,Potenza,2015,139,138316,138455,0.10039362969918024
402.0,IT024L3,Catanzaro,2015,327,89756,90083,0.3629985679873006
403.0,IT025L3,Reggio di Calabria,2015,591,47657,48248,1.2249212402586636
404.0,IT026L3,Sassari,2015,2228,150997,153225,1.4540708108990048
405.0,IT027L2,Cagliari,2015,4875,190417,195292,2.4962620076603237
406.0,IT028L3,Padova,2015,3,61442,61445,0.004882415168036456
407.0,IT029L3,Brescia,2015,84,60185,60269,0.13937513481225836
408.0,IT030L3,Modena,2015,135,69133,69268,0.19489518969798464
409.0,IT031L3,Foggia,2015,4,89707,89711,0.004458762024723836
410.0,IT032L3,Salerno,2015,335,37504,37839,0.8853299505800892
411.0,IT033L2,Piacenza,2015,183,93944,94127,0.19441817969339298
412.0,IT034L1,Bolzano,2015,802,105954,106756,0.7512458316160215
413.0,IT035L2,Udine,2015,0,71830,71830,0.0
414.0,IT036L2,La Spezia,2015,601,42318,42919,1.4003122160348564
415.0,IT037L1,Lecce,2015,328,61182,61510,0.5332466265647863
416.0,IT038L1,Barletta,2015,228,14869,15097,1.5102338212889979
417.0,IT039L2,Pesaro,2015,134,25557,25691,0.5215834338873535
418.0,IT040L2,Como,2015,503,19238,19741,2.5479965553923307
419.0,IT041L2,Pisa,2015,449,47604,48053,0.9343849499510957
420.0,IT042L1,Treviso,2015,31,24014,24045,0.1289249324183822
421.0,IT043L2,Varese,2015,464,23200,23664,1.9607843137254901
422.0,IT045L2,Asti,2015,10,54826,54836,0.018236195200233424
423.0,IT046L2,Pavia,2015,20,36184,36204,0.055242514639266375
424.0,IT047L1,Massa,2015,218,11025,11243,1.9389842568709421
425.0,IT048L2,Cosenza,2015,366,92113,92479,0.3957655251462494
426.0,IT052L1,Savona,2015,194,28511,28705,0.6758404459153458
427.0,IT054L1,Matera,2015,639,77150,77789,0.8214529046523287
428.0,IT056L1,Acireale,2015,52,5936,5988,0.8684034736138945
429.0,IT057L2,Avellino,2015,0,39759,39759,0.0
430.0,IT058L2,Pordenone,2015,4,37046,37050,0.010796221322537112
431.0,IT060L1,Lecco,2015,1415,28797,30212,4.683569442605587
432.0,IT061L0,Altamura,2015,0,42800,42800,0.0
433.0,IT064L1,Battipaglia,2015,53,6433,6486,0.8171446191797719
434.0,IT065L0,Bisceglie,2015,80,6864,6944,1.1520737327188941
435.0,IT066L1,Carpi,2015,3,20619,20622,0.014547570555717195
436.0,IT067L0,Cerignola,2015,140,58757,58897,0.23770310881708745
437.0,IT068L1,Gallarate,2015,0,5319,5319,0.0
438.0,IT069L1,Gela,2015,417,57478,57895,0.7202694533206667
439.0,IT073L1,Sassuolo,2015,0,24062,24062,0.0
440.0,IT501L2,Messina,2015,785,33658,34443,2.2791278343930554
441.0,IT502L2,Prato,2015,4,40955,40959,0.00976586342440001
442.0,IT503L3,Parma,2015,95,113412,113507,0.08369527870527808
443.0,IT504L3,Livorno,2015,341,25473,25814,1.3209886108313318
444.0,IT505L3,Reggio nell'Emilia,2015,1,69033,69034,0.0014485615783526957
445.0,IT506L2,Ravenna,2015,3474,77715,81189,4.278904777740826
446.0,IT507L2,Ferrara,2015,111,91372,91483,0.12133401834220567
447.0,IT508L3,Rimini,2015,317,32262,32579,0.9730194296939746
448.0,IT509L3,Siracusa,2015,545,33597,34142,1.5962743834573252
449.0,IT511L2,Bergamo,2015,0,18556,18556,0.0
450.0,IT512L3,ForlÃ¬,2015,6,72745,72751,0.008247309315335872
451.0,IT513L3,Latina,2015,527,65966,66493,0.7925646308633991
452.0,IT514L2,Vicenza,2015,1,34981,34982,0.0028586130009719286
453.0,IT515L2,Terni,2015,130,102202,102332,0.12703748583043425
454.0,IT516L2,Novara,2015,0,54165,54165,0.0
455.0,IT518L1,Alessandria,2015,23,76891,76914,0.029903528616376733
456.0,IT519L1,Arezzo,2015,0,88627,88627,0.0
457.0,IT520L1,Grosseto,2015,420,119179,119599,0.3511735047951906
458.0,IT521L1,Brindisi,2015,827,63160,63987,1.2924500289121228
459.0,IT522L1,Trapani,2015,961,49829,50790,1.8921047450285489
460.0,IT523L1,Ragusa,2015,256,52594,52850,0.48438978240302744
461.0,IT524L0,Andria,2015,0,39880,39880,0.0
462.0,IT525L0,Trani,2015,110,10269,10379,1.0598323537913095
463.0,IT526L1,L'Aquila,2015,1354,138915,140269,0.9652881249598985
464.0,LT001L1,Vilnius,2015,4103,420466,424569,0.9663917996839146
465.0,LT002L1,Kaunas,2015,1144,160907,162051,0.7059505958000877
466.0,LT003L1,PanevÄÅ¾ys,2015,74,222734,222808,0.03321245197658971
467.0,LT004L0,Alytus,2015,6,3953,3959,0.15155342258145996
468.0,LT501L0,KlaipÄda,2015,93,8830,8923,1.0422503642272778
469.0,LT502L0,Å iauliai,2015,707,7338,8045,8.788067122436296
470.0,LU001L1,Luxembourg,2015,38,259677,259715,0.014631422905877597
471.0,LV001L1,RÄ«ga,2015,8894,607355,616249,1.4432477780897008
472.0,LV002L2,LiepÄja,2015,2904,269153,272057,1.067423370837729
473.0,LV003L1,Jelgava,2015,177,166282,166459,0.10633249028289249
474.0,LV501L1,Daugavpils,2015,2259,257416,259675,0.8699335708096658
475.0,ME001L1,Podgorica,2015,1165,183316,184481,0.6315013470221865
476.0,MK001L1,Skopje,2015,5,224348,224353,0.0022286307738251772
477.0,MK003L1,Bitola,2015,215,119447,119662,0.17967274489812973
478.0,MK004L1,Tetovo,2015,0,105621,105621,0.0
479.0,MK005L1,Prilep,2015,59,86772,86831,0.06794808305789407
480.0,MT001L1,Valletta,2015,933,25023,25956,3.5945446139620896
481.0,NL001L3,s' Gravenhage,2015,3036,39671,42707,7.108904863371344
482.0,NL002L3,Amsterdam,2015,73194,259763,332957,21.9830188282571
483.0,NL003L3,Rotterdam,2015,29158,188013,217171,13.426286198433493
484.0,NL004L3,Utrecht,2015,772,96515,97287,0.7935284262028842
485.0,NL005L3,Eindhoven,2015,105,144301,144406,0.07271166018032492
486.0,NL006L3,Tilburg,2015,31,43203,43234,0.07170282647915992
487.0,NL007L3,Groningen,2015,3021,205139,208160,1.4512874711760184
488.0,NL008L3,Enschede,2015,148,84808,84956,0.17420782522717643
489.0,NL009L3,Arnhem,2015,544,55354,55898,0.9732011878779204
490.0,NL010L3,Heerlen,2015,19,33324,33343,0.05698347479231023
491.0,NL012L3,Breda,2015,1315,72055,73370,1.7922856753441458
492.0,NL013L3,Nijmegen,2015,841,38995,39836,2.1111557385279647
493.0,NL014L3,Apeldoorn,2015,13,71111,71124,0.018277937123896294
494.0,NL015L3,Leeuwarden,2015,1188,109735,110923,1.0710132253905862
495.0,NL016L3,Sittard-Geleen,2015,28,22884,22912,0.12220670391061453
496.0,NL020L3,Roosendaal,2015,0,24574,24574,0.0
497.0,NL026L0,Alphen aan den Rijn,2015,31,13179,13210,0.23467070401211204
498.0,NL028L3,Bergen op Zoom,2015,1956,32825,34781,5.623760098904575
499.0,NL030L0,Gouda,2015,8,1780,1788,0.44742729306487694
500.0,NL032L3,MiddelburgÂ Â Â Â Â Â ,2015,1061,22327,23388,4.536514451855653
501.0,NL503L3,s-Hertogenbosch,2015,302,36557,36859,0.8193385604601318
502.0,NL504L3,Amersfoort,2015,2,12242,12244,0.01633453119895459
503.0,NL505L3,Maastricht,2015,57,20328,20385,0.27961736571008095
504.0,NL507L3,Leiden,2015,325,19456,19781,1.6429907486982458
505.0,NL511L3,Zwolle,2015,1005,122015,123020,0.8169403349048934
506.0,NL512L3,Ede,2015,13,35252,35265,0.0368637459237204
507.0,NL513L3,Deventer,2015,67,25178,25245,0.26539908892850067
508.0,NL514L3,Alkmaar,2015,238,47554,47792,0.49799129561432876
509.0,NL515L3,Venlo,2015,236,51000,51236,0.4606136310406745
510.0,NL519L3,Almelo,2015,12,42013,42025,0.028554431885782272
511.0,NL520L3,Lelystad,2015,58530,60312,118842,49.250265057807844
512.0,NL521L3,Oss,2015,41,33105,33146,0.12369516683762748
513.0,NL522L3,Assen,2015,115,70747,70862,0.1622872625666789
514.0,NL524L3,Veenendaal,2015,36,8149,8185,0.43982895540623085
515.0,NL529L3,Soest,2015,1,7941,7942,0.012591286829513975
516.0,NO001L1,Oslo,2015,24362,722281,746643,3.2628712785092744
517.0,NO002L1,Bergen,2015,25123,332620,357743,7.022639157160309
518.0,NO003L1,Trondheim,2015,17793,655463,673256,2.6428282852287985
519.0,NO004L1,Stavanger,2015,17887,271190,289077,6.187624750499002
520.0,NO005L1,Kristiansand,2015,9096,306366,315462,2.883390075508302
521.0,NO006L1,TromsÃ¸,2015,42808,331805,374613,11.427259598572395
522.0,PL001L2,Warszawa,2015,3310,857933,861243,0.3843282325661863
523.0,PL002L2,ÅÃ³dÅº,2015,25,169475,169500,0.014749262536873156
524.0,PL003L2,KrakÃ³w,2015,679,375069,375748,0.1807062179971683
525.0,PL004L2,WrocÅaw,2015,792,263908,264700,0.29920664903664523
526.0,PL005L2,PoznaÅ,2015,879,308449,309328,0.2841643821445197
527.0,PL006L2,GdaÅsk,2015,1032,262484,263516,0.391627073877867
528.0,PL007L2,Szczecin,2015,4828,108232,113060,4.2702989563063865
529.0,PL008L2,Bydgoszcz,2015,1541,208595,210136,0.733334602352762
530.0,PL009L2,Lublin,2015,430,322354,322784,0.13321602062060078
531.0,PL010L2,Katowice,2015,689,393906,394595,0.1746094096478668
532.0,PL011L2,BiaÅystok,2015,52,223270,223322,0.02328476370442679
533.0,PL012L2,Kielce,2015,96,224133,224229,0.04281337382764941
534.0,PL013L2,ToruÅ,2015,1254,157679,158933,0.7890117219205578
535.0,PL014L2,Olsztyn,2015,5412,197132,202544,2.672012007267557
536.0,PL015L2,RzeszÃ³w,2015,113,229236,229349,0.04926988999298013
537.0,PL016L2,Opole,2015,1573,175043,176616,0.8906327852516194
538.0,PL017L2,GorzÃ³w Wielkopolski,2015,78,97342,97420,0.08006569492917266
539.0,PL018L2,Zielona GÃ³ra,2015,102,169182,169284,0.060253774721769335
540.0,PL019L2,Jelenia GÃ³ra,2015,1235,82106,83341,1.481863668542494
541.0,PL020L2,Nowy SÄcz,2015,671,129747,130418,0.5144995322731525
542.0,PL021L2,SuwaÅki,2015,1130,71003,72133,1.5665506772212443
543.0,PL022L2,Konin,2015,680,117483,118163,0.5754762489104034
544.0,PL024L2,CzÄstochowa,2015,8,193890,193898,0.004125880617644329
545.0,PL025L2,Radom,2015,10,68012,68022,0.01470112610625974
546.0,PL026L2,PÅock,2015,2088,168987,171075,1.2205173169662429
547.0,PL027L2,Kalisz,2015,89,148934,149023,0.05972232474181837
548.0,PL028L2,Koszalin,2015,115,129556,129671,0.08868598221653261
549.0,PL029L1,SÅupsk,2015,8020,226984,235004,3.412707868802233
550.0,PL030L1,JastrzÄbie-ZdrÃ³j,2015,0,29571,29571,0.0
551.0,PL031L1,Siedlce,2015,88,126081,126169,0.06974771932883671
552.0,PL032L1,PiotrkÃ³w Trybunalski,2015,17,116905,116922,0.014539607601648963
553.0,PL033L1,Lubin,2015,183,93123,93306,0.19612886631084817
554.0,PL034L1,PiÅa,2015,130,52062,52192,0.2490803188228081
555.0,PL035L1,InowrocÅaw,2015,15,20113,20128,0.07452305246422894
556.0,PL036L1,Ostrowiec ÅwiÄtokrzyski,2015,2,61458,61460,0.003254149040026033
557.0,PL037L1,Gniezno,2015,192,66379,66571,0.28841387390905954
558.0,PL038L1,Stargard SzczeciÅski,2015,2070,34594,36664,5.645865153829369
559.0,PL039L1,OstrÃ³w Wielkopolski,2015,51,84710,84761,0.06016918158115171
560.0,PL040L1,PrzemyÅl,2015,239,84850,85089,0.28088237022411827
561.0,PL041L1,ZamoÅÄ,2015,282,112425,112707,0.2502062870984056
562.0,PL042L1,CheÅm,2015,34,46536,46570,0.07300837449001503
563.0,PL043L1,Pabianice,2015,1,32958,32959,0.0030340726356988985
564.0,PL044L1,GÅogÃ³w,2015,27,64054,64081,0.04213417393611211
565.0,PL045L1,Stalowa Wola,2015,319,189994,190313,0.16761860724175437
566.0,PL046L1,TomaszÃ³w Mazowiecki,2015,362,18801,19163,1.8890570369983823
567.0,PL047L1,ÅomÅ¼a,2015,8,55994,56002,0.014285204099853576
568.0,PL048L1,Leszno,2015,118,77454,77572,0.15211674315474658
569.0,PL049L1,Åwidnica,2015,16,47974,47990,0.03334027922483851
570.0,PL051L1,Tczew,2015,276,26848,27124,1.017549034065772
571.0,PL052L1,EÅk,2015,1524,38528,40052,3.8050534305402977
572.0,PL506L2,Bielsko-BiaÅa,2015,151,73284,73435,0.20562402124327636
573.0,PL508L1,Rybnik,2015,0,14881,14881,0.0
574.0,PL511L2,WaÅbrzych,2015,9,51501,51510,0.017472335468841003
575.0,PL512L2,ElblÄg,2015,16,96459,96475,0.016584607411246437
576.0,PL513L2,WÅocÅawek,2015,2011,120468,122479,1.6419141240539195
577.0,PL514L2,TarnÃ³w,2015,187,125140,125327,0.14920966750979436
578.0,PL516L2,Legnica,2015,157,56343,56500,0.2778761061946903
579.0,PL517L2,GrudziÄdz,2015,318,54725,55043,0.5777301382555456
580.0,PT001L3,Lisboa,2015,7348,431933,439281,1.672733398439723
581.0,PT002L2,Porto,2015,1107,94633,95740,1.1562565280969292
582.0,PT003L1,Braga,2015,45,49304,49349,0.0911872581004681
583.0,PT004L2,Funchal,2015,967,34995,35962,2.688949446638118
584.0,PT005L2,Coimbra,2015,426,162361,162787,0.2616916584248128
585.0,PT007L1,Ponta Delgada,2015,199,55095,55294,0.35989438275400587
586.0,PT008L2,Aveiro,2015,1859,41471,43330,4.290330025386568
587.0,PT009L1,Faro,2015,2494,46656,49150,5.074262461851475
588.0,PT014L1,Viseu,2015,6,70868,70874,0.008465727911504925
589.0,PT016L0,Viana do Castelo,2015,390,31862,32252,1.2092273347389308
590.0,PT019L0,PÃ³voa de Varzim,2015,32,8374,8406,0.3806804663335713
591.0,PT505L1,GuimarÃ£es,2015,0,26541,26541,0.0
592.0,RO001L1,BucureÅti,2015,568,107274,107842,0.5266964633445226
593.0,RO002L1,Cluj-Napoca,2015,0,59302,59302,0.0
594.0,RO003L1,TimiÅoara,2015,2,23652,23654,0.00845522955948254
595.0,RO004L1,Craiova,2015,55,34341,34396,0.15990231422258402
596.0,RO005L1,BrÄila,2015,1245,22284,23529,5.291342598495474
597.0,RO006L1,Oradea,2015,52,20287,20339,0.25566645361128865
598.0,RO007L1,BacÄu,2015,128,21965,22093,0.5793690309147694
599.0,RO008L1,Arad,2015,150,51458,51608,0.2906526119981398
600.0,RO009L1,Sibiu,2015,0,56340,56340,0.0
601.0,RO010L1,TÃ¢rgu MureÅ,2015,10,13730,13740,0.0727802037845706
602.0,RO011L1,Piatra NeamÅ£,2015,81,14918,14999,0.54003600240016
603.0,RO012L1,CÇlÇraÅi,2015,507,24037,24544,2.065677966101695
604.0,RO013L1,Giurgiu,2015,541,10409,10950,4.940639269406392
605.0,RO014L1,Alba Iulia,2015,2,26000,26002,0.007691716021844474
606.0,RO015L1,FocÅani,2015,19,27083,27102,0.07010552726736034
607.0,RO016L1,TÃ¢rgu Jiu,2015,0,24522,24522,0.0
608.0,RO017L1,Tulcea,2015,1473,39474,40947,3.5973331379588247
609.0,RO018L1,TÃ¢rgoviÅte,2015,1,20256,20257,0.004936565137976996
610.0,RO019L1,Slatina,2015,101,7022,7123,1.4179418784220132
611.0,RO020L1,BÃ¢rlad,2015,89,26230,26319,0.33815874463315476
612.0,RO021L1,Roman,2015,32,14358,14390,0.22237665045170257
613.0,RO022L1,BistriÅ£a,2015,0,42631,42631,0.0
614.0,RO501L1,Constanta,2015,4972,54379,59351,8.377280921972671
615.0,RO502L1,Iasi,2015,207,79729,79936,0.25895716573258604
616.0,RO503L1,Galati,2015,2674,38558,41232,6.485254171517268
617.0,RO504L1,Brasov,2015,14,98489,98503,0.014212765093448931
618.0,RO505L1,Ploiesti,2015,17,34320,34337,0.04950927570841949
619.0,RO506L1,Pitesti,2015,25,24859,24884,0.10046616299630284
620.0,RO507L1,Baia Mare,2015,28,52513,52541,0.05329171504158657
621.0,RO508L1,Buzau,2015,25,38515,38540,0.06486766995329528
622.0,RO509L1,Satu Mare,2015,20,70824,70844,0.028231042854723054
623.0,RO510L1,Botosani,2015,79,37261,37340,0.21156936261381895
624.0,RO511L1,Ramnicu Valcea,2015,214,28959,29173,0.7335549994858259
625.0,RO512L1,Suceava,2015,105,39573,39678,0.26463027370331166
626.0,RO513L1,Drobeta-Turnu Severin,2015,2084,30850,32934,6.327807129410336
627.0,RS001L1,Beograd,2015,6581,306443,313024,2.1023947045593947
628.0,RS002L1,Novi Sad,2015,2631,186812,189443,1.3888082431127042
629.0,RS003L1,NiÅ¡,2015,12,341552,341564,0.0035132508109753952
630.0,RS004L1,Kragujevac,2015,559,143516,144075,0.38799236508762797
631.0,RS005L1,Subotica,2015,297,159995,160292,0.18528685149601976
632.0,RS006L1,Novi Pazar,2015,49,140742,140791,0.034803361010291856
633.0,RS008L1,Zrenjanin,2015,1296,183835,185131,0.7000448331181703
634.0,RS009L1,Kraljevo,2015,6,176506,176512,0.0033992023205221176
635.0,RS011L0,ÄaÄak,2015,9,63678,63687,0.014131612416976778
636.0,RS012L1,KruÅ¡evac,2015,0,122649,122649,0.0
637.0,RS013L1,Leskovac,2015,5,166277,166282,0.0030069400175605295
638.0,RS014L1,Valjevo,2015,25,141637,141662,0.017647640157558132
639.0,RS015L1,Vranje,2015,2,195354,195356,0.0010237719855033887
640.0,RS016L1,Smederevo,2015,2637,157587,160224,1.6458208508088676
641.0,SE001L1,Stockholm,2015,58814,696912,755726,7.782450253134073
642.0,SE002L1,GÃ¶teborg,2015,19861,415398,435259,4.563030287713752
643.0,SE003L1,MalmÃ¶,2015,2748,185268,188016,1.4615777380648456
644.0,SE004L1,JÃ¶nkÃ¶ping,2015,52151,295040,347191,15.02083867381355
645.0,SE005L1,UmeÃ¥,2015,21652,966597,988249,2.1909458041445022
646.0,SE006L1,Uppsala,2015,12874,684653,697527,1.8456633219932703
647.0,SE007L1,LinkÃ¶ping,2015,20676,402520,423196,4.885679448766057
648.0,SE008L1,Ãrebro,2015,24451,344146,368597,6.633532014639294
649.0,SE501L1,VÃ¤sterÃ¥s,2015,16991,273424,290415,5.850593116746724
650.0,SE502L1,NorrkÃ¶ping,2015,15858,295880,311738,5.086964053147194
651.0,SE503L1,Helsingborg,2015,1318,113104,114422,1.151876387408016
652.0,SE505L1,BorÃ¥s,2015,2545,94817,97362,2.6139561635956534
653.0,SI001L2,Ljubljana,2015,389,232898,233287,0.16674739698311522
654.0,SI002L1,Maribor,2015,759,216226,216985,0.34979376454593636
655.0,SK001L1,Bratislava,2015,1777,203164,204941,0.8670788178061002
656.0,SK002L1,KoÅ¡ice,2015,105,177529,177634,0.0591103054595404
657.0,SK003L1,BanskÃ¡ Bystrica,2015,5,80875,80880,0.0061819980217606325
658.0,SK004L1,Nitra,2015,12,87115,87127,0.013772998037347781
659.0,SK005L1,PreÅ¡ov,2015,19,93280,93299,0.020364634133270453
660.0,SK006L1,Å½ilina,2015,139,81309,81448,0.1706610352617621
661.0,SK007L1,Trnava,2015,100,74120,74220,0.13473457289140395
662.0,SK008L1,TrenÄÃ­n,2015,32,67391,67423,0.04746154872966198
739.0,UK001L3,London,2015,2753,695417,698170,0.3943165704627813
740.0,UK002L3,West Midlands urban area,2015,165,215144,215309,0.07663404688145874
741.0,UK003L2,Leeds,2015,2289,510138,512427,0.4466977735365233
742.0,UK004L1,Glasgow,2015,2618,335066,337684,0.7752810319707182
743.0,UK006L3,Liverpool,2015,660,99843,100503,0.6566968150204472
744.0,UK007L1,Edinburgh,2015,949,174469,175418,0.5409935126383838
745.0,UK008L3,Greater Manchester,2015,5044,307202,312246,1.615392991423429
746.0,UK009L1,Cardiff,2015,149,84342,84491,0.17635014380229846
747.0,UK010L3,Sheffield,2015,782,125305,126087,0.6202066826873508
748.0,UK011L2,Bristol,2015,249,98136,98385,0.2530873608781826
749.0,UK012L2,Belfast,2015,21826,173319,195145,11.184503830485024
750.0,UK013L2,Newcastle upon Tyne,2015,2126,544582,546708,0.38887303642895293
751.0,UK014L1,Leicester,2015,42,139739,139781,0.030047002096136102
752.0,UK016L1,Aberdeen,2015,5268,648680,653948,0.8055686384850171
753.0,UK017L2,Cambridge,2015,52,159567,159619,0.032577575351305295
754.0,UK018L3,Exeter,2015,963,246763,247726,0.38873594212961093
755.0,UK019L3,Lincoln,2015,264,211279,211543,0.12479732253017116
756.0,UK023L1,Portsmouth,2015,325,20528,20853,1.5585287488610753
757.0,UK024L1,Worcester,2015,118,61084,61202,0.19280415672690435
758.0,UK025L3,Coventry,2015,20,81427,81447,0.02455584613306813
759.0,UK026L1,Kingston upon Hull,2015,525,251173,251698,0.2085833022113803
760.0,UK027L1,Stoke-on-Trent,2015,375,87801,88176,0.4252857920522591
761.0,UK029L1,Nottingham,2015,31,90258,90289,0.03433419353409607
762.0,UK033L1,Guildford,2015,13,61678,61691,0.021072765881571056
763.0,UK050L1,Burnley,2015,66,27908,27974,0.23593336669764783
764.0,UK056L1,Hastings,2015,67,54683,54750,0.1223744292237443
765.0,UK515L1,Brighton and Hove,2015,298,42109,42407,0.702714174546655
766.0,UK516L1,Plymouth,2015,1006,214769,215775,0.4662263932336925
767.0,UK517L1,Swansea,2015,411,83631,84042,0.48904119368886984
768.0,UK518L1,Derby,2015,28,68074,68102,0.04111479839064932
769.0,UK520L2,Southampton,2015,1211,152141,153352,0.7896864729511189
770.0,UK528L1,Northampton,2015,693,153852,154545,0.44841308356789283
771.0,UK539L1,Bournemouth,2015,801,92992,93793,0.85400829486209
772.0,UK546L1,Colchester,2015,864,68631,69495,1.2432549104252104
773.0,UK550L0,Dundee City,2015,534,225882,226416,0.2358490566037736
774.0,UK551L1,Falkirk,2015,48,29741,29789,0.16113330423982009
775.0,UK552L0,Reading,2015,26,21895,21921,0.11860772774964647
776.0,UK553L1,Blackpool,2015,31,48924,48955,0.06332346032070268
777.0,UK557L1,Blackburn with Darwen,2015,142,79412,79554,0.1784951102395857
778.0,UK558L1,Newport,2015,27,31673,31700,0.08517350157728706
779.0,UK559L2,Middlesbrough,2015,858,60911,61769,1.3890462853534946
780.0,UK560L1,Oxford,2015,124,192799,192923,0.0642743477967894
781.0,UK562L2,Preston,2015,55,25707,25762,0.2134927412467976
782.0,UK566L1,Norwich,2015,14,150226,150240,0.009318423855165068
783.0,UK568L1,Cheshire West and Chester,2015,454,135691,136145,0.3334679936832054
784.0,UK569L2,Ipswich,2015,1215,154431,155646,0.780617555221464
785.0,UK571L1,Cheltenham,2015,8,46175,46183,0.01732239135612671
786.0,XK001L1,Pristina,2015,52,255755,255807,0.020327825274523374
787.0,XK002L1,Prizren,2015,6,127627,127633,0.004700978587042536
788.0,XK003L1,MitrovicÃ«,2015,3,117911,117914,0.002544227148599827
1.0,AL001L1,Tirana,2016,1562,165559,167121,0.9346521382710731
2.0,AL003L1,Elbasan,2016,662,125342,126004,0.5253801466620107
3.0,AL004L1,ShkodÃ«r,2016,10307,175022,185329,5.561460969411155
4.0,AL005L0,VlorÃ«,2016,2246,61487,63733,3.5240770087709663
5.0,AT001L3,Wien,2016,4431,914059,918490,0.48242223649685895
6.0,AT002L3,Graz,2016,15,291117,291132,0.005152302048555294
7.0,AT003L3,Linz,2016,3039,356191,359230,0.8459761155805472
8.0,AT004L3,Salzburg,2016,1784,135692,137476,1.2976810497832347
9.0,AT005L3,Innsbruck,2016,19143,193679,212822,8.994840758944093
10.0,AT006L2,Klagenfurt,2016,2554,180706,183260,1.3936483684382843
11.0,BA001L1,Sarajevo,2016,7,263767,263774,0.002653786953983334
12.0,BA002L1,Banja Luka,2016,76,275226,275302,0.027606047177281677
13.0,BA003L1,Mostar,2016,1312,181035,182347,0.7195073129801971
14.0,BA004L1,Tuzla,2016,476,111785,112261,0.4240119008382252
15.0,BA005L1,Zenica,2016,3,86713,86716,0.0034595691683195723
16.0,BE001L2,Bruxelles / Brussel,2016,132,326519,326651,0.04041010130077667
17.0,BE002L2,Antwerpen,2016,4493,114719,119212,3.768915880951582
18.0,BE003L2,Gent,2016,536,101305,101841,0.5263106214589409
19.0,BE004L2,Charleroi,2016,400,109365,109765,0.3644148863481073
20.0,BE005L2,LiÃ¨ge,2016,565,140833,141398,0.39958132363965543
21.0,BE006L2,Brugge,2016,823,55716,56539,1.4556323953377315
22.0,BE007L2,Namur,2016,157,83950,84107,0.1866669837231146
23.0,BE008L1,Leuven,2016,27,45049,45076,0.05989883751885704
24.0,BE009L1,Mons,2016,125,39075,39200,0.31887755102040816
25.0,BE010L1,Kortrijk,2016,50,22289,22339,0.2238238058999955
26.0,BE011L1,Oostende,2016,161,20771,20932,0.7691572711637683
27.0,BG001L2,Sofia,2016,2512,569262,571774,0.4393344223416944
28.0,BG002L2,Plovdiv,2016,246,276840,277086,0.08878110045256707
29.0,BG003L2,Varna,2016,3602,201196,204798,1.7588062383421712
30.0,BG004L2,Burgas,2016,5086,290814,295900,1.7188239270023657
31.0,BG005L1,Pleven,2016,1027,178049,179076,0.5734995197569747
32.0,BG006L2,Ruse,2016,2449,131568,134017,1.8273801084936987
33.0,BG007L2,Vidin,2016,1761,59203,60964,2.8885899875336265
34.0,BG008L2,Stara Zagora,2016,0,132068,132068,0.0
35.0,BG009L1,Sliven,2016,1,136773,136774,0.0007311331100940238
36.0,BG010L1,Dobrich,2016,54,140284,140338,0.03847853040516467
37.0,BG011L1,Shumen,2016,81,94426,94507,0.08570793697821324
38.0,BG013L1,Yambol,2016,279,130527,130806,0.21329296821246732
39.0,BG014L1,Haskovo,2016,371,73597,73968,0.5015682457278823
40.0,BG015L1,Pazardzhik,2016,26,63796,63822,0.04073830340634891
41.0,BG016L1,Blagoevgrad,2016,25,135454,135479,0.01845304438326235
42.0,BG017L1,Veliko Tarnovo,2016,0,88539,88539,0.0
43.0,BG018L1,Vratsa,2016,118,70439,70557,0.16724067066343523
44.0,CH001L2,ZÃ¼rich,2016,116,127601,127717,0.09082581018971632
45.0,CH002L2,GenÃ¨ve,2016,275,53622,53897,0.5102324804720114
46.0,CH003L2,Basel,2016,151,69269,69420,0.21751656583117257
47.0,CH004L2,Bern,2016,55,78233,78288,0.0702534232577151
48.0,CH005L2,Lausanne,2016,8,77497,77505,0.010321914715179667
49.0,CH006L1,Winterthur,2016,0,13291,13291,0.0
50.0,CH007L2,St. Gallen,2016,108,31801,31909,0.3384625027421731
51.0,CH008L2,Luzern,2016,6,29253,29259,0.020506510817184458
52.0,CH009L2,Lugano,2016,63,30562,30625,0.2057142857142857
53.0,CH010L1,Biel/Bienne,2016,7,9088,9095,0.07696536558548653
54.0,CY001L2,Lefkosia,2016,56,162572,162628,0.034434414737929506
55.0,CY501L2,Lemesos,2016,971,124928,125899,0.771253147364157
56.0,CZ001L2,Praha,2016,360,570202,570562,0.06309568460570456
57.0,CZ002L2,Brno,2016,1656,266259,267915,0.6181064889983764
58.0,CZ003L2,Ostrava,2016,551,142115,142666,0.3862167580222337
59.0,CZ004L2,PlzeÅ,2016,114,195843,195957,0.058176028414397035
60.0,CZ005L2,ÃstÃ­ nad Labem,2016,206,35705,35911,0.5736403887388265
61.0,CZ006L2,Olomouc,2016,95,93469,93564,0.1015347783335471
62.0,CZ007L2,Liberec,2016,0,61316,61316,0.0
63.0,CZ008L2,ÄeskÃ© BudÄjovice,2016,786,128618,129404,0.6074000803684585
64.0,CZ009L2,Hradec KrÃ¡lovÃ©,2016,58,79447,79505,0.07295138670523867
65.0,CZ010L2,Pardubice,2016,232,86125,86357,0.26865222274974815
66.0,CZ011L2,ZlÃ­n,2016,81,57871,57952,0.13977084483710656
67.0,CZ013L2,Karlovy Vary,2016,71,46913,46984,0.1511152732845224
68.0,CZ014L2,Jihlava,2016,88,95939,96027,0.09164089266560446
69.0,CZ016L2,Most,2016,75,27703,27778,0.26999784001727983
70.0,CZ018L2,Chomutov-Jirkov,2016,407,45279,45686,0.8908637219279428
71.0,DE001L1,Berlin,2016,31471,1716794,1748265,1.800127555033133
72.0,DE002L1,Hamburg,2016,10768,723406,734174,1.4666822851258694
73.0,DE003L1,MÃ¼nchen,2016,7427,542514,549941,1.350508509094612
74.0,DE004L1,KÃ¶ln,2016,1197,161433,162630,0.7360265633646929
75.0,DE005L1,Frankfurt am Main,2016,591,429740,430331,0.13733614357320295
76.0,DE007L1,Stuttgart,2016,66,365104,365170,0.01807377385875072
77.0,DE008L2,Leipzig,2016,6350,391339,397689,1.5967250791447587
78.0,DE009L2,Dresden,2016,5478,577718,583196,0.9393068539564743
79.0,DE011L1,DÃ¼sseldorf,2016,1515,118802,120317,1.2591736828544595
80.0,DE012L1,Bremen,2016,1885,587654,589539,0.3197413572299712
81.0,DE013L1,Hannover,2016,1428,295884,297312,0.4803035195350339
82.0,DE014L1,NÃ¼rnberg,2016,339,293162,293501,0.11550216183249802
83.0,DE017L0,Bielefeld,2016,8,25875,25883,0.030908318201135883
84.0,DE018L1,Halle an der Saale,2016,2229,155357,157586,1.41446575203381
85.0,DE019L2,Magdeburg,2016,773,416261,417034,0.1853565896305817
86.0,DE020L1,Wiesbaden,2016,795,100643,101438,0.783729963130188
87.0,DE021L1,GÃ¶ttingen,2016,124,238833,238957,0.051892181438501495
88.0,DE025L1,Darmstadt,2016,16,78171,78187,0.020463759960095668
89.0,DE026L1,Trier,2016,102,121025,121127,0.08420913586566166
90.0,DE027L1,Freiburg im Breisgau,2016,881,220315,221196,0.3982892999873416
91.0,DE028L1,Regensburg,2016,740,252922,253662,0.29172678603811375
92.0,DE029L0,Frankfurt (Oder),2016,58,14786,14844,0.3907302613850714
93.0,DE030L1,Weimar,2016,42,88986,89028,0.04717616929505324
94.0,DE031L1,Schwerin,2016,6608,483395,490003,1.348563172062212
95.0,DE032L1,Erfurt,2016,555,284957,285512,0.19438762643951918
96.0,DE033L1,Augsburg,2016,204,199730,199934,0.10203367111146677
97.0,DE034L1,Bonn,2016,729,128608,129337,0.5636438142217618
98.0,DE035L1,Karlsruhe,2016,305,125507,125812,0.2424252058627158
99.0,DE036L0,MÃ¶nchengladbach,2016,2,17021,17023,0.011748810432943665
100.0,DE037L1,Mainz,2016,936,69369,70305,1.3313420098143802
101.0,DE038L1,Ruhrgebiet,2016,3179,440573,443752,0.7163911373920568
102.0,DE039L1,Kiel,2016,5644,334118,339762,1.6611628139697787
103.0,DE040L1,SaarbrÃ¼cken,2016,33,153649,153682,0.02147291159667365
104.0,DE042L1,Koblenz,2016,861,91315,92176,0.9340826245443499
105.0,DE043L2,Rostock,2016,3792,358012,361804,1.0480812815778708
106.0,DE044L1,Kaiserslautern,2016,18,135509,135527,0.013281486345894175
107.0,DE045L1,Iserlohn,2016,183,105924,106107,0.17246741496790974
108.0,DE048L1,Wilhelmshaven,2016,590,73457,74047,0.7967912271935393
109.0,DE050L1,TÃ¼bingen,2016,0,52025,52025,0.0
110.0,DE051L1,Villingen-Schwenningen,2016,45,102515,102560,0.04387675507020281
111.0,DE052L1,Flensburg,2016,957,204518,205475,0.4657500912519771
112.0,DE053L1,Marburg,2016,1,126241,126242,0.0007921294022591531
113.0,DE054L1,Konstanz,2016,178,81722,81900,0.21733821733821734
114.0,DE055L0,NeumÃ¼nster,2016,2,7174,7176,0.027870680044593088
115.0,DE056L0,Brandenburg an der Havel,2016,1451,21379,22830,6.355672360928604
116.0,DE057L1,GieÃen,2016,13,85515,85528,0.015199700682817324
117.0,DE058L1,LÃ¼neburg,2016,114,132388,132502,0.0860364371858538
118.0,DE059L1,Bayreuth,2016,5,199915,199920,0.002501000400160064
119.0,DE060L1,Celle,2016,44,155003,155047,0.02837849168316704
120.0,DE061L1,Aschaffenburg,2016,131,147485,147616,0.08874376761326686
121.0,DE062L1,Bamberg,2016,93,122062,122155,0.07613278212107569
122.0,DE063L1,Plauen,2016,2859,138429,141288,2.023526414132835
123.0,DE064L1,Neubrandenburg,2016,25779,558212,583991,4.414280357060297
124.0,DE065L1,Fulda,2016,2,138223,138225,0.0014469162597214686
125.0,DE066L1,Kempten (AllgÃ¤u),2016,346,158821,159167,0.21738174370315458
126.0,DE067L1,Landshut,2016,139,141314,141453,0.09826585508967643
127.0,DE069L1,Rosenheim,2016,237,147526,147763,0.16039197904752883
128.0,DE071L1,Stralsund,2016,19931,318317,338248,5.892422128142664
129.0,DE072L1,Friedrichshafen,2016,54,66565,66619,0.08105795643885379
130.0,DE073L1,Offenburg,2016,311,185573,185884,0.1673086441006219
131.0,DE074L1,GÃ¶rlitz,2016,1660,209447,211107,0.7863311022372541
132.0,DE077L1,Schweinfurt,2016,69,201271,201340,0.03427038839773518
133.0,DE078L1,Greifswald,2016,7735,342059,349794,2.2113015088880883
134.0,DE079L1,Wetzlar,2016,38,106452,106490,0.03568410179359564
135.0,DE081L1,Passau,2016,1036,159030,160066,0.6472330163807429
136.0,DE082L0,Dessau-RoÃlau,2016,78,24570,24648,0.31645569620253167
137.0,DE083L1,Braunschweig-Salzgitter-Wolfsburg,2016,434,412410,412844,0.10512445378884033
138.0,DE084L1,Mannheim-Ludwigshafen,2016,829,203599,204428,0.4055217484884654
139.0,DE504L1,MÃ¼nster,2016,114,141649,141763,0.08041590541960879
140.0,DE505L0,Chemnitz,2016,3,22190,22193,0.01351777587527599
141.0,DE507L1,Aachen,2016,1472,69048,70520,2.0873511060692
142.0,DE508L0,Krefeld,2016,108,13572,13680,0.7894736842105263
143.0,DE510L1,LÃ¼beck,2016,4122,158027,162149,2.542106334297467
144.0,DE513L1,Kassel,2016,104,139757,139861,0.07435954268881247
145.0,DE516L0,Solingen,2016,0,8954,8954,0.0
146.0,DE517L1,OsnabrÃ¼ck,2016,23,224107,224130,0.010261901574978808
147.0,DE520L1,Oldenburg (Oldenburg),2016,379,189590,189969,0.199506235227853
148.0,DE522L1,Heidelberg,2016,232,116873,117105,0.19811280474787582
149.0,DE523L1,Paderborn,2016,73,124610,124683,0.058548478942598424
150.0,DE524L2,WÃ¼rzburg,2016,199,305730,305929,0.06504777252238264
151.0,DE527L1,Bremerhaven,2016,1147,213332,214479,0.5347842912359718
152.0,DE529L1,Heilbronn,2016,81,119903,119984,0.06750900120016001
153.0,DE530L0,Remscheid,2016,2,7367,7369,0.02714072465734835
154.0,DE532L1,Ulm,2016,204,199104,199308,0.1023541453428864
155.0,DE533L1,Pforzheim,2016,6,67142,67148,0.00893548579257759
156.0,DE534L1,Ingolstadt,2016,1575,283260,284835,0.5529517088840908
157.0,DE535L1,Gera,2016,51,99735,99786,0.051109374060489446
158.0,DE537L1,Reutlingen,2016,1,109281,109282,0.0009150637799454622
159.0,DE539L1,Cottbus,2016,1182,181098,182280,0.6484529295589203
160.0,DE540L2,Siegen,2016,9,177555,177564,0.005068594985470028
161.0,DE542L1,Hildesheim,2016,2,120808,120810,0.001655492095025246
162.0,DE544L1,Zwickau,2016,147,94657,94804,0.1550567486603941
163.0,DE546L0,Wuppertal,2016,0,16833,16833,0.0
164.0,DE547L2,Jena,2016,0,93068,93068,0.0
165.0,DE548L1,DÃ¼ren,2016,374,93664,94038,0.39771156341053615
166.0,DE549L1,Bocholt,2016,103,142162,142265,0.07240009840790075
167.0,DK001L2,KÃ¸benhavn,2016,13418,277805,291223,4.607465756482146
168.0,DK002L3,Ãrhus,2016,4179,458345,462524,0.9035206821700063
169.0,DK003L2,Odense,2016,7496,352343,359839,2.0831538549184496
170.0,DK004L3,Aalborg,2016,3817,616642,620459,0.615189722447414
171.0,EE001L1,Tallinn,2016,5899,433162,439061,1.3435490740466587
172.0,EE002L1,Tartu,2016,1140,298502,299642,0.38045400845008376
173.0,EE003L0,Narva,2016,285,6604,6889,4.137030047902454
174.0,EL001L1,Athina,2016,5107,304280,309387,1.6506834482379673
175.0,EL002L1,Thessaloniki,2016,2019,140100,142119,1.4206404492010216
176.0,EL003L1,Patra,2016,665,50925,51590,1.289009497964722
177.0,EL004L1,Irakleio,2016,1084,60300,61384,1.7659324905512839
178.0,EL005L1,Larisa,2016,65,155454,155519,0.041795536236729915
179.0,EL006L1,Volos,2016,264,30552,30816,0.8566978193146416
180.0,EL007L1,Ioannina,2016,2089,130552,132641,1.5749278126672748
181.0,EL008L1,Kavala,2016,307,35261,35568,0.8631354026090868
182.0,EL009L1,Kalamata,2016,269,44183,44452,0.6051471249887519
183.0,ES001L3,Madrid,2016,2483,785120,787603,0.3152603532490354
184.0,ES002L2,Barcelona,2016,1302,263305,264607,0.4920504748551625
185.0,ES003L3,Valencia,2016,3092,172028,175120,1.76564641388762
186.0,ES004L3,Sevilla,2016,4691,463735,468426,1.0014388612075333
187.0,ES005L2,Zaragoza,2016,152,275986,276138,0.05504494129746721
188.0,ES006L2,MÃ¡laga,2016,889,151853,152742,0.5820272092810098
189.0,ES007L2,Murcia,2016,88,120048,120136,0.07325031630818406
190.0,ES008L2,Las Palmas,2016,753,75843,76596,0.983080056399812
191.0,ES009L2,Valladolid,2016,195,115334,115529,0.1687887889620788
192.0,ES010L2,Palma de Mallorca,2016,2271,201963,204234,1.1119598108052529
193.0,ES011L2,Santiago de Compostela,2016,0,126256,126256,0.0
194.0,ES012L2,Vitoria/Gasteiz,2016,1544,157777,159321,0.9691126719013815
195.0,ES013L2,Oviedo,2016,29,93458,93487,0.031020355771390673
196.0,ES014L3,Pamplona/IruÃ±a,2016,5,169509,169514,0.002949608881862265
197.0,ES015L2,Santander,2016,322,69161,69483,0.4634227077126779
198.0,ES016L2,Toledo,2016,463,92935,93398,0.4957279599134885
199.0,ES017L2,Badajoz,2016,825,217924,218749,0.3771445812323714
200.0,ES018L2,LogroÃ±o,2016,35,46103,46138,0.07585937838657938
201.0,ES019L3,Bilbao,2016,881,152440,153321,0.5746114361372545
202.0,ES020L2,CÃ³rdoba,2016,1203,185699,186902,0.6436528234047789
203.0,ES021L2,Alicante/Alacant,2016,413,35645,36058,1.1453768927838484
204.0,ES022L2,Vigo,2016,916,135555,136471,0.6712048713646123
205.0,ES023L2,GijÃ³n,2016,295,53107,53402,0.5524137672746339
206.0,ES025L3,Santa Cruz de Tenerife,2016,810,66173,66983,1.2092620515653225
207.0,ES026L2,CoruÃ±a (A),2016,472,75503,75975,0.621256992431721
208.0,ES028L1,Reus,2016,0,11534,11534,0.0
209.0,ES031L1,Lugo,2016,3,134008,134011,0.002238622202655006
210.0,ES033L1,Girona,2016,2,39619,39621,0.005047828171929028
211.0,ES034L1,CÃ¡ceres,2016,1948,236325,238273,0.8175496174556077
212.0,ES035L1,Torrevieja,2016,1709,7129,8838,19.33695406200498
213.0,ES039L1,AvilÃ©s,2016,118,19024,19142,0.6164455124856337
214.0,ES040L1,Talavera de la Reina,2016,551,82715,83266,0.6617346816227512
215.0,ES041L1,Palencia,2016,15,28366,28381,0.05285226031499947
216.0,ES043L1,Ferrol,2016,546,46424,46970,1.1624441132637855
217.0,ES044L1,Pontevedra,2016,200,51416,51616,0.38747675139491633
218.0,ES046L1,Gandia,2016,246,17091,17337,1.418930610832324
219.0,ES048L1,Guadalajara,2016,3,45380,45383,0.006610404777119186
220.0,ES050L1,Manresa,2016,3,29600,29603,0.010134108029591596
221.0,ES053L1,Ciudad Real,2016,668,95677,96345,0.6933416368259899
222.0,ES054L1,Benidorm,2016,318,20355,20673,1.5382382818168627
223.0,ES057L1,Ponferrada,2016,247,62096,62343,0.396195242449032
224.0,ES059L1,Zamora,2016,325,33855,34180,0.9508484493856056
225.0,ES070L1,Irun,2016,80,7162,7242,1.1046672190002762
226.0,ES072L1,Arrecife,2016,3567,55367,58934,6.052533342383005
227.0,ES501L3,Granada,2016,355,162269,162624,0.21829496261314443
228.0,ES505L1,Elche/Elx,2016,768,38050,38818,1.9784635993611213
229.0,ES506L1,Cartagena,2016,1509,59439,60948,2.4758810789525496
230.0,ES508L1,Jerez de la Frontera,2016,169,125937,126106,0.1340142419868999
231.0,ES510L1,Donostia-San SebastiÃ¡n,2016,281,33039,33320,0.8433373349339736
232.0,ES514L1,AlmerÃ­a,2016,737,39993,40730,1.8094770439479497
233.0,ES515L1,Burgos,2016,4,149387,149391,0.002677537468789954
234.0,ES516L1,Salamanca,2016,18,45626,45644,0.03943563228463763
235.0,ES519L1,Albacete,2016,0,245325,245325,0.0
236.0,ES520L1,CastellÃ³n/CastellÃ³,2016,344,32450,32794,1.0489723729950602
237.0,ES521L1,Huelva,2016,3798,93622,97420,3.898583453089715
238.0,ES522L1,CÃ¡diz,2016,1085,23748,24833,4.369186163572666
239.0,ES523L1,LeÃ³n,2016,2,118885,118887,0.0016822697183039358
240.0,ES525L1,Tarragona,2016,445,21295,21740,2.046918123275069
241.0,ES527L1,JaÃ©n,2016,31,99900,99931,0.03102140476929081
242.0,ES528L1,Lleida,2016,113,70562,70675,0.15988680580120268
243.0,ES529L1,Ourense,2016,121,65047,65168,0.1856739504051068
244.0,ES532L1,Algeciras,2016,470,41824,42294,1.111268737882442
245.0,ES533L1,Marbella,2016,580,68625,69205,0.8380897334007659
246.0,ES537L1,Alcoy,2016,0,20529,20529,0.0
247.0,ES538L1,Ãvila,2016,519,53127,53646,0.9674533049994407
248.0,ES542L1,Cuenca,2016,84,164498,164582,0.05103838815909394
249.0,ES543L1,Eivissa,2016,2036,57366,59402,3.427494023770243
250.0,ES544L1,Linares,2016,14,25762,25776,0.05431409062693979
251.0,ES545L1,Lorca,2016,105,182102,182207,0.057626765162699566
252.0,ES546L1,MÃ©rida,2016,916,127383,128299,0.7139572405084997
253.0,ES547L1,Sagunto,2016,196,15332,15528,1.2622359608449252
254.0,ES550L1,Puerto de la Cruz,2016,1254,26218,27472,4.564647641234712
255.0,ES552L1,Igualada,2016,0,25426,25426,0.0
256.0,FI001L3,Helsinki,2016,19845,471673,491518,4.037492014534565
257.0,FI002L3,Tampere,2016,84867,603776,688643,12.323802028046464
258.0,FI003L4,Turku,2016,20362,446082,466444,4.365368618740942
259.0,FI004L4,Oulu,2016,7679,716142,723821,1.0608976528727407
260.0,FI007L2,Lahti,2016,34758,300645,335403,10.36305578662087
261.0,FI008L2,Kuopio,2016,150409,769997,920406,16.341592731903095
262.0,FI009L2,JyvÃ¤skylÃ¤,2016,47668,429274,476942,9.99450666957408
263.0,FR001L1,Paris,2016,1850,1208102,1209952,0.15289862738356563
264.0,FR003L2,Lyon,2016,2238,364993,367231,0.6094256748477116
265.0,FR004L2,Toulouse,2016,807,523865,524672,0.15381038058062943
266.0,FR006L2,Strasbourg,2016,486,203397,203883,0.2383720074748753
267.0,FR007L2,Bordeaux,2016,5179,550575,555754,0.9318871299171937
268.0,FR008L2,Nantes,2016,2689,313930,316619,0.8492857345895224
269.0,FR009L2,Lille,2016,99,144354,144453,0.06853440219310088
270.0,FR010L2,Montpellier,2016,7332,216586,223918,3.274412954742361
271.0,FR011L2,Saint-Etienne,2016,129,180926,181055,0.07124906796277375
272.0,FR012L2,Le Havre,2016,919,75519,76438,1.2022815876919857
273.0,FR013L2,Rennes,2016,251,381886,382137,0.06568324972457522
274.0,FR014L2,Amiens,2016,89,244706,244795,0.036356951735125306
275.0,FR016L2,Nancy,2016,650,282859,283509,0.2292696175430057
276.0,FR017L2,Metz,2016,599,176331,176930,0.33855196970553325
277.0,FR018L2,Reims,2016,31,243120,243151,0.012749279254455051
278.0,FR019L2,OrlÃ©ans,2016,1070,290897,291967,0.3664797733990485
279.0,FR020L2,Dijon,2016,2377,383384,385761,0.6161846324537732
280.0,FR021L2,Poitiers,2016,45,250397,250442,0.01796823216553134
281.0,FR022L2,Clermont-Ferrand,2016,155,265971,266126,0.058243087860637435
282.0,FR023L2,Caen,2016,618,225655,226273,0.27312140644266
283.0,FR024L2,Limoges,2016,240,317594,317834,0.0755111158655147
284.0,FR025L2,BesanÃ§on,2016,126,238910,239036,0.05271172543047909
285.0,FR026L2,Grenoble,2016,1796,264052,265848,0.6755740122175078
286.0,FR027L2,Ajaccio,2016,1475,145534,147009,1.0033399315688154
289.0,FR032L2,Toulon,2016,2197,104859,107056,2.0521969810192795
290.0,FR034L2,Valenciennes,2016,41,78405,78446,0.05226525253040308
291.0,FR035L2,Tours,2016,689,284159,284848,0.2418833904398135
292.0,FR036L2,Angers,2016,1018,230233,231251,0.44021431258675636
293.0,FR037L2,Brest,2016,882,134112,134994,0.6533623716609627
294.0,FR038L2,Le Mans,2016,64,224047,224111,0.028557277420563916
295.0,FR039L1,Avignon,2016,1490,85735,87225,1.708225852679851
296.0,FR040L2,Mulhouse,2016,153,129613,129766,0.11790453585685003
297.0,FR042L2,Dunkerque,2016,630,90495,91125,0.6913580246913581
298.0,FR043L2,Perpignan,2016,1474,181556,183030,0.8053324591597006
299.0,FR044L2,NÃ®mes,2016,1361,149130,150491,0.904373018984524
300.0,FR045L2,Pau,2016,42,201717,201759,0.020816915230547337
301.0,FR046L2,Bayonne,2016,562,102068,102630,0.5475981681769463
302.0,FR047L0,Annemasse,2016,6,7794,7800,0.07692307692307693
303.0,FR048L2,Annecy,2016,2299,116744,119043,1.931234931915358
304.0,FR049L2,Lorient,2016,463,112719,113182,0.40907564807124813
305.0,FR050L2,MontbÃ©liard,2016,112,122945,123057,0.09101473300990598
306.0,FR051L2,Troyes,2016,2288,258662,260950,0.8767963211343168
307.0,FR052L2,Saint-Nazaire,2016,507,106628,107135,0.47323470387828437
308.0,FR053L2,La Rochelle,2016,247,111093,111340,0.2218430034129693
309.0,FR056L2,AngoulÃªme,2016,21,214271,214292,0.009799712541765442
310.0,FR057L2,Boulogne-sur-Mer,2016,206,68332,68538,0.30056319122238756
311.0,FR058L2,ChambÃ©ry,2016,3229,98460,101689,3.175368033907305
312.0,FR059L2,Chalon-sur-SaÃ´ne,2016,461,155897,156358,0.29483620921219256
313.0,FR060L2,Chartres,2016,89,161271,161360,0.05515617253346554
314.0,FR061L2,Niort,2016,7,178912,178919,0.003912384933964531
315.0,FR062L2,Calais,2016,99,50131,50230,0.1970933704957197
316.0,FR063L2,BÃ©ziers,2016,412,84731,85143,0.48389180555066186
317.0,FR064L2,Arras,2016,20,107543,107563,0.018593754357911177
318.0,FR065L2,Bourges,2016,216,250103,250319,0.08628989409513461
319.0,FR066L2,Saint-Brieuc,2016,83,115098,115181,0.07206049608876464
320.0,FR067L2,Quimper,2016,756,121166,121922,0.6200685684289955
321.0,FR068L2,Vannes,2016,895,120139,121034,0.7394616388783317
322.0,FR069L2,Cherbourg,2016,386,90332,90718,0.4254943892061112
323.0,FR073L2,Tarbes,2016,68,104261,104329,0.06517842594101353
324.0,FR074L2,CompiÃ¨gne,2016,140,98597,98737,0.14179081803174087
325.0,FR076L2,Belfort,2016,225,65394,65619,0.34288849266218624
326.0,FR077L2,Roanne,2016,290,122910,123200,0.23538961038961037
327.0,FR079L2,Saint-Quentin,2016,37,99337,99374,0.037233079075009556
328.0,FR082L2,Beauvais,2016,0,131142,131142,0.0
329.0,FR084L2,Creil,2016,12,29631,29643,0.04048173261815606
330.0,FR086L2,Evreux,2016,25,126545,126570,0.019751915935845778
331.0,FR090L2,ChÃ¢teauroux,2016,377,260800,261177,0.14434655425248014
332.0,FR093L2,Brive-la-Gaillarde,2016,25,132557,132582,0.018856254996907573
333.0,FR096L2,Albi,2016,311,133927,134238,0.23167806433349722
334.0,FR099L2,FrÃ©jus,2016,428,43985,44413,0.9636818048769504
335.0,FR104L2,ChÃ¢lons-en-Champagne,2016,63,152746,152809,0.04122793814500455
336.0,FR203L2,Marseille,2016,2885,422891,425776,0.6775863364773965
337.0,FR205L2,Nice,2016,1056,306284,307340,0.3435934144595562
338.0,FR207L2,Lens - LiÃ©vin,2016,42,25266,25308,0.16595542911332387
339.0,FR208L1,HÃ©nin - Carvin,2016,5,11593,11598,0.043110881186411446
340.0,FR209L2,Douai,2016,146,44938,45084,0.32383994321710585
341.0,FR214L1,Valence,2016,817,90144,90961,0.8981871351458318
342.0,FR215L2,Rouen,2016,2217,284909,287126,0.7721348815502601
343.0,FR304L1,Melun,2016,52,44784,44836,0.1159782317780355
344.0,FR324L1,Martigues,2016,1688,18768,20456,8.25185764567853
345.0,FR505L1,Charleville-MÃ©ziÃ¨res,2016,238,135131,135369,0.17581573329196493
346.0,FR506L1,Colmar,2016,243,101742,101985,0.23827033387262836
347.0,FR519L1,Cannes,2016,494,19642,20136,2.4533174413984904
348.0,HR001L2,Grad Zagreb,2016,275,505593,505868,0.05436200748021223
349.0,HR002L2,Rijeka,2016,494,106740,107234,0.4606747859820579
350.0,HR003L2,Slavonski Brod,2016,704,97126,97830,0.7196156598180516
351.0,HR004L2,Osijek,2016,1486,171448,172934,0.8592873581828906
352.0,HR005L2,Split,2016,2829,336241,339070,0.8343409915356712
353.0,HR006L1,Pula - Pola,2016,1277,57620,58897,2.1681919282815763
354.0,HR007L1,Zadar,2016,2515,153985,156500,1.6070287539936101
355.0,HU001L2,Budapest,2016,6962,632172,639134,1.0892864407150926
356.0,HU002L2,Miskolc,2016,198,164471,164669,0.12024121115692692
357.0,HU003L2,NyÃ­regyhÃ¡za,2016,280,167945,168225,0.16644375092881555
358.0,HU004L2,PÃ©cs,2016,117,185371,185488,0.0630768567238851
359.0,HU005L2,Debrecen,2016,576,201002,201578,0.28574546825546443
360.0,HU006L2,Szeged,2016,796,160137,160933,0.49461577178080324
361.0,HU007L2,GyÃµr,2016,712,203928,204640,0.34792806880375293
362.0,HU008L2,KecskemÃ©t,2016,60,182079,182139,0.03294187406321546
363.0,HU009L2,SzÃ©kesfehÃ©rvÃ¡r,2016,1760,299363,301123,0.5844787678124885
364.0,HU010L1,Szombathely,2016,41,134236,134277,0.030533896348592836
365.0,HU011L1,Szolnok,2016,674,143301,143975,0.4681368293106442
366.0,HU012L1,TatabÃ¡nya,2016,79,69751,69830,0.11313189173707576
367.0,HU013L1,VeszprÃ©m,2016,7153,124167,131320,5.446999695400549
368.0,HU014L1,BÃ©kÃ©scsaba,2016,145,106018,106163,0.1365824251387018
369.0,HU015L1,KaposvÃ¡r,2016,24,145536,145560,0.01648804616652927
370.0,HU016L1,Eger,2016,1,100577,100578,0.000994253216409155
371.0,HU017L1,DunaÃºjvÃ¡ros,2016,833,60837,61670,1.350737797956867
372.0,HU018L1,Zalaegerszeg,2016,144,139835,139979,0.10287257374320434
373.0,HU019L1,Sopron,2016,226,80444,80670,0.2801537126565018
374.0,IE001L1,Dublin,2016,5332,698270,703602,0.7578147873371593
375.0,IE002L1,Cork,2016,2810,326853,329663,0.8523856180402412
376.0,IE003L1,Limerick,2016,193,156265,156458,0.12335578877398408
377.0,IE004L1,Galway,2016,4774,221509,226283,2.109747528537274
378.0,IE005L1,Waterford,2016,1109,94748,95857,1.1569316794808933
379.0,IS001L1,ReykjavÃ­k,2016,167292,1129938,1297230,12.896093984875465
380.0,IT001L3,Roma,2016,8910,608306,617216,1.4435789091663211
381.0,IT002L3,Milano,2016,21,384024,384045,0.0054681092059524275
382.0,IT003L3,Napoli,2016,2940,150002,152942,1.9222973414758537
383.0,IT004L2,Torino,2016,59,170120,170179,0.03466937753776906
384.0,IT005L3,Palermo,2016,1542,148531,150073,1.0274999500243216
385.0,IT006L3,Genova,2016,666,120098,120764,0.5514888542943261
386.0,IT007L3,Firenze,2016,100,163671,163771,0.061060871582880975
387.0,IT008L3,Bari,2016,722,112707,113429,0.6365215244778671
388.0,IT009L1,Bologna,2016,38,185219,185257,0.020512045428782717
389.0,IT010L2,Catania,2016,668,60757,61425,1.0875050875050873
390.0,IT011L2,Venezia,2016,1793,65244,67037,2.6746423616808626
391.0,IT012L3,Verona,2016,54,73107,73161,0.07380981670562184
392.0,IT013L3,Cremona,2016,335,60062,60397,0.5546633110916105
393.0,IT014L3,Trento,2016,607,97580,98187,0.6182081130903276
394.0,IT015L1,Trieste,2016,374,21263,21637,1.728520589730554
395.0,IT016L3,Perugia,2016,5946,125082,131028,4.5379613517721396
396.0,IT017L3,Ancona,2016,475,43768,44243,1.073616165269082
397.0,IT019L2,Pescara,2016,262,16181,16443,1.5933832025786048
398.0,IT020L3,Campobasso,2016,504,102331,102835,0.49010550882481646
399.0,IT021L2,Caserta,2016,1,9341,9342,0.010704345964461572
400.0,IT022L2,Taranto,2016,3478,103450,106928,3.252655992817597
401.0,IT023L2,Potenza,2016,95,138360,138455,0.06861435123325269
402.0,IT024L3,Catanzaro,2016,267,89816,90083,0.2963933261547684
403.0,IT025L3,Reggio di Calabria,2016,556,47692,48248,1.152379373238269
404.0,IT026L3,Sassari,2016,2256,150969,153225,1.4723445912873225
405.0,IT027L2,Cagliari,2016,4870,190422,195292,2.4937017389345186
406.0,IT028L3,Padova,2016,3,61442,61445,0.004882415168036456
407.0,IT029L3,Brescia,2016,73,60196,60269,0.12112362906303406
408.0,IT030L3,Modena,2016,136,69132,69268,0.19633885776982157
409.0,IT031L3,Foggia,2016,4,89707,89711,0.004458762024723836
410.0,IT032L3,Salerno,2016,328,37511,37839,0.8668305187769234
411.0,IT033L2,Piacenza,2016,228,93899,94127,0.24222592879832566
412.0,IT034L1,Bolzano,2016,862,105894,106756,0.8074487616621081
413.0,IT035L2,Udine,2016,0,71830,71830,0.0
414.0,IT036L2,La Spezia,2016,641,42278,42919,1.4935110324098884
415.0,IT037L1,Lecce,2016,326,61184,61510,0.5299951227442692
416.0,IT038L1,Barletta,2016,231,14866,15097,1.5301053189375373
417.0,IT039L2,Pesaro,2016,140,25551,25691,0.5449379160017127
418.0,IT040L2,Como,2016,562,19179,19741,2.846866926700775
419.0,IT041L2,Pisa,2016,466,47587,48053,0.9697625538467942
420.0,IT042L1,Treviso,2016,31,24014,24045,0.1289249324183822
421.0,IT043L2,Varese,2016,641,23023,23664,2.7087559161595673
422.0,IT045L2,Asti,2016,6,54830,54836,0.010941717120140054
423.0,IT046L2,Pavia,2016,100,36104,36204,0.27621257319633186
424.0,IT047L1,Massa,2016,201,11042,11243,1.7877790625277952
425.0,IT048L2,Cosenza,2016,468,92011,92479,0.506060835432909
426.0,IT052L1,Savona,2016,187,28518,28705,0.6514544504441735
427.0,IT054L1,Matera,2016,637,77152,77789,0.8188818470477831
428.0,IT056L1,Acireale,2016,52,5936,5988,0.8684034736138945
429.0,IT057L2,Avellino,2016,0,39759,39759,0.0
430.0,IT058L2,Pordenone,2016,12,37038,37050,0.032388663967611336
431.0,IT060L1,Lecco,2016,1215,28997,30212,4.0215808288097445
432.0,IT061L0,Altamura,2016,0,42800,42800,0.0
433.0,IT064L1,Battipaglia,2016,53,6433,6486,0.8171446191797719
434.0,IT065L0,Bisceglie,2016,86,6858,6944,1.2384792626728112
435.0,IT066L1,Carpi,2016,8,20614,20622,0.03879352148191252
436.0,IT067L0,Cerignola,2016,127,58770,58897,0.21563067728407218
437.0,IT068L1,Gallarate,2016,0,5319,5319,0.0
438.0,IT069L1,Gela,2016,407,57488,57895,0.7029968045599793
439.0,IT073L1,Sassuolo,2016,1,24061,24062,0.004155930512841825
440.0,IT501L2,Messina,2016,740,33703,34443,2.148477194204918
441.0,IT502L2,Prato,2016,5,40954,40959,0.012207329280500013
442.0,IT503L3,Parma,2016,206,113301,113507,0.1814866043503925
443.0,IT504L3,Livorno,2016,277,25537,25814,1.0730611296195862
444.0,IT505L3,Reggio nell'Emilia,2016,1,69033,69034,0.0014485615783526957
445.0,IT506L2,Ravenna,2016,3546,77643,81189,4.367586742046337
446.0,IT507L2,Ferrara,2016,819,90664,91483,0.8952482974978958
447.0,IT508L3,Rimini,2016,255,32324,32579,0.7827127904478345
448.0,IT509L3,Siracusa,2016,545,33597,34142,1.5962743834573252
449.0,IT511L2,Bergamo,2016,0,18556,18556,0.0
450.0,IT512L3,ForlÃ¬,2016,1,72750,72751,0.0013745515525559787
451.0,IT513L3,Latina,2016,527,65966,66493,0.7925646308633991
452.0,IT514L2,Vicenza,2016,1,34981,34982,0.0028586130009719286
453.0,IT515L2,Terni,2016,150,102182,102332,0.14658171441973183
454.0,IT516L2,Novara,2016,1,54164,54165,0.0018462106526354657
455.0,IT518L1,Alessandria,2016,65,76849,76914,0.08450997217671685
456.0,IT519L1,Arezzo,2016,2,88625,88627,0.002256648651088269
457.0,IT520L1,Grosseto,2016,403,119196,119599,0.33695933912490905
458.0,IT521L1,Brindisi,2016,804,63183,63987,1.2565052276243611
459.0,IT522L1,Trapani,2016,927,49863,50790,1.8251624335499115
460.0,IT523L1,Ragusa,2016,255,52595,52850,0.48249763481551566
461.0,IT524L0,Andria,2016,0,39880,39880,0.0
462.0,IT525L0,Trani,2016,114,10265,10379,1.0983717121109933
463.0,IT526L1,L'Aquila,2016,548,139721,140269,0.3906779117267536
464.0,LT001L1,Vilnius,2016,4574,419995,424569,1.0773278312830188
465.0,LT002L1,Kaunas,2016,1430,160621,162051,0.8824382447501096
466.0,LT003L1,PanevÄÅ¾ys,2016,91,222717,222808,0.040842339592833295
467.0,LT004L0,Alytus,2016,13,3946,3959,0.3283657489264966
468.0,LT501L0,KlaipÄda,2016,90,8833,8923,1.0086293847360752
469.0,LT502L0,Å iauliai,2016,1164,6881,8045,14.468614045991298
470.0,LU001L1,Luxembourg,2016,7506,252209,259715,2.890091061355717
471.0,LV001L1,RÄ«ga,2016,9922,606327,616249,1.6100634646060277
472.0,LV002L2,LiepÄja,2016,2489,269568,272057,0.9148818078564418
473.0,LV003L1,Jelgava,2016,359,166100,166459,0.21566872322914352
474.0,LV501L1,Daugavpils,2016,2616,257059,259675,1.007413112544527
475.0,ME001L1,Podgorica,2016,1471,183010,184481,0.7973720870984004
476.0,MK001L1,Skopje,2016,7,224346,224353,0.003120083083355248
477.0,MK003L1,Bitola,2016,223,119439,119662,0.18635824238271131
478.0,MK004L1,Tetovo,2016,87,105534,105621,0.08236998324196892
479.0,MK005L1,Prilep,2016,105,86726,86831,0.12092455459455724
480.0,MT001L1,Valletta,2016,984,24972,25956,3.7910309754969953
481.0,NL001L3,s' Gravenhage,2016,931,41776,42707,2.179970496639895
482.0,NL002L3,Amsterdam,2016,71781,261176,332957,21.55863970422607
483.0,NL003L3,Rotterdam,2016,29232,187939,217171,13.46036072956334
484.0,NL004L3,Utrecht,2016,987,96300,97287,1.0145240371272628
485.0,NL005L3,Eindhoven,2016,245,144161,144406,0.16966054042075815
486.0,NL006L3,Tilburg,2016,243,42991,43234,0.5620576398205116
487.0,NL007L3,Groningen,2016,3646,204514,208160,1.7515372790161414
488.0,NL008L3,Enschede,2016,85,84871,84956,0.10005179151560807
489.0,NL009L3,Arnhem,2016,644,55254,55898,1.152098465061362
490.0,NL010L3,Heerlen,2016,18,33325,33343,0.05398434454008338
491.0,NL012L3,Breda,2016,1722,71648,73370,2.347008314024806
492.0,NL013L3,Nijmegen,2016,897,38939,39836,2.2517321016166285
493.0,NL014L3,Apeldoorn,2016,11,71113,71124,0.01546594679714302
494.0,NL015L3,Leeuwarden,2016,938,109985,110923,0.8456316543908838
495.0,NL016L3,Sittard-Geleen,2016,78,22834,22912,0.3404329608938547
496.0,NL020L3,Roosendaal,2016,4,24570,24574,0.016277366322129082
497.0,NL026L0,Alphen aan den Rijn,2016,34,13176,13210,0.2573807721423164
498.0,NL028L3,Bergen op Zoom,2016,2110,32671,34781,6.066530577039188
499.0,NL030L0,Gouda,2016,2,1786,1788,0.11185682326621924
500.0,NL032L3,MiddelburgÂ Â Â Â Â Â ,2016,1190,22198,23388,5.0880793569351805
501.0,NL503L3,s-Hertogenbosch,2016,686,36173,36859,1.8611465313763258
502.0,NL504L3,Amersfoort,2016,3,12241,12244,0.024501796798431882
503.0,NL505L3,Maastricht,2016,226,20159,20385,1.1086583272013735
504.0,NL507L3,Leiden,2016,306,19475,19781,1.5469389818512713
505.0,NL511L3,Zwolle,2016,1108,121912,123020,0.900666558283206
506.0,NL512L3,Ede,2016,34,35231,35265,0.09641287395434567
507.0,NL513L3,Deventer,2016,87,25158,25245,0.34462269756387404
508.0,NL514L3,Alkmaar,2016,240,47552,47792,0.5021760964178106
509.0,NL515L3,Venlo,2016,339,50897,51236,0.6616441564524943
510.0,NL519L3,Almelo,2016,36,41989,42025,0.08566329565734682
511.0,NL520L3,Lelystad,2016,59154,59688,118842,49.77533195334983
512.0,NL521L3,Oss,2016,201,32945,33146,0.6064080130332469
513.0,NL522L3,Assen,2016,155,70707,70862,0.21873500606813243
514.0,NL524L3,Veenendaal,2016,34,8151,8185,0.41539401343921806
515.0,NL529L3,Soest,2016,5,7937,7942,0.06295643414756988
516.0,NO001L1,Oslo,2016,30664,715979,746643,4.106915888851835
517.0,NO002L1,Bergen,2016,17639,340104,357743,4.930634561682549
518.0,NO003L1,Trondheim,2016,12211,661045,673256,1.8137231602837554
519.0,NO004L1,Stavanger,2016,14004,275073,289077,4.844384022250127
520.0,NO005L1,Kristiansand,2016,5231,310231,315462,1.6582028897299834
521.0,NO006L1,TromsÃ¸,2016,56440,318173,374613,15.066215000547231
522.0,PL001L2,Warszawa,2016,3523,857720,861243,0.4090599284986932
523.0,PL002L2,ÅÃ³dÅº,2016,59,169441,169500,0.03480825958702065
524.0,PL003L2,KrakÃ³w,2016,460,375288,375748,0.12242247463725689
525.0,PL004L2,WrocÅaw,2016,1389,263311,264700,0.5247449943332074
526.0,PL005L2,PoznaÅ,2016,851,308477,309328,0.2751125019396886
527.0,PL006L2,GdaÅsk,2016,2356,261160,263516,0.8940633585816421
528.0,PL007L2,Szczecin,2016,4036,109024,113060,3.569785954360517
529.0,PL008L2,Bydgoszcz,2016,2015,208121,210136,0.9589028058019567
530.0,PL009L2,Lublin,2016,385,322399,322784,0.11927480916030535
531.0,PL010L2,Katowice,2016,2874,391721,394595,0.7283417174571396
532.0,PL011L2,BiaÅystok,2016,75,223247,223322,0.03358379380446172
533.0,PL012L2,Kielce,2016,163,224066,224229,0.0726935409781964
534.0,PL013L2,ToruÅ,2016,1362,157571,158933,0.8569648845740029
535.0,PL014L2,Olsztyn,2016,6204,196340,202544,3.063038154672565
536.0,PL015L2,RzeszÃ³w,2016,110,229239,229349,0.04796183981617535
537.0,PL016L2,Opole,2016,1208,175408,176616,0.6839697422657064
538.0,PL017L2,GorzÃ³w Wielkopolski,2016,157,97263,97420,0.16115787312666802
539.0,PL018L2,Zielona GÃ³ra,2016,170,169114,169284,0.10042295786961555
540.0,PL019L2,Jelenia GÃ³ra,2016,1354,81987,83341,1.624650532151042
541.0,PL020L2,Nowy SÄcz,2016,392,130026,130418,0.30057200693155856
542.0,PL021L2,SuwaÅki,2016,1590,70543,72133,2.2042615723732553
543.0,PL022L2,Konin,2016,1926,116237,118163,1.6299518461785838
544.0,PL024L2,CzÄstochowa,2016,23,193875,193898,0.011861906775727444
545.0,PL025L2,Radom,2016,5,68017,68022,0.00735056305312987
546.0,PL026L2,PÅock,2016,3093,167982,171075,1.8079789565979836
547.0,PL027L2,Kalisz,2016,53,148970,149023,0.03556497990243117
548.0,PL028L2,Koszalin,2016,162,129509,129671,0.12493155755720245
549.0,PL029L1,SÅupsk,2016,10881,224123,235004,4.630133955166721
550.0,PL030L1,JastrzÄbie-ZdrÃ³j,2016,60,29511,29571,0.20290149132596125
551.0,PL031L1,Siedlce,2016,106,126063,126169,0.0840142982824624
552.0,PL032L1,PiotrkÃ³w Trybunalski,2016,199,116723,116922,0.17019893604283196
553.0,PL033L1,Lubin,2016,220,93086,93306,0.23578333654856062
554.0,PL034L1,PiÅa,2016,2342,49850,52192,4.487277743715512
555.0,PL035L1,InowrocÅaw,2016,42,20086,20128,0.208664546899841
556.0,PL036L1,Ostrowiec ÅwiÄtokrzyski,2016,3,61457,61460,0.00488122356003905
557.0,PL037L1,Gniezno,2016,361,66210,66571,0.542278169172763
558.0,PL038L1,Stargard SzczeciÅski,2016,2043,34621,36664,5.572223434431596
559.0,PL039L1,OstrÃ³w Wielkopolski,2016,179,84582,84761,0.21118202947110112
560.0,PL040L1,PrzemyÅl,2016,418,84671,85089,0.4912503378815123
561.0,PL041L1,ZamoÅÄ,2016,327,112380,112707,0.2901328222736831
562.0,PL042L1,CheÅm,2016,125,46445,46570,0.2684131415074082
563.0,PL043L1,Pabianice,2016,5,32954,32959,0.015170363178494494
564.0,PL044L1,GÅogÃ³w,2016,109,63972,64081,0.17009722070504518
565.0,PL045L1,Stalowa Wola,2016,429,189884,190313,0.22541812698029037
566.0,PL046L1,TomaszÃ³w Mazowiecki,2016,520,18643,19163,2.7135625945833115
567.0,PL047L1,ÅomÅ¼a,2016,10,55992,56002,0.01785650512481697
568.0,PL048L1,Leszno,2016,151,77421,77572,0.19465786624039602
569.0,PL049L1,Åwidnica,2016,11,47979,47990,0.022921441967076475
570.0,PL051L1,Tczew,2016,199,26925,27124,0.7336676006488718
571.0,PL052L1,EÅk,2016,1702,38350,40052,4.249475681613902
572.0,PL506L2,Bielsko-BiaÅa,2016,430,73005,73435,0.5855518485735685
573.0,PL508L1,Rybnik,2016,31,14850,14881,0.20831933337813321
574.0,PL511L2,WaÅbrzych,2016,0,51510,51510,0.0
575.0,PL512L2,ElblÄg,2016,30,96445,96475,0.031096138896087068
576.0,PL513L2,WÅocÅawek,2016,2203,120276,122479,1.7986756913430058
577.0,PL514L2,TarnÃ³w,2016,221,125106,125327,0.17633869796612064
578.0,PL516L2,Legnica,2016,0,56500,56500,0.0
579.0,PL517L2,GrudziÄdz,2016,1106,53937,55043,2.0093381538070236
580.0,PT001L3,Lisboa,2016,7254,432027,439281,1.651334794812432
581.0,PT002L2,Porto,2016,1095,94645,95740,1.1437225819928973
582.0,PT003L1,Braga,2016,45,49304,49349,0.0911872581004681
583.0,PT004L2,Funchal,2016,954,35008,35962,2.6528001779656303
584.0,PT005L2,Coimbra,2016,431,162356,162787,0.26476315676313217
585.0,PT007L1,Ponta Delgada,2016,298,54996,55294,0.5389373168879082
586.0,PT008L2,Aveiro,2016,1919,41411,43330,4.428802215555043
587.0,PT009L1,Faro,2016,2502,46648,49150,5.090539165818922
588.0,PT014L1,Viseu,2016,7,70867,70874,0.00987668256342241
589.0,PT016L0,Viana do Castelo,2016,353,31899,32252,1.094505767084212
590.0,PT019L0,PÃ³voa de Varzim,2016,35,8371,8406,0.4163692600523436
591.0,PT505L1,GuimarÃ£es,2016,1,26540,26541,0.0037677555480200445
592.0,RO001L1,BucureÅti,2016,214,107628,107842,0.1984384562600842
593.0,RO002L1,Cluj-Napoca,2016,0,59302,59302,0.0
594.0,RO003L1,TimiÅoara,2016,4,23650,23654,0.01691045911896508
595.0,RO004L1,Craiova,2016,14,34382,34396,0.04070240725665775
596.0,RO005L1,BrÄila,2016,1123,22406,23529,4.77283352458668
597.0,RO006L1,Oradea,2016,11,20328,20339,0.05408328826392645
598.0,RO007L1,BacÄu,2016,24,22069,22093,0.10863169329651927
599.0,RO008L1,Arad,2016,264,51344,51608,0.5115485971167261
600.0,RO009L1,Sibiu,2016,133,56207,56340,0.23606673766418174
601.0,RO010L1,TÃ¢rgu MureÅ,2016,16,13724,13740,0.11644832605531297
602.0,RO011L1,Piatra NeamÅ£,2016,92,14907,14999,0.6133742249483298
603.0,RO012L1,CÇlÇraÅi,2016,425,24119,24544,1.7315840938722293
604.0,RO013L1,Giurgiu,2016,532,10418,10950,4.858447488584475
605.0,RO014L1,Alba Iulia,2016,0,26002,26002,0.0
606.0,RO015L1,FocÅani,2016,0,27102,27102,0.0
607.0,RO016L1,TÃ¢rgu Jiu,2016,10,24512,24522,0.0407797080172906
608.0,RO017L1,Tulcea,2016,1639,39308,40947,4.0027352431191545
609.0,RO018L1,TÃ¢rgoviÅte,2016,2,20255,20257,0.009873130275953991
610.0,RO019L1,Slatina,2016,140,6983,7123,1.9654639898918997
611.0,RO020L1,BÃ¢rlad,2016,0,26319,26319,0.0
612.0,RO021L1,Roman,2016,3,14387,14390,0.020847810979847115
613.0,RO022L1,BistriÅ£a,2016,8,42623,42631,0.0187656869414276
614.0,RO501L1,Constanta,2016,4804,54547,59351,8.094219136998534
615.0,RO502L1,Iasi,2016,11,79925,79936,0.013761008807045637
616.0,RO503L1,Galati,2016,2463,38769,41232,5.9735157159487775
617.0,RO504L1,Brasov,2016,142,98361,98503,0.14415804594783915
618.0,RO505L1,Ploiesti,2016,0,34337,34337,0.0
619.0,RO506L1,Pitesti,2016,114,24770,24884,0.45812570326314095
620.0,RO507L1,Baia Mare,2016,25,52516,52541,0.047581888429988006
621.0,RO508L1,Buzau,2016,0,38540,38540,0.0
622.0,RO509L1,Satu Mare,2016,4,70840,70844,0.005646208570944611
623.0,RO510L1,Botosani,2016,0,37340,37340,0.0
624.0,RO511L1,Ramnicu Valcea,2016,378,28795,29173,1.295718643951599
625.0,RO512L1,Suceava,2016,20,39658,39678,0.05040576641967841
626.0,RO513L1,Drobeta-Turnu Severin,2016,2172,30762,32934,6.595008198214611
627.0,RS001L1,Beograd,2016,6672,306352,313024,2.1314659578818236
628.0,RS002L1,Novi Sad,2016,2742,186701,189443,1.4474010652280633
629.0,RS003L1,NiÅ¡,2016,7,341557,341564,0.002049396306402314
630.0,RS004L1,Kragujevac,2016,622,143453,144075,0.43171959049106373
631.0,RS005L1,Subotica,2016,107,160185,160292,0.066753175454795
632.0,RS006L1,Novi Pazar,2016,0,140791,140791,0.0
633.0,RS008L1,Zrenjanin,2016,1246,183885,185131,0.6730369306058952
634.0,RS009L1,Kraljevo,2016,1,176511,176512,0.0005665337200870196
635.0,RS011L0,ÄaÄak,2016,38,63649,63687,0.05966680798279084
636.0,RS012L1,KruÅ¡evac,2016,0,122649,122649,0.0
637.0,RS013L1,Leskovac,2016,1,166281,166282,0.000601388003512106
638.0,RS014L1,Valjevo,2016,0,141662,141662,0.0
639.0,RS015L1,Vranje,2016,0,195356,195356,0.0
640.0,RS016L1,Smederevo,2016,2771,157453,160224,1.729453764729379
641.0,SE001L1,Stockholm,2016,64066,691660,755726,8.477411125196168
642.0,SE002L1,GÃ¶teborg,2016,20508,414751,435259,4.7116774150563225
643.0,SE003L1,MalmÃ¶,2016,2907,185109,188016,1.5461450089354096
644.0,SE004L1,JÃ¶nkÃ¶ping,2016,53192,293999,347191,15.320673634973256
645.0,SE005L1,UmeÃ¥,2016,16192,972057,988249,1.6384534666870394
646.0,SE006L1,Uppsala,2016,11423,686104,697527,1.6376427005692968
647.0,SE007L1,LinkÃ¶ping,2016,11476,411720,423196,2.7117458577113207
648.0,SE008L1,Ãrebro,2016,21817,346780,368597,5.918930430795693
649.0,SE501L1,VÃ¤sterÃ¥s,2016,15644,274771,290415,5.386774099133998
650.0,SE502L1,NorrkÃ¶ping,2016,9016,302722,311738,2.8921722728701664
651.0,SE503L1,Helsingborg,2016,1402,113020,114422,1.2252888430546574
652.0,SE505L1,BorÃ¥s,2016,1374,95988,97362,1.4112281999137242
653.0,SI001L2,Ljubljana,2016,419,232868,233287,0.17960709340854827
654.0,SI002L1,Maribor,2016,506,216479,216985,0.23319584303062424
655.0,SK001L1,Bratislava,2016,1629,203312,204941,0.7948629117648494
656.0,SK002L1,KoÅ¡ice,2016,382,177252,177634,0.2150489208147089
657.0,SK003L1,BanskÃ¡ Bystrica,2016,1,80879,80880,0.0012363996043521265
658.0,SK004L1,Nitra,2016,2,87125,87127,0.0022954996728912964
659.0,SK005L1,PreÅ¡ov,2016,6,93293,93299,0.006430937094716985
660.0,SK006L1,Å½ilina,2016,271,81177,81448,0.33272762989883115
661.0,SK007L1,Trnava,2016,136,74084,74220,0.18323901913230936
662.0,SK008L1,TrenÄÃ­n,2016,60,67363,67423,0.08899040386811621
739.0,UK001L3,London,2016,1258,696912,698170,0.18018534167896072
740.0,UK002L3,West Midlands urban area,2016,230,215079,215309,0.1068232168650637
741.0,UK003L2,Leeds,2016,268,512159,512427,0.052300132506679003
742.0,UK004L1,Glasgow,2016,2108,335576,337684,0.62425225950889
743.0,UK006L3,Liverpool,2016,619,99884,100503,0.6159020128752375
744.0,UK007L1,Edinburgh,2016,1029,174389,175418,0.5865988667069514
745.0,UK008L3,Greater Manchester,2016,699,311547,312246,0.2238619549970216
746.0,UK009L1,Cardiff,2016,176,84315,84491,0.20830621012888945
747.0,UK010L3,Sheffield,2016,213,125874,126087,0.16893097623069786
748.0,UK011L2,Bristol,2016,202,98183,98385,0.20531585099354577
749.0,UK012L2,Belfast,2016,22167,172978,195145,11.359245689102975
750.0,UK013L2,Newcastle upon Tyne,2016,1601,545107,546708,0.29284371181691143
751.0,UK014L1,Leicester,2016,106,139675,139781,0.07583291005215301
752.0,UK016L1,Aberdeen,2016,1412,652536,653948,0.21591930856887706
753.0,UK017L2,Cambridge,2016,109,159510,159619,0.06828760987100532
754.0,UK018L3,Exeter,2016,1012,246714,247726,0.4085158602649702
755.0,UK019L3,Lincoln,2016,86,211457,211543,0.04065367324846485
756.0,UK023L1,Portsmouth,2016,292,20561,20853,1.4002781374382582
757.0,UK024L1,Worcester,2016,7,61195,61202,0.011437534721087547
758.0,UK025L3,Coventry,2016,194,81253,81447,0.23819170749076085
759.0,UK026L1,Kingston upon Hull,2016,405,251293,251698,0.1609071188487791
760.0,UK027L1,Stoke-on-Trent,2016,122,88054,88176,0.13835964434766831
761.0,UK029L1,Nottingham,2016,132,90157,90289,0.14619721117744133
762.0,UK033L1,Guildford,2016,11,61680,61691,0.017830801899790895
763.0,UK050L1,Burnley,2016,9,27965,27974,0.03217273182240652
764.0,UK056L1,Hastings,2016,124,54626,54750,0.2264840182648402
765.0,UK515L1,Brighton and Hove,2016,312,42095,42407,0.7357275921428066
766.0,UK516L1,Plymouth,2016,809,214966,215775,0.37492758660641873
767.0,UK517L1,Swansea,2016,289,83753,84042,0.3438756812070155
768.0,UK518L1,Derby,2016,79,68023,68102,0.11600246688790343
769.0,UK520L2,Southampton,2016,1117,152235,153352,0.7283895873545829
770.0,UK528L1,Northampton,2016,600,153945,154545,0.3882364359895176
771.0,UK539L1,Bournemouth,2016,815,92978,93793,0.8689347819133624
772.0,UK546L1,Colchester,2016,376,69119,69495,0.541046118425786
773.0,UK550L0,Dundee City,2016,964,225452,226416,0.4257649636068122
774.0,UK551L1,Falkirk,2016,46,29743,29789,0.15441941656316088
775.0,UK552L0,Reading,2016,13,21908,21921,0.05930386387482323
776.0,UK553L1,Blackpool,2016,52,48903,48955,0.10621999795730774
777.0,UK557L1,Blackburn with Darwen,2016,50,79504,79554,0.06285039092943158
778.0,UK558L1,Newport,2016,85,31615,31700,0.26813880126182965
779.0,UK559L2,Middlesbrough,2016,902,60867,61769,1.4602794281921352
780.0,UK560L1,Oxford,2016,369,192554,192923,0.19126801884689748
781.0,UK562L2,Preston,2016,42,25720,25762,0.16303082058846363
782.0,UK566L1,Norwich,2016,131,150109,150240,0.08719382321618743
783.0,UK568L1,Cheshire West and Chester,2016,312,135833,136145,0.22916743178229096
784.0,UK569L2,Ipswich,2016,1484,154162,155646,0.9534456394639117
785.0,UK571L1,Cheltenham,2016,1,46182,46183,0.002165298919515839
786.0,XK001L1,Pristina,2016,0,255807,255807,0.0
787.0,XK002L1,Prizren,2016,182,127451,127633,0.1425963504736236
788.0,XK003L1,MitrovicÃ«,2016,0,117914,117914,0.0
1.0,AL001L1,Tirana,2017,1605,165516,167121,0.9603819986716212
2.0,AL003L1,Elbasan,2017,648,125356,126004,0.5142693882733881
3.0,AL004L1,ShkodÃ«r,2017,9220,176109,185329,4.974936464341792
4.0,AL005L0,VlorÃ«,2017,2195,61538,63733,3.4440556697472267
5.0,AT001L3,Wien,2017,8142,910348,918490,0.8864549423510327
6.0,AT002L3,Graz,2017,434,290698,291132,0.14907327260486652
7.0,AT003L3,Linz,2017,1501,357729,359230,0.4178381538290232
8.0,AT004L3,Salzburg,2017,2577,134899,137476,1.8745090052081816
9.0,AT005L3,Innsbruck,2017,17102,195720,212822,8.03582336412589
10.0,AT006L2,Klagenfurt,2017,2739,180521,183260,1.4945978391356542
11.0,BA001L1,Sarajevo,2017,0,263774,263774,0.0
12.0,BA002L1,Banja Luka,2017,1,275301,275302,0.00036323746285896945
13.0,BA003L1,Mostar,2017,709,181638,182347,0.38881911959067056
14.0,BA004L1,Tuzla,2017,235,112026,112261,0.20933360650626665
15.0,BA005L1,Zenica,2017,0,86716,86716,0.0
16.0,BE001L2,Bruxelles / Brussel,2017,64,326587,326651,0.019592776388255354
17.0,BE002L2,Antwerpen,2017,4150,115062,119212,3.4811931684729727
18.0,BE003L2,Gent,2017,269,101572,101841,0.26413723353069984
19.0,BE004L2,Charleroi,2017,158,109607,109765,0.1439438801075024
20.0,BE005L2,LiÃ¨ge,2017,262,141136,141398,0.18529257839573404
21.0,BE006L2,Brugge,2017,827,55712,56539,1.4627071578910134
22.0,BE007L2,Namur,2017,42,84065,84107,0.04993639055013257
23.0,BE008L1,Leuven,2017,15,45061,45076,0.033277131954920575
24.0,BE009L1,Mons,2017,34,39166,39200,0.08673469387755102
25.0,BE010L1,Kortrijk,2017,41,22298,22339,0.18353552083799635
26.0,BE011L1,Oostende,2017,166,20766,20932,0.7930441429390407
27.0,BG001L2,Sofia,2017,642,571132,571774,0.11228212545516235
28.0,BG002L2,Plovdiv,2017,250,276836,277086,0.0902246955818771
29.0,BG003L2,Varna,2017,3629,201169,204798,1.7719899608394614
30.0,BG004L2,Burgas,2017,4936,290964,295900,1.668131125380196
31.0,BG005L1,Pleven,2017,1067,178009,179076,0.5958364046550069
32.0,BG006L2,Ruse,2017,2459,131558,134017,1.834841848422215
33.0,BG007L2,Vidin,2017,1750,59214,60964,2.8705465520635127
34.0,BG008L2,Stara Zagora,2017,1,132067,132068,0.0007571856922191599
35.0,BG009L1,Sliven,2017,3,136771,136774,0.002193399330282071
36.0,BG010L1,Dobrich,2017,2,140336,140338,0.0014251307557468398
37.0,BG011L1,Shumen,2017,65,94442,94507,0.06877797411831928
38.0,BG013L1,Yambol,2017,294,130512,130806,0.22476033209485802
39.0,BG014L1,Haskovo,2017,385,73583,73968,0.5204953493402552
40.0,BG015L1,Pazardzhik,2017,13,63809,63822,0.020369151703174455
41.0,BG016L1,Blagoevgrad,2017,1,135478,135479,0.000738121775330494
42.0,BG017L1,Veliko Tarnovo,2017,0,88539,88539,0.0
43.0,BG018L1,Vratsa,2017,32,70525,70557,0.04535340221381295
44.0,CH001L2,ZÃ¼rich,2017,298,127419,127717,0.23332837445289192
45.0,CH002L2,GenÃ¨ve,2017,35,53862,53897,0.06493867933280145
46.0,CH003L2,Basel,2017,57,69363,69420,0.08210890233362143
47.0,CH004L2,Bern,2017,23,78265,78288,0.029378704271408134
48.0,CH005L2,Lausanne,2017,4,77501,77505,0.0051609573575898335
49.0,CH006L1,Winterthur,2017,0,13291,13291,0.0
50.0,CH007L2,St. Gallen,2017,127,31782,31909,0.3980068319282961
51.0,CH008L2,Luzern,2017,354,28905,29259,1.2098841382138827
52.0,CH009L2,Lugano,2017,156,30469,30625,0.5093877551020408
53.0,CH010L1,Biel/Bienne,2017,0,9095,9095,0.0
54.0,CY001L2,Lefkosia,2017,52,162576,162628,0.03197481368522025
55.0,CY501L2,Lemesos,2017,964,124935,125899,0.7656931349732723
56.0,CZ001L2,Praha,2017,539,570023,570562,0.09446826111798542
57.0,CZ002L2,Brno,2017,516,267399,267915,0.1925983987458709
58.0,CZ003L2,Ostrava,2017,135,142531,142666,0.09462661040472152
59.0,CZ004L2,PlzeÅ,2017,255,195702,195957,0.13013058987430917
60.0,CZ005L2,ÃstÃ­ nad Labem,2017,430,35481,35911,1.197404694940269
61.0,CZ006L2,Olomouc,2017,31,93533,93564,0.033132401350946944
62.0,CZ007L2,Liberec,2017,0,61316,61316,0.0
63.0,CZ008L2,ÄeskÃ© BudÄjovice,2017,1875,127529,129404,1.4489505733980401
64.0,CZ009L2,Hradec KrÃ¡lovÃ©,2017,60,79445,79505,0.07546695176404
65.0,CZ010L2,Pardubice,2017,113,86244,86357,0.13085216021862733
66.0,CZ011L2,ZlÃ­n,2017,10,57942,57952,0.01725565985643291
67.0,CZ013L2,Karlovy Vary,2017,0,46984,46984,0.0
68.0,CZ014L2,Jihlava,2017,18,96009,96027,0.018744728045237274
69.0,CZ016L2,Most,2017,10,27768,27778,0.03599971200230398
70.0,CZ018L2,Chomutov-Jirkov,2017,87,45599,45686,0.19043032876592392
71.0,DE001L1,Berlin,2017,8638,1739627,1748265,0.49408985479890066
72.0,DE002L1,Hamburg,2017,13316,720858,734174,1.8137389774086254
73.0,DE003L1,MÃ¼nchen,2017,4775,545166,549941,0.8682749604048434
74.0,DE004L1,KÃ¶ln,2017,540,162090,162630,0.3320420586607637
75.0,DE005L1,Frankfurt am Main,2017,672,429659,430331,0.15615886375836274
76.0,DE007L1,Stuttgart,2017,101,365069,365170,0.02765835090505792
77.0,DE008L2,Leipzig,2017,4110,393579,397689,1.0334708779976312
78.0,DE009L2,Dresden,2017,5011,578185,583196,0.8592308589222148
79.0,DE011L1,DÃ¼sseldorf,2017,995,119322,120317,0.8269820557360972
80.0,DE012L1,Bremen,2017,1823,587716,589539,0.3092246653741313
81.0,DE013L1,Hannover,2017,2593,294719,297312,0.8721477774190076
82.0,DE014L1,NÃ¼rnberg,2017,357,293144,293501,0.12163501998289615
83.0,DE017L0,Bielefeld,2017,11,25872,25883,0.042498937526561836
84.0,DE018L1,Halle an der Saale,2017,1922,155664,157586,1.2196514918837968
85.0,DE019L2,Magdeburg,2017,529,416505,417034,0.12684817065275253
86.0,DE020L1,Wiesbaden,2017,301,101137,101438,0.29673297975117807
87.0,DE021L1,GÃ¶ttingen,2017,190,238767,238957,0.07951221349447808
88.0,DE025L1,Darmstadt,2017,83,78104,78187,0.10615575479299627
89.0,DE026L1,Trier,2017,14,121113,121127,0.011558116687443757
90.0,DE027L1,Freiburg im Breisgau,2017,432,220764,221196,0.19530190419356588
91.0,DE028L1,Regensburg,2017,362,253300,253662,0.14270958992675292
92.0,DE029L0,Frankfurt (Oder),2017,17,14827,14844,0.11452438695769335
93.0,DE030L1,Weimar,2017,34,88994,89028,0.03819023228647167
94.0,DE031L1,Schwerin,2017,6924,483079,490003,1.4130525731475112
95.0,DE032L1,Erfurt,2017,722,284790,285512,0.2528790383591583
96.0,DE033L1,Augsburg,2017,41,199893,199934,0.02050676723318695
97.0,DE034L1,Bonn,2017,295,129042,129337,0.22808631714049343
98.0,DE035L1,Karlsruhe,2017,536,125276,125812,0.42603249292595297
99.0,DE036L0,MÃ¶nchengladbach,2017,0,17023,17023,0.0
100.0,DE037L1,Mainz,2017,419,69886,70305,0.5959746817438305
101.0,DE038L1,Ruhrgebiet,2017,1156,442596,443752,0.2605058681425661
102.0,DE039L1,Kiel,2017,8613,331149,339762,2.5350098009783317
103.0,DE040L1,SaarbrÃ¼cken,2017,8,153674,153682,0.0052055543264663395
104.0,DE042L1,Koblenz,2017,411,91765,92176,0.4458861308800555
105.0,DE043L2,Rostock,2017,3300,358504,361804,0.9120960520060586
106.0,DE044L1,Kaiserslautern,2017,1,135526,135527,0.0007378603525496764
107.0,DE045L1,Iserlohn,2017,21,106086,106107,0.019791342701235545
108.0,DE048L1,Wilhelmshaven,2017,534,73513,74047,0.7211635852904237
109.0,DE050L1,TÃ¼bingen,2017,5,52020,52025,0.009610764055742432
110.0,DE051L1,Villingen-Schwenningen,2017,26,102534,102560,0.02535101404056162
111.0,DE052L1,Flensburg,2017,1889,203586,205475,0.9193332522204648
112.0,DE053L1,Marburg,2017,9,126233,126242,0.007129164620332378
113.0,DE054L1,Konstanz,2017,95,81805,81900,0.115995115995116
114.0,DE055L0,NeumÃ¼nster,2017,101,7075,7176,1.407469342251951
115.0,DE056L0,Brandenburg an der Havel,2017,865,21965,22830,3.788874288217258
116.0,DE057L1,GieÃen,2017,36,85492,85528,0.04209147881395566
117.0,DE058L1,LÃ¼neburg,2017,480,132022,132502,0.3622586828878055
118.0,DE059L1,Bayreuth,2017,98,199822,199920,0.049019607843137254
119.0,DE060L1,Celle,2017,26,155021,155047,0.016769108721871432
120.0,DE061L1,Aschaffenburg,2017,297,147319,147616,0.20119770214610885
121.0,DE062L1,Bamberg,2017,155,122000,122155,0.1268879702017928
122.0,DE063L1,Plauen,2017,671,140617,141288,0.47491648264537684
123.0,DE064L1,Neubrandenburg,2017,24275,559716,583991,4.1567421415740995
124.0,DE065L1,Fulda,2017,4,138221,138225,0.0028938325194429373
125.0,DE066L1,Kempten (AllgÃ¤u),2017,1640,157527,159167,1.0303643343155302
126.0,DE067L1,Landshut,2017,117,141336,141453,0.0827129859387924
127.0,DE069L1,Rosenheim,2017,59,147704,147763,0.039928804910566246
128.0,DE071L1,Stralsund,2017,19716,318532,338248,5.8288592985028735
129.0,DE072L1,Friedrichshafen,2017,48,66571,66619,0.0720515168345367
130.0,DE073L1,Offenburg,2017,22,185862,185884,0.011835338167889653
131.0,DE074L1,GÃ¶rlitz,2017,1879,209228,211107,0.8900699645203618
132.0,DE077L1,Schweinfurt,2017,157,201183,201340,0.077977550412238
133.0,DE078L1,Greifswald,2017,2963,346831,349794,0.8470699897654048
134.0,DE079L1,Wetzlar,2017,59,106431,106490,0.05540426331110903
135.0,DE081L1,Passau,2017,555,159511,160066,0.34673197306111225
136.0,DE082L0,Dessau-RoÃlau,2017,11,24637,24648,0.04462836741317754
137.0,DE083L1,Braunschweig-Salzgitter-Wolfsburg,2017,925,411919,412844,0.2240555754716067
138.0,DE084L1,Mannheim-Ludwigshafen,2017,331,204097,204428,0.16191519752675756
139.0,DE504L1,MÃ¼nster,2017,54,141709,141763,0.03809174467244626
140.0,DE505L0,Chemnitz,2017,4,22189,22193,0.01802370116703465
141.0,DE507L1,Aachen,2017,93,70427,70520,0.13187748156551332
142.0,DE508L0,Krefeld,2017,49,13631,13680,0.358187134502924
143.0,DE510L1,LÃ¼beck,2017,4674,157475,162149,2.882533965673547
144.0,DE513L1,Kassel,2017,73,139788,139861,0.052194679002724134
145.0,DE516L0,Solingen,2017,0,8954,8954,0.0
146.0,DE517L1,OsnabrÃ¼ck,2017,3,224127,224130,0.0013385089010841923
147.0,DE520L1,Oldenburg (Oldenburg),2017,110,189859,189969,0.057904184366923024
148.0,DE522L1,Heidelberg,2017,152,116953,117105,0.12979804448998764
149.0,DE523L1,Paderborn,2017,114,124569,124683,0.09143187122542769
150.0,DE524L2,WÃ¼rzburg,2017,298,305631,305929,0.09740822216919613
151.0,DE527L1,Bremerhaven,2017,1032,213447,214479,0.48116598827857276
152.0,DE529L1,Heilbronn,2017,34,119950,119984,0.02833711161488198
153.0,DE530L0,Remscheid,2017,0,7369,7369,0.0
154.0,DE532L1,Ulm,2017,229,199079,199308,0.11489754550745579
155.0,DE533L1,Pforzheim,2017,9,67139,67148,0.013403228688866385
156.0,DE534L1,Ingolstadt,2017,443,284392,284835,0.1555286393877157
157.0,DE535L1,Gera,2017,275,99511,99786,0.2755897620908745
158.0,DE537L1,Reutlingen,2017,5,109277,109282,0.004575318899727311
159.0,DE539L1,Cottbus,2017,810,181470,182280,0.4443712969058591
160.0,DE540L2,Siegen,2017,13,177551,177564,0.007321303867901151
161.0,DE542L1,Hildesheim,2017,151,120659,120810,0.1249896531744061
162.0,DE544L1,Zwickau,2017,107,94697,94804,0.11286443609974262
163.0,DE546L0,Wuppertal,2017,2,16831,16833,0.011881423394522663
164.0,DE547L2,Jena,2017,0,93068,93068,0.0
165.0,DE548L1,DÃ¼ren,2017,67,93971,94038,0.071247793445203
166.0,DE549L1,Bocholt,2017,81,142184,142265,0.05693599971883456
167.0,DK001L2,KÃ¸benhavn,2017,15836,275387,291223,5.4377573199918965
168.0,DK002L3,Ãrhus,2017,5352,457172,462524,1.1571291435687663
169.0,DK003L2,Odense,2017,7473,352366,359839,2.0767621074980753
170.0,DK004L3,Aalborg,2017,2490,617969,620459,0.40131580007703976
171.0,EE001L1,Tallinn,2017,5902,433159,439061,1.344232350402336
172.0,EE002L1,Tartu,2017,1147,298495,299642,0.3827901295546018
173.0,EE003L0,Narva,2017,343,6546,6889,4.978951952387865
174.0,EL001L1,Athina,2017,5104,304283,309387,1.6497137888792999
175.0,EL002L1,Thessaloniki,2017,1482,140637,142119,1.0427880860405716
176.0,EL003L1,Patra,2017,665,50925,51590,1.289009497964722
177.0,EL004L1,Irakleio,2017,1085,60299,61384,1.7675615795647075
178.0,EL005L1,Larisa,2017,63,155456,155519,0.040509519737138226
179.0,EL006L1,Volos,2017,273,30543,30816,0.8859034267912772
180.0,EL007L1,Ioannina,2017,2020,130621,132641,1.522907698223023
181.0,EL008L1,Kavala,2017,307,35261,35568,0.8631354026090868
182.0,EL009L1,Kalamata,2017,269,44183,44452,0.6051471249887519
183.0,ES001L3,Madrid,2017,2393,785210,787603,0.30383327640956165
184.0,ES002L2,Barcelona,2017,1299,263308,264607,0.49091671800065756
185.0,ES003L3,Valencia,2017,3093,172027,175120,1.766217450890818
186.0,ES004L3,Sevilla,2017,4519,463907,468426,0.9647201478995615
187.0,ES005L2,Zaragoza,2017,152,275986,276138,0.05504494129746721
188.0,ES006L2,MÃ¡laga,2017,860,151882,152742,0.5630409448612693
189.0,ES007L2,Murcia,2017,90,120046,120136,0.07491509622427915
190.0,ES008L2,Las Palmas,2017,910,75686,76596,1.1880515953835709
191.0,ES009L2,Valladolid,2017,160,115369,115529,0.13849336530221848
192.0,ES010L2,Palma de Mallorca,2017,2235,201999,204234,1.0943329710038485
193.0,ES011L2,Santiago de Compostela,2017,11,126245,126256,0.008712457229755418
194.0,ES012L2,Vitoria/Gasteiz,2017,1481,157840,159321,0.9295698621022965
195.0,ES013L2,Oviedo,2017,5,93482,93487,0.00534833720196391
196.0,ES014L3,Pamplona/IruÃ±a,2017,101,169413,169514,0.05958209941361775
197.0,ES015L2,Santander,2017,474,69009,69483,0.682181252968352
198.0,ES016L2,Toledo,2017,458,92940,93398,0.49037452622111827
199.0,ES017L2,Badajoz,2017,701,218048,218749,0.32045860781077856
200.0,ES018L2,LogroÃ±o,2017,50,46088,46138,0.10837054055225627
201.0,ES019L3,Bilbao,2017,921,152400,153321,0.6007004911264602
202.0,ES020L2,CÃ³rdoba,2017,1205,185697,186902,0.6447229029116863
203.0,ES021L2,Alicante/Alacant,2017,412,35646,36058,1.1426035831160908
204.0,ES022L2,Vigo,2017,948,135523,136471,0.6946530764777864
205.0,ES023L2,GijÃ³n,2017,459,52943,53402,0.8595183700984981
206.0,ES025L3,Santa Cruz de Tenerife,2017,1190,65793,66983,1.7765701745218938
207.0,ES026L2,CoruÃ±a (A),2017,155,75820,75975,0.2040144784468575
208.0,ES028L1,Reus,2017,0,11534,11534,0.0
209.0,ES031L1,Lugo,2017,32,133979,134011,0.023878636828320064
210.0,ES033L1,Girona,2017,2,39619,39621,0.005047828171929028
211.0,ES034L1,CÃ¡ceres,2017,1946,236327,238273,0.8167102441317313
212.0,ES035L1,Torrevieja,2017,1692,7146,8838,19.144602851323828
213.0,ES039L1,AvilÃ©s,2017,105,19037,19142,0.5485320238219622
214.0,ES040L1,Talavera de la Reina,2017,551,82715,83266,0.6617346816227512
215.0,ES041L1,Palencia,2017,0,28381,28381,0.0
216.0,ES043L1,Ferrol,2017,268,46702,46970,0.570576964019587
217.0,ES044L1,Pontevedra,2017,179,51437,51616,0.3467916924984501
218.0,ES046L1,Gandia,2017,244,17093,17337,1.407394589606045
219.0,ES048L1,Guadalajara,2017,4,45379,45383,0.008813873036158914
220.0,ES050L1,Manresa,2017,3,29600,29603,0.010134108029591596
221.0,ES053L1,Ciudad Real,2017,577,95768,96345,0.5988894078571799
222.0,ES054L1,Benidorm,2017,325,20348,20673,1.5720988729260386
223.0,ES057L1,Ponferrada,2017,247,62096,62343,0.396195242449032
224.0,ES059L1,Zamora,2017,330,33850,34180,0.965476887068461
225.0,ES070L1,Irun,2017,78,7164,7242,1.0770505385252693
226.0,ES072L1,Arrecife,2017,2788,56146,58934,4.730715715885567
227.0,ES501L3,Granada,2017,365,162259,162624,0.22444411648957102
228.0,ES505L1,Elche/Elx,2017,683,38135,38818,1.7594930187026636
229.0,ES506L1,Cartagena,2017,1480,59468,60948,2.428299534029008
230.0,ES508L1,Jerez de la Frontera,2017,176,125930,126106,0.13956512774967092
231.0,ES510L1,Donostia-San SebastiÃ¡n,2017,216,33104,33320,0.6482593037214885
232.0,ES514L1,AlmerÃ­a,2017,737,39993,40730,1.8094770439479497
233.0,ES515L1,Burgos,2017,4,149387,149391,0.002677537468789954
234.0,ES516L1,Salamanca,2017,17,45627,45644,0.03724476382437999
235.0,ES519L1,Albacete,2017,15,245310,245325,0.0061143381228981955
236.0,ES520L1,CastellÃ³n/CastellÃ³,2017,344,32450,32794,1.0489723729950602
237.0,ES521L1,Huelva,2017,3800,93620,97420,3.9006364196263603
238.0,ES522L1,CÃ¡diz,2017,999,23834,24833,4.022872790238796
239.0,ES523L1,LeÃ³n,2017,1,118886,118887,0.0008411348591519679
240.0,ES525L1,Tarragona,2017,451,21289,21740,2.0745170193192273
241.0,ES527L1,JaÃ©n,2017,31,99900,99931,0.03102140476929081
242.0,ES528L1,Lleida,2017,108,70567,70675,0.1528121683763707
243.0,ES529L1,Ourense,2017,384,64784,65168,0.5892462558310827
244.0,ES532L1,Algeciras,2017,462,41832,42294,1.0923535253227408
245.0,ES533L1,Marbella,2017,569,68636,69205,0.8221949281121306
246.0,ES537L1,Alcoy,2017,0,20529,20529,0.0
247.0,ES538L1,Ãvila,2017,486,53160,53646,0.9059389330052566
248.0,ES542L1,Cuenca,2017,69,164513,164582,0.04192439027354145
249.0,ES543L1,Eivissa,2017,2038,57364,59402,3.4308609137739468
250.0,ES544L1,Linares,2017,13,25763,25776,0.05043451272501552
251.0,ES545L1,Lorca,2017,152,182055,182207,0.08342160290219366
252.0,ES546L1,MÃ©rida,2017,890,127409,128299,0.6936920786600052
253.0,ES547L1,Sagunto,2017,204,15324,15528,1.313755795981453
254.0,ES550L1,Puerto de la Cruz,2017,1338,26134,27472,4.87041351193943
255.0,ES552L1,Igualada,2017,0,25426,25426,0.0
256.0,FI001L3,Helsinki,2017,18395,473123,491518,3.7424875589500286
257.0,FI002L3,Tampere,2017,83004,605639,688643,12.053269981688624
258.0,FI003L4,Turku,2017,17268,449176,466444,3.702052122012503
259.0,FI004L4,Oulu,2017,15838,707983,723821,2.188110043781543
260.0,FI007L2,Lahti,2017,33030,302373,335403,9.847854670351786
261.0,FI008L2,Kuopio,2017,127709,792697,920406,13.875289817754338
262.0,FI009L2,JyvÃ¤skylÃ¤,2017,51326,425616,476942,10.761476238200872
263.0,FR001L1,Paris,2017,1593,1208359,1209952,0.13165811536325409
264.0,FR003L2,Lyon,2017,286,366945,367231,0.07788013539161999
265.0,FR004L2,Toulouse,2017,403,524269,524672,0.07680989265674555
266.0,FR006L2,Strasbourg,2017,62,203821,203883,0.030409597661403845
267.0,FR007L2,Bordeaux,2017,4798,550956,555754,0.8633316179460696
268.0,FR008L2,Nantes,2017,1793,314826,316619,0.5662957687315038
269.0,FR009L2,Lille,2017,57,144396,144453,0.03945920126269444
270.0,FR010L2,Montpellier,2017,7269,216649,223918,3.246277655213069
271.0,FR011L2,Saint-Etienne,2017,257,180798,181055,0.14194581756924693
272.0,FR012L2,Le Havre,2017,849,75589,76438,1.1107041000549465
273.0,FR013L2,Rennes,2017,199,381938,382137,0.052075564522671196
274.0,FR014L2,Amiens,2017,109,244686,244795,0.044527053248636615
275.0,FR016L2,Nancy,2017,136,283373,283509,0.04797025843976735
276.0,FR017L2,Metz,2017,52,176878,176930,0.029390154298310066
277.0,FR018L2,Reims,2017,19,243132,243151,0.007814074381762773
278.0,FR019L2,OrlÃ©ans,2017,1106,290861,291967,0.37880993399939034
279.0,FR020L2,Dijon,2017,121,385640,385761,0.031366571530040625
280.0,FR021L2,Poitiers,2017,30,250412,250442,0.01197882144368756
281.0,FR022L2,Clermont-Ferrand,2017,67,266059,266126,0.02517604443008199
282.0,FR023L2,Caen,2017,291,225982,226273,0.12860571080067
283.0,FR024L2,Limoges,2017,80,317754,317834,0.025170371955171567
284.0,FR025L2,BesanÃ§on,2017,2,239034,239036,0.0008366940544520491
285.0,FR026L2,Grenoble,2017,2661,263187,265848,1.0009479100839578
286.0,FR027L2,Ajaccio,2017,1486,145523,147009,1.0108224666517016
289.0,FR032L2,Toulon,2017,2198,104858,107056,2.0531310715887012
290.0,FR034L2,Valenciennes,2017,39,78407,78446,0.04971572801672488
291.0,FR035L2,Tours,2017,612,284236,284848,0.21485142953434813
292.0,FR036L2,Angers,2017,88,231163,231251,0.03805388949669407
293.0,FR037L2,Brest,2017,177,134817,134994,0.13111693853060136
294.0,FR038L2,Le Mans,2017,58,224053,224111,0.02588003266238605
295.0,FR039L1,Avignon,2017,1476,85749,87225,1.6921754084264833
296.0,FR040L2,Mulhouse,2017,25,129741,129766,0.019265447035433012
297.0,FR042L2,Dunkerque,2017,855,90270,91125,0.9382716049382716
298.0,FR043L2,Perpignan,2017,1533,181497,183030,0.8375676118669071
299.0,FR044L2,NÃ®mes,2017,1353,149138,150491,0.8990570864702874
300.0,FR045L2,Pau,2017,30,201729,201759,0.014869225164676668
301.0,FR046L2,Bayonne,2017,835,101795,102630,0.8136022605475981
302.0,FR047L0,Annemasse,2017,1,7799,7800,0.01282051282051282
303.0,FR048L2,Annecy,2017,1792,117251,119043,1.5053384071301967
304.0,FR049L2,Lorient,2017,578,112604,113182,0.5106819105511478
305.0,FR050L2,MontbÃ©liard,2017,8,123049,123057,0.0065010523578504275
306.0,FR051L2,Troyes,2017,57,260893,260950,0.021843264993293733
307.0,FR052L2,Saint-Nazaire,2017,322,106813,107135,0.30055537406076444
308.0,FR053L2,La Rochelle,2017,261,111079,111340,0.23441710077240882
309.0,FR056L2,AngoulÃªme,2017,27,214265,214292,0.012599630410841282
310.0,FR057L2,Boulogne-sur-Mer,2017,174,68364,68538,0.2538737634596866
311.0,FR058L2,ChambÃ©ry,2017,700,100989,101689,0.6883733737179045
312.0,FR059L2,Chalon-sur-SaÃ´ne,2017,56,156302,156358,0.03581524450299953
313.0,FR060L2,Chartres,2017,18,161342,161360,0.01115518096182449
314.0,FR061L2,Niort,2017,12,178907,178919,0.006706945601082054
315.0,FR062L2,Calais,2017,86,50144,50230,0.1712124228548676
316.0,FR063L2,BÃ©ziers,2017,422,84721,85143,0.49563675228732834
317.0,FR064L2,Arras,2017,19,107544,107563,0.01766406664001562
318.0,FR065L2,Bourges,2017,74,250245,250319,0.029562278532592412
319.0,FR066L2,Saint-Brieuc,2017,75,115106,115181,0.0651149061043054
320.0,FR067L2,Quimper,2017,484,121438,121922,0.396975115237611
321.0,FR068L2,Vannes,2017,785,120249,121034,0.6485780854966373
322.0,FR069L2,Cherbourg,2017,512,90206,90718,0.5643863400868625
323.0,FR073L2,Tarbes,2017,57,104272,104329,0.05463485703879075
324.0,FR074L2,CompiÃ¨gne,2017,65,98672,98737,0.06583145122902255
325.0,FR076L2,Belfort,2017,12,65607,65619,0.018287386275316602
326.0,FR077L2,Roanne,2017,115,123085,123200,0.09334415584415584
327.0,FR079L2,Saint-Quentin,2017,19,99355,99374,0.01911968925473464
328.0,FR082L2,Beauvais,2017,18,131124,131142,0.013725579905751017
329.0,FR084L2,Creil,2017,132,29511,29643,0.4452990587997166
330.0,FR086L2,Evreux,2017,10,126560,126570,0.00790076637433831
331.0,FR090L2,ChÃ¢teauroux,2017,137,261040,261177,0.052454848627559086
332.0,FR093L2,Brive-la-Gaillarde,2017,0,132582,132582,0.0
333.0,FR096L2,Albi,2017,48,134190,134238,0.03575738613507353
334.0,FR099L2,FrÃ©jus,2017,422,43991,44413,0.9501722468646566
335.0,FR104L2,ChÃ¢lons-en-Champagne,2017,30,152779,152809,0.019632351497621214
336.0,FR203L2,Marseille,2017,2942,422834,425776,0.6909736575100522
337.0,FR205L2,Nice,2017,813,306527,307340,0.26452788442766967
338.0,FR207L2,Lens - LiÃ©vin,2017,17,25291,25308,0.06717243559348822
339.0,FR208L1,HÃ©nin - Carvin,2017,6,11592,11598,0.05173305742369374
340.0,FR209L2,Douai,2017,114,44970,45084,0.25286132552568535
341.0,FR214L1,Valence,2017,324,90637,90961,0.35619661173469946
342.0,FR215L2,Rouen,2017,1160,285966,287126,0.4040038171395137
343.0,FR304L1,Melun,2017,35,44801,44836,0.07806227138906235
344.0,FR324L1,Martigues,2017,1729,18727,20456,8.452287837309347
345.0,FR505L1,Charleville-MÃ©ziÃ¨res,2017,0,135369,135369,0.0
346.0,FR506L1,Colmar,2017,18,101967,101985,0.01764965436093543
347.0,FR519L1,Cannes,2017,494,19642,20136,2.4533174413984904
348.0,HR001L2,Grad Zagreb,2017,282,505586,505868,0.05574576767061764
349.0,HR002L2,Rijeka,2017,605,106629,107234,0.5641867318201317
350.0,HR003L2,Slavonski Brod,2017,318,97512,97830,0.3250536645200858
351.0,HR004L2,Osijek,2017,1262,171672,172934,0.7297581736384979
352.0,HR005L2,Split,2017,3318,335752,339070,0.9785589996165984
353.0,HR006L1,Pula - Pola,2017,1307,57590,58897,2.2191283087423805
354.0,HR007L1,Zadar,2017,2478,154022,156500,1.5833865814696486
355.0,HU001L2,Budapest,2017,5632,633502,639134,0.8811923634167483
356.0,HU002L2,Miskolc,2017,66,164603,164669,0.04008040371897564
357.0,HU003L2,NyÃ­regyhÃ¡za,2017,147,168078,168225,0.08738296923762817
358.0,HU004L2,PÃ©cs,2017,40,185448,185488,0.02156473734149918
359.0,HU005L2,Debrecen,2017,288,201290,201578,0.14287273412773221
360.0,HU006L2,Szeged,2017,750,160183,160933,0.46603244828593265
361.0,HU007L2,GyÃµr,2017,502,204138,204640,0.2453088350273651
362.0,HU008L2,KecskemÃ©t,2017,62,182077,182139,0.03403993653198931
363.0,HU009L2,SzÃ©kesfehÃ©rvÃ¡r,2017,1386,299737,301123,0.46027702965233475
364.0,HU010L1,Szombathely,2017,12,134265,134277,0.008936750150807658
365.0,HU011L1,Szolnok,2017,707,143268,143975,0.49105747525612087
366.0,HU012L1,TatabÃ¡nya,2017,110,69720,69830,0.15752541887440927
367.0,HU013L1,VeszprÃ©m,2017,7141,124179,131320,5.437861711848919
368.0,HU014L1,BÃ©kÃ©scsaba,2017,85,106078,106163,0.08006555956406658
369.0,HU015L1,KaposvÃ¡r,2017,3,145557,145560,0.0020610057708161586
370.0,HU016L1,Eger,2017,59,100519,100578,0.058660939768140144
371.0,HU017L1,DunaÃºjvÃ¡ros,2017,744,60926,61670,1.2064212745257015
372.0,HU018L1,Zalaegerszeg,2017,245,139734,139979,0.1750262539380907
373.0,HU019L1,Sopron,2017,528,80142,80670,0.6545184083302343
374.0,IE001L1,Dublin,2017,7640,695962,703602,1.0858411431462673
375.0,IE002L1,Cork,2017,2755,326908,329663,0.8357019137725497
376.0,IE003L1,Limerick,2017,48,156410,156458,0.030679159902338004
377.0,IE004L1,Galway,2017,6056,220227,226283,2.6762947282827256
378.0,IE005L1,Waterford,2017,943,94914,95857,0.9837570547795154
379.0,IS001L1,ReykjavÃ­k,2017,179743,1117487,1297230,13.855908358579436
380.0,IT001L3,Roma,2017,8921,608295,617216,1.445361105350477
381.0,IT002L3,Milano,2017,152,383893,384045,0.039578695204989
382.0,IT003L3,Napoli,2017,2963,149979,152942,1.9373357220384197
383.0,IT004L2,Torino,2017,57,170122,170179,0.03349414440089553
384.0,IT005L3,Palermo,2017,1460,148613,150073,0.972859874860901
385.0,IT006L3,Genova,2017,666,120098,120764,0.5514888542943261
386.0,IT007L3,Firenze,2017,97,163674,163771,0.05922904543539454
387.0,IT008L3,Bari,2017,676,112753,113429,0.5959675215332939
388.0,IT009L1,Bologna,2017,45,185212,185257,0.024290580113032166
389.0,IT010L2,Catania,2017,433,60992,61425,0.7049247049247049
390.0,IT011L2,Venezia,2017,1801,65236,67037,2.6865760699315304
391.0,IT012L3,Verona,2017,56,73105,73161,0.07654351362064488
392.0,IT013L3,Cremona,2017,303,60094,60397,0.5016805470470388
393.0,IT014L3,Trento,2017,681,97506,98187,0.6935745057899722
394.0,IT015L1,Trieste,2017,394,21243,21637,1.820954845865878
395.0,IT016L3,Perugia,2017,5853,125175,131028,4.466984156058247
396.0,IT017L3,Ancona,2017,503,43740,44243,1.1369030129059965
397.0,IT019L2,Pescara,2017,256,16187,16443,1.5568935109164994
398.0,IT020L3,Campobasso,2017,397,102438,102835,0.3860553313560558
399.0,IT021L2,Caserta,2017,1,9341,9342,0.010704345964461572
400.0,IT022L2,Taranto,2017,3474,103454,106928,3.248915157863235
401.0,IT023L2,Potenza,2017,107,138348,138455,0.07728142717850565
402.0,IT024L3,Catanzaro,2017,273,89810,90083,0.3030538503380216
403.0,IT025L3,Reggio di Calabria,2017,570,47678,48248,1.181396120046427
404.0,IT026L3,Sassari,2017,2225,151000,153225,1.4521129058573992
405.0,IT027L2,Cagliari,2017,4945,190347,195292,2.5321057698216003
406.0,IT028L3,Padova,2017,9,61436,61445,0.014647245504109365
407.0,IT029L3,Brescia,2017,116,60153,60269,0.1924704242645473
408.0,IT030L3,Modena,2017,134,69134,69268,0.19345152162614773
409.0,IT031L3,Foggia,2017,4,89707,89711,0.004458762024723836
410.0,IT032L3,Salerno,2017,328,37511,37839,0.8668305187769234
411.0,IT033L2,Piacenza,2017,194,93933,94127,0.20610451836348764
412.0,IT034L1,Bolzano,2017,930,105826,106756,0.8711454157143392
413.0,IT035L2,Udine,2017,0,71830,71830,0.0
414.0,IT036L2,La Spezia,2017,682,42237,42919,1.589039819194296
415.0,IT037L1,Lecce,2017,324,61186,61510,0.5267436189237523
416.0,IT038L1,Barletta,2017,230,14867,15097,1.5234814863880242
417.0,IT039L2,Pesaro,2017,141,25550,25691,0.5488303296874392
418.0,IT040L2,Como,2017,574,19167,19741,2.9076541208652045
419.0,IT041L2,Pisa,2017,478,47575,48053,0.9947349801261107
420.0,IT042L1,Treviso,2017,57,23988,24045,0.23705552089831566
421.0,IT043L2,Varese,2017,695,22969,23664,2.936950642325896
422.0,IT045L2,Asti,2017,29,54807,54836,0.05288496608067693
423.0,IT046L2,Pavia,2017,7,36197,36204,0.019334880123743233
424.0,IT047L1,Massa,2017,187,11056,11243,1.6632571377746153
425.0,IT048L2,Cosenza,2017,327,92152,92479,0.3535937888601737
426.0,IT052L1,Savona,2017,187,28518,28705,0.6514544504441735
427.0,IT054L1,Matera,2017,585,77204,77789,0.7520343493295967
428.0,IT056L1,Acireale,2017,52,5936,5988,0.8684034736138945
429.0,IT057L2,Avellino,2017,0,39759,39759,0.0
430.0,IT058L2,Pordenone,2017,11,37039,37050,0.02968960863697706
431.0,IT060L1,Lecco,2017,1225,28987,30212,4.054680259499537
432.0,IT061L0,Altamura,2017,0,42800,42800,0.0
433.0,IT064L1,Battipaglia,2017,53,6433,6486,0.8171446191797719
434.0,IT065L0,Bisceglie,2017,80,6864,6944,1.1520737327188941
435.0,IT066L1,Carpi,2017,10,20612,20622,0.048491901852390655
436.0,IT067L0,Cerignola,2017,127,58770,58897,0.21563067728407218
437.0,IT068L1,Gallarate,2017,0,5319,5319,0.0
438.0,IT069L1,Gela,2017,408,57487,57895,0.704724069436048
439.0,IT073L1,Sassuolo,2017,2,24060,24062,0.00831186102568365
440.0,IT501L2,Messina,2017,749,33694,34443,2.174607322242546
441.0,IT502L2,Prato,2017,4,40955,40959,0.00976586342440001
442.0,IT503L3,Parma,2017,125,113382,113507,0.11012536671747117
443.0,IT504L3,Livorno,2017,311,25503,25814,1.2047726040133262
444.0,IT505L3,Reggio nell'Emilia,2017,1,69033,69034,0.0014485615783526957
445.0,IT506L2,Ravenna,2017,3563,77626,81189,4.388525539174026
446.0,IT507L2,Ferrara,2017,632,90851,91483,0.6908387350655313
447.0,IT508L3,Rimini,2017,284,32295,32579,0.8717271862242548
448.0,IT509L3,Siracusa,2017,546,33596,34142,1.5992033272801829
449.0,IT511L2,Bergamo,2017,0,18556,18556,0.0
450.0,IT512L3,ForlÃ¬,2017,1,72750,72751,0.0013745515525559787
451.0,IT513L3,Latina,2017,528,65965,66493,0.7940685485690223
452.0,IT514L2,Vicenza,2017,1,34981,34982,0.0028586130009719286
453.0,IT515L2,Terni,2017,128,102204,102332,0.1250830629715045
454.0,IT516L2,Novara,2017,3,54162,54165,0.005538631957906397
455.0,IT518L1,Alessandria,2017,77,76837,76914,0.10011181319395689
456.0,IT519L1,Arezzo,2017,6,88621,88627,0.006769945953264806
457.0,IT520L1,Grosseto,2017,406,119193,119599,0.3394677213020176
458.0,IT521L1,Brindisi,2017,809,63178,63987,1.2643193148608312
459.0,IT522L1,Trapani,2017,893,49897,50790,1.7582201220712739
460.0,IT523L1,Ragusa,2017,259,52591,52850,0.490066225165563
461.0,IT524L0,Andria,2017,0,39880,39880,0.0
462.0,IT525L0,Trani,2017,103,10276,10379,0.9923884767318625
463.0,IT526L1,L'Aquila,2017,322,139947,140269,0.22955891893433333
464.0,LT001L1,Vilnius,2017,3427,421142,424569,0.8071715080469841
465.0,LT002L1,Kaunas,2017,1624,160427,162051,1.0021536429889355
466.0,LT003L1,PanevÄÅ¾ys,2017,213,222595,222808,0.09559800366234605
467.0,LT004L0,Alytus,2017,0,3959,3959,0.0
468.0,LT501L0,KlaipÄda,2017,106,8817,8923,1.187941275355822
469.0,LT502L0,Å iauliai,2017,703,7342,8045,8.738346799254195
470.0,LU001L1,Luxembourg,2017,55,259660,259715,0.021177059469033362
471.0,LV001L1,RÄ«ga,2017,9172,607077,616249,1.4883594131592912
472.0,LV002L2,LiepÄja,2017,3473,268584,272057,1.2765707186361681
473.0,LV003L1,Jelgava,2017,282,166177,166459,0.16941108621342194
474.0,LV501L1,Daugavpils,2017,3659,256016,259675,1.4090690285934342
475.0,ME001L1,Podgorica,2017,1706,182775,184481,0.9247564789869959
476.0,MK001L1,Skopje,2017,21,224332,224353,0.009360249250065745
477.0,MK003L1,Bitola,2017,165,119497,119662,0.1378883856194949
478.0,MK004L1,Tetovo,2017,2,105619,105621,0.0018935628331487107
479.0,MK005L1,Prilep,2017,69,86762,86831,0.07946470730499476
480.0,MT001L1,Valletta,2017,995,24961,25956,3.8334103868084455
481.0,NL001L3,s' Gravenhage,2017,2111,40596,42707,4.942983585829021
482.0,NL002L3,Amsterdam,2017,59737,273220,332957,17.941355790687684
483.0,NL003L3,Rotterdam,2017,28888,188283,217171,13.30196020647324
484.0,NL004L3,Utrecht,2017,625,96662,97287,0.6424291015243557
485.0,NL005L3,Eindhoven,2017,52,144354,144406,0.03600958408930377
486.0,NL006L3,Tilburg,2017,20,43214,43234,0.04625988805107092
487.0,NL007L3,Groningen,2017,1811,206349,208160,0.8700038431975403
488.0,NL008L3,Enschede,2017,79,84877,84956,0.09298931211450634
489.0,NL009L3,Arnhem,2017,914,54984,55898,1.6351211134566532
490.0,NL010L3,Heerlen,2017,20,33323,33343,0.05998260504453709
491.0,NL012L3,Breda,2017,1794,71576,73370,2.445141065830721
492.0,NL013L3,Nijmegen,2017,941,38895,39836,2.3621849583291494
493.0,NL014L3,Apeldoorn,2017,19,71105,71124,0.026713908104156123
494.0,NL015L3,Leeuwarden,2017,437,110486,110923,0.39396698610748
495.0,NL016L3,Sittard-Geleen,2017,49,22863,22912,0.2138617318435754
496.0,NL020L3,Roosendaal,2017,2,24572,24574,0.008138683161064541
497.0,NL026L0,Alphen aan den Rijn,2017,31,13179,13210,0.23467070401211204
498.0,NL028L3,Bergen op Zoom,2017,1983,32798,34781,5.701388689226876
499.0,NL030L0,Gouda,2017,0,1788,1788,0.0
500.0,NL032L3,MiddelburgÂ Â Â Â Â Â ,2017,1148,22240,23388,4.908500085513938
501.0,NL503L3,s-Hertogenbosch,2017,162,36697,36859,0.4395127377302694
502.0,NL504L3,Amersfoort,2017,15,12229,12244,0.12250898399215943
503.0,NL505L3,Maastricht,2017,187,20198,20385,0.9173411822418445
504.0,NL507L3,Leiden,2017,262,19519,19781,1.3245033112582782
505.0,NL511L3,Zwolle,2017,644,122376,123020,0.5234921151032352
506.0,NL512L3,Ede,2017,52,35213,35265,0.1474549836948816
507.0,NL513L3,Deventer,2017,65,25180,25245,0.25747672806496336
508.0,NL514L3,Alkmaar,2017,87,47705,47792,0.1820388349514563
509.0,NL515L3,Venlo,2017,180,51056,51236,0.35131548130220935
510.0,NL519L3,Almelo,2017,7,42018,42025,0.01665675193337299
511.0,NL520L3,Lelystad,2017,51910,66932,118842,43.67984382625671
512.0,NL521L3,Oss,2017,64,33082,33146,0.19308513847824776
513.0,NL522L3,Assen,2017,29,70833,70862,0.04092461403855381
514.0,NL524L3,Veenendaal,2017,35,8150,8185,0.42761148442272445
515.0,NL529L3,Soest,2017,9,7933,7942,0.11332158146562579
516.0,NO001L1,Oslo,2017,25935,720708,746643,3.473547599053363
517.0,NO002L1,Bergen,2017,17916,339827,357743,5.00806444850074
518.0,NO003L1,Trondheim,2017,16973,656283,673256,2.5210321185403473
519.0,NO004L1,Stavanger,2017,15273,273804,289077,5.283367407299785
520.0,NO005L1,Kristiansand,2017,5433,310029,315462,1.7222359586891607
521.0,NO006L1,TromsÃ¸,2017,53896,320717,374613,14.387114168488546
522.0,PL001L2,Warszawa,2017,2707,858536,861243,0.31431314971500496
523.0,PL002L2,ÅÃ³dÅº,2017,1055,168445,169500,0.6224188790560472
524.0,PL003L2,KrakÃ³w,2017,585,375163,375748,0.1556894514408593
525.0,PL004L2,WrocÅaw,2017,665,264035,264700,0.2512278050623347
526.0,PL005L2,PoznaÅ,2017,436,308892,309328,0.140950706046656
527.0,PL006L2,GdaÅsk,2017,2285,261231,263516,0.8671200230726027
528.0,PL007L2,Szczecin,2017,639,112421,113060,0.5651866265699629
529.0,PL008L2,Bydgoszcz,2017,1301,208835,210136,0.6191228537708913
530.0,PL009L2,Lublin,2017,158,322626,322784,0.04894914246059284
531.0,PL010L2,Katowice,2017,2156,392439,394595,0.546383000291438
532.0,PL011L2,BiaÅystok,2017,48,223274,223322,0.021493628034855498
533.0,PL012L2,Kielce,2017,83,224146,224229,0.03701572945515522
534.0,PL013L2,ToruÅ,2017,767,158166,158933,0.48259329402955964
535.0,PL014L2,Olsztyn,2017,3318,199226,202544,1.638162572083103
536.0,PL015L2,RzeszÃ³w,2017,108,229241,229349,0.04708980636497216
537.0,PL016L2,Opole,2017,129,176487,176616,0.07303981519228156
538.0,PL017L2,GorzÃ³w Wielkopolski,2017,17,97403,97420,0.01745021556148635
539.0,PL018L2,Zielona GÃ³ra,2017,48,169236,169284,0.028354717516126747
540.0,PL019L2,Jelenia GÃ³ra,2017,293,83048,83341,0.3515676557756686
541.0,PL020L2,Nowy SÄcz,2017,189,130229,130418,0.14491864619914427
542.0,PL021L2,SuwaÅki,2017,2483,69650,72133,3.44225250578792
543.0,PL022L2,Konin,2017,1405,116758,118163,1.189035484881054
544.0,PL024L2,CzÄstochowa,2017,15,193883,193898,0.007736026158083116
545.0,PL025L2,Radom,2017,12,68010,68022,0.017641351327511687
546.0,PL026L2,PÅock,2017,2574,168501,171075,1.5046032441911443
547.0,PL027L2,Kalisz,2017,94,148929,149023,0.0630775115250666
548.0,PL028L2,Koszalin,2017,118,129553,129671,0.09099952957870303
549.0,PL029L1,SÅupsk,2017,6771,228233,235004,2.8812275535735563
550.0,PL030L1,JastrzÄbie-ZdrÃ³j,2017,8,29563,29571,0.02705353217679483
551.0,PL031L1,Siedlce,2017,27,126142,126169,0.021399868430438538
552.0,PL032L1,PiotrkÃ³w Trybunalski,2017,20,116902,116922,0.017105420707822307
553.0,PL033L1,Lubin,2017,143,93163,93306,0.15325916875656442
554.0,PL034L1,PiÅa,2017,69,52123,52192,0.1322041692213366
555.0,PL035L1,InowrocÅaw,2017,56,20072,20128,0.27821939586645467
556.0,PL036L1,Ostrowiec ÅwiÄtokrzyski,2017,1,61459,61460,0.0016270745200130164
557.0,PL037L1,Gniezno,2017,181,66390,66571,0.27189016238301966
558.0,PL038L1,Stargard SzczeciÅski,2017,200,36464,36664,0.5454942177612917
559.0,PL039L1,OstrÃ³w Wielkopolski,2017,47,84714,84761,0.0554500300845908
560.0,PL040L1,PrzemyÅl,2017,542,84547,85089,0.6369801031860758
561.0,PL041L1,ZamoÅÄ,2017,215,112492,112707,0.19076011250410355
562.0,PL042L1,CheÅm,2017,83,46487,46570,0.17822632596091906
563.0,PL043L1,Pabianice,2017,2,32957,32959,0.006068145271397797
564.0,PL044L1,GÅogÃ³w,2017,31,64050,64081,0.04837627377849909
565.0,PL045L1,Stalowa Wola,2017,245,190068,190313,0.12873529396310288
566.0,PL046L1,TomaszÃ³w Mazowiecki,2017,423,18740,19163,2.2073788029014247
567.0,PL047L1,ÅomÅ¼a,2017,0,56002,56002,0.0
568.0,PL048L1,Leszno,2017,32,77540,77572,0.04125199814366008
569.0,PL049L1,Åwidnica,2017,18,47972,47990,0.03750781412794332
570.0,PL051L1,Tczew,2017,89,27035,27124,0.3281226957675859
571.0,PL052L1,EÅk,2017,1210,38842,40052,3.0210726056127033
572.0,PL506L2,Bielsko-BiaÅa,2017,94,73341,73435,0.12800435759515216
573.0,PL508L1,Rybnik,2017,427,14454,14881,2.869430817821383
574.0,PL511L2,WaÅbrzych,2017,0,51510,51510,0.0
575.0,PL512L2,ElblÄg,2017,47,96428,96475,0.048717284270536405
576.0,PL513L2,WÅocÅawek,2017,1821,120658,122479,1.4867854897574277
577.0,PL514L2,TarnÃ³w,2017,141,125186,125327,0.11250568512770592
578.0,PL516L2,Legnica,2017,115,56385,56500,0.20353982300884954
579.0,PL517L2,GrudziÄdz,2017,742,54301,55043,1.3480369892629398
580.0,PT001L3,Lisboa,2017,7555,431726,439281,1.7198558553636512
581.0,PT002L2,Porto,2017,1060,94680,95740,1.1071652391894715
582.0,PT003L1,Braga,2017,45,49304,49349,0.0911872581004681
583.0,PT004L2,Funchal,2017,1056,34906,35962,2.936432901395918
584.0,PT005L2,Coimbra,2017,437,162350,162787,0.26844895476911546
585.0,PT007L1,Ponta Delgada,2017,1330,53964,55294,2.4053242666473755
586.0,PT008L2,Aveiro,2017,1864,41466,43330,4.301869374567274
587.0,PT009L1,Faro,2017,2505,46645,49150,5.096642929806714
588.0,PT014L1,Viseu,2017,5,70869,70874,0.007054773259587437
589.0,PT016L0,Viana do Castelo,2017,389,31863,32252,1.206126751829344
590.0,PT019L0,PÃ³voa de Varzim,2017,22,8384,8406,0.26171782060433024
591.0,PT505L1,GuimarÃ£es,2017,0,26541,26541,0.0
592.0,RO001L1,BucureÅti,2017,441,107401,107842,0.40893158509671557
593.0,RO002L1,Cluj-Napoca,2017,0,59302,59302,0.0
594.0,RO003L1,TimiÅoara,2017,3,23651,23654,0.01268284433922381
595.0,RO004L1,Craiova,2017,3,34393,34396,0.008721944412140947
596.0,RO005L1,BrÄila,2017,1185,22344,23529,5.0363381359173784
597.0,RO006L1,Oradea,2017,49,20290,20339,0.24091646590294508
598.0,RO007L1,BacÄu,2017,65,22028,22093,0.29421083601140635
599.0,RO008L1,Arad,2017,186,51422,51608,0.3604092388776934
600.0,RO009L1,Sibiu,2017,702,55638,56340,1.2460063897763578
601.0,RO010L1,TÃ¢rgu MureÅ,2017,16,13724,13740,0.11644832605531297
602.0,RO011L1,Piatra NeamÅ£,2017,88,14911,14999,0.586705780385359
603.0,RO012L1,CÇlÇraÅi,2017,449,24095,24544,1.829367666232073
604.0,RO013L1,Giurgiu,2017,540,10410,10950,4.931506849315069
605.0,RO014L1,Alba Iulia,2017,0,26002,26002,0.0
606.0,RO015L1,FocÅani,2017,3,27099,27102,0.011069293779056896
607.0,RO016L1,TÃ¢rgu Jiu,2017,10,24512,24522,0.0407797080172906
608.0,RO017L1,Tulcea,2017,1574,39373,40947,3.8439934549539654
609.0,RO018L1,TÃ¢rgoviÅte,2017,3,20254,20257,0.014809695413930986
610.0,RO019L1,Slatina,2017,103,7020,7123,1.446019935420469
611.0,RO020L1,BÃ¢rlad,2017,42,26277,26319,0.15958053117519663
612.0,RO021L1,Roman,2017,6,14384,14390,0.04169562195969423
613.0,RO022L1,BistriÅ£a,2017,0,42631,42631,0.0
614.0,RO501L1,Constanta,2017,4579,54772,59351,7.7151185321224585
615.0,RO502L1,Iasi,2017,167,79769,79936,0.20891713370696555
616.0,RO503L1,Galati,2017,2684,38548,41232,6.509507178890182
617.0,RO504L1,Brasov,2017,103,98400,98503,0.10456534318751713
618.0,RO505L1,Ploiesti,2017,21,34316,34337,0.06115851705157701
619.0,RO506L1,Pitesti,2017,91,24793,24884,0.36569683330654235
620.0,RO507L1,Baia Mare,2017,104,52437,52541,0.19794065586875012
621.0,RO508L1,Buzau,2017,15,38525,38540,0.038920601971977165
622.0,RO509L1,Satu Mare,2017,4,70840,70844,0.005646208570944611
623.0,RO510L1,Botosani,2017,121,37219,37340,0.32404927691483665
624.0,RO511L1,Ramnicu Valcea,2017,626,28547,29173,2.1458197648510606
625.0,RO512L1,Suceava,2017,21,39657,39678,0.05292605474066233
626.0,RO513L1,Drobeta-Turnu Severin,2017,2079,30855,32934,6.312625250501001
627.0,RS001L1,Beograd,2017,6382,306642,313024,2.0388213044367207
628.0,RS002L1,Novi Sad,2017,2229,187214,189443,1.1766072116678894
629.0,RS003L1,NiÅ¡,2017,5,341559,341564,0.0014638545045730813
630.0,RS004L1,Kragujevac,2017,544,143531,144075,0.3775811209439528
631.0,RS005L1,Subotica,2017,134,160158,160292,0.08359743468170588
632.0,RS006L1,Novi Pazar,2017,40,140751,140791,0.028410906947177017
633.0,RS008L1,Zrenjanin,2017,991,184140,185131,0.5352966277932923
634.0,RS009L1,Kraljevo,2017,22,176490,176512,0.012463741841914431
635.0,RS011L0,ÄaÄak,2017,23,63664,63687,0.03611412062116288
636.0,RS012L1,KruÅ¡evac,2017,14,122635,122649,0.01141468744139781
637.0,RS013L1,Leskovac,2017,47,166235,166282,0.02826523616506898
638.0,RS014L1,Valjevo,2017,0,141662,141662,0.0
639.0,RS015L1,Vranje,2017,11,195345,195356,0.005630745920268638
640.0,RS016L1,Smederevo,2017,2923,157301,160224,1.8243209506690634
641.0,SE001L1,Stockholm,2017,60121,695605,755726,7.955396532605732
642.0,SE002L1,GÃ¶teborg,2017,22092,413167,435259,5.075598666541071
643.0,SE003L1,MalmÃ¶,2017,2824,185192,188016,1.501999829801719
644.0,SE004L1,JÃ¶nkÃ¶ping,2017,55738,291453,347191,16.053987574562704
645.0,SE005L1,UmeÃ¥,2017,27736,960513,988249,2.8065801230256744
646.0,SE006L1,Uppsala,2017,13129,684398,697527,1.8822210466404885
647.0,SE007L1,LinkÃ¶ping,2017,15090,408106,423196,3.5657236835886916
648.0,SE008L1,Ãrebro,2017,23880,344717,368597,6.478620281771148
649.0,SE501L1,VÃ¤sterÃ¥s,2017,19047,271368,290415,6.558545529673054
650.0,SE502L1,NorrkÃ¶ping,2017,12331,299407,311738,3.9555652503063468
651.0,SE503L1,Helsingborg,2017,1637,112785,114422,1.4306689273041897
652.0,SE505L1,BorÃ¥s,2017,2791,94571,97362,2.866621474497237
653.0,SI001L2,Ljubljana,2017,442,232845,233287,0.18946619400138026
654.0,SI002L1,Maribor,2017,703,216282,216985,0.3239855289536143
655.0,SK001L1,Bratislava,2017,1789,203152,204941,0.8729341615391746
656.0,SK002L1,KoÅ¡ice,2017,136,177498,177634,0.07656191945235709
657.0,SK003L1,BanskÃ¡ Bystrica,2017,0,80880,80880,0.0
658.0,SK004L1,Nitra,2017,0,87127,87127,0.0
659.0,SK005L1,PreÅ¡ov,2017,25,93274,93299,0.026795571227987435
660.0,SK006L1,Å½ilina,2017,65,81383,81448,0.07980552008643552
661.0,SK007L1,Trnava,2017,52,74168,74220,0.07006197790353004
662.0,SK008L1,TrenÄÃ­n,2017,10,67413,67423,0.01483173397801937
739.0,UK001L3,London,2017,813,697357,698170,0.11644728361287365
740.0,UK002L3,West Midlands urban area,2017,233,215076,215309,0.1082165631719993
741.0,UK003L2,Leeds,2017,9784,502643,512427,1.909345135990102
742.0,UK004L1,Glasgow,2017,2806,334878,337684,0.8309543833880195
743.0,UK006L3,Liverpool,2017,519,99984,100503,0.5164024954478971
744.0,UK007L1,Edinburgh,2017,1216,174202,175418,0.6932013818422283
745.0,UK008L3,Greater Manchester,2017,1776,310470,312246,0.5687823062585269
746.0,UK009L1,Cardiff,2017,150,84341,84491,0.17753370181439443
747.0,UK010L3,Sheffield,2017,1382,124705,126087,1.096068587562556
748.0,UK011L2,Bristol,2017,264,98121,98385,0.26833358743710933
749.0,UK012L2,Belfast,2017,24161,170984,195145,12.381049988470112
750.0,UK013L2,Newcastle upon Tyne,2017,2298,544410,546708,0.4203340723018503
751.0,UK014L1,Leicester,2017,96,139685,139781,0.06867886193402536
752.0,UK016L1,Aberdeen,2017,2498,651450,653948,0.38198755864380657
753.0,UK017L2,Cambridge,2017,21,159598,159619,0.013156328507257908
754.0,UK018L3,Exeter,2017,1285,246441,247726,0.5187182613048287
755.0,UK019L3,Lincoln,2017,200,211343,211543,0.0945434261592206
756.0,UK023L1,Portsmouth,2017,296,20557,20853,1.419460029731933
757.0,UK024L1,Worcester,2017,15,61187,61202,0.024509002973759027
758.0,UK025L3,Coventry,2017,78,81369,81447,0.09576779991896571
759.0,UK026L1,Kingston upon Hull,2017,1809,249889,251698,0.7187184641912133
760.0,UK027L1,Stoke-on-Trent,2017,112,88064,88176,0.1270186898929414
761.0,UK029L1,Nottingham,2017,129,90160,90289,0.14287454728704493
762.0,UK033L1,Guildford,2017,4,61687,61691,0.006483927963560326
763.0,UK050L1,Burnley,2017,88,27886,27974,0.3145778222635304
764.0,UK056L1,Hastings,2017,37,54713,54750,0.06757990867579909
765.0,UK515L1,Brighton and Hove,2017,311,42096,42407,0.7333694908859386
766.0,UK516L1,Plymouth,2017,797,214978,215775,0.3693662379793767
767.0,UK517L1,Swansea,2017,369,83673,84042,0.43906618119511676
768.0,UK518L1,Derby,2017,206,67896,68102,0.3024874453026343
769.0,UK520L2,Southampton,2017,1020,152332,153352,0.6651364181751787
770.0,UK528L1,Northampton,2017,7408,147137,154545,4.793425863017244
771.0,UK539L1,Bournemouth,2017,1020,92773,93793,1.0875011994498525
772.0,UK546L1,Colchester,2017,845,68650,69495,1.2159148140153968
773.0,UK550L0,Dundee City,2017,509,225907,226416,0.2248074341035969
774.0,UK551L1,Falkirk,2017,84,29705,29789,0.2819832824196851
775.0,UK552L0,Reading,2017,18,21903,21921,0.08211304228821678
776.0,UK553L1,Blackpool,2017,57,48898,48955,0.11643345929935654
777.0,UK557L1,Blackburn with Darwen,2017,216,79338,79554,0.2715136888151444
778.0,UK558L1,Newport,2017,104,31596,31700,0.3280757097791798
779.0,UK559L2,Middlesbrough,2017,1623,60146,61769,2.627531609707135
780.0,UK560L1,Oxford,2017,245,192678,192923,0.12699367105010806
781.0,UK562L2,Preston,2017,51,25711,25762,0.1979659964288487
782.0,UK566L1,Norwich,2017,1,150239,150240,0.0006656017039403621
783.0,UK568L1,Cheshire West and Chester,2017,386,135759,136145,0.28352124573065485
784.0,UK569L2,Ipswich,2017,1552,154094,155646,0.9971345232129318
785.0,UK571L1,Cheltenham,2017,13,46170,46183,0.028148885953705908
786.0,XK001L1,Pristina,2017,179,255628,255807,0.06997462931037852
787.0,XK002L1,Prizren,2017,11,127622,127633,0.008618460742911317
788.0,XK003L1,MitrovicÃ«,2017,2,117912,117914,0.0016961514323998845
1.0,AL001L1,Tirana,2018,1562,165559,167121,0.9346521382710731
2.0,AL003L1,Elbasan,2018,608,125396,126004,0.48252436430589507
3.0,AL004L1,ShkodÃ«r,2018,6858,178471,185329,3.7004462334550987
4.0,AL005L0,VlorÃ«,2018,2276,61457,63733,3.571148384667284
5.0,AT001L3,Wien,2018,3079,915411,918490,0.3352241178455944
6.0,AT002L3,Graz,2018,108,291024,291132,0.03709657474959812
7.0,AT003L3,Linz,2018,2387,356843,359230,0.6644767975948557
8.0,AT004L3,Salzburg,2018,1795,135681,137476,1.3056824463906427
9.0,AT005L3,Innsbruck,2018,15639,197183,212822,7.348394432906373
10.0,AT006L2,Klagenfurt,2018,2253,181007,183260,1.2294008512495906
11.0,BA001L1,Sarajevo,2018,1,263773,263774,0.00037911242199761917
12.0,BA002L1,Banja Luka,2018,79,275223,275302,0.028695759565858583
13.0,BA003L1,Mostar,2018,1425,180922,182347,0.7814770739304733
14.0,BA004L1,Tuzla,2018,591,111670,112261,0.5264517508306535
15.0,BA005L1,Zenica,2018,7,86709,86716,0.008072328059412335
16.0,BE001L2,Bruxelles / Brussel,2018,45,326606,326651,0.013776170897992048
17.0,BE002L2,Antwerpen,2018,4410,114802,119212,3.6992920175821222
18.0,BE003L2,Gent,2018,108,101733,101841,0.10604766253277167
19.0,BE004L2,Charleroi,2018,17,109748,109765,0.015487632669794561
20.0,BE005L2,LiÃ¨ge,2018,205,141193,141398,0.1449808342409369
21.0,BE006L2,Brugge,2018,796,55743,56539,1.4078777481030793
22.0,BE007L2,Namur,2018,35,84072,84107,0.04161365879177714
23.0,BE008L1,Leuven,2018,2,45074,45076,0.004436950927322744
24.0,BE009L1,Mons,2018,34,39166,39200,0.08673469387755102
25.0,BE010L1,Kortrijk,2018,16,22323,22339,0.07162361788799856
26.0,BE011L1,Oostende,2018,146,20786,20932,0.6974966558379514
27.0,BG001L2,Sofia,2018,2571,569203,571774,0.4496531846498792
28.0,BG002L2,Plovdiv,2018,256,276830,277086,0.09239008827584215
29.0,BG003L2,Varna,2018,3678,201120,204798,1.7959159757419505
30.0,BG004L2,Burgas,2018,5180,290720,295900,1.750591416018925
31.0,BG005L1,Pleven,2018,1041,178035,179076,0.581317429471286
32.0,BG006L2,Ruse,2018,2457,131560,134017,1.8333495004365117
33.0,BG007L2,Vidin,2018,1744,59220,60964,2.8607046781707237
34.0,BG008L2,Stara Zagora,2018,16,132052,132068,0.012114971075506558
35.0,BG009L1,Sliven,2018,46,136728,136774,0.033632123064325094
36.0,BG010L1,Dobrich,2018,69,140269,140338,0.04916701107326597
37.0,BG011L1,Shumen,2018,42,94465,94507,0.044441152507221686
38.0,BG013L1,Yambol,2018,474,130332,130806,0.36236869868354665
39.0,BG014L1,Haskovo,2018,438,73530,73968,0.5921479558728099
40.0,BG015L1,Pazardzhik,2018,44,63778,63822,0.06894174422612892
41.0,BG016L1,Blagoevgrad,2018,1,135478,135479,0.000738121775330494
42.0,BG017L1,Veliko Tarnovo,2018,4,88535,88539,0.004517783123821141
43.0,BG018L1,Vratsa,2018,25,70532,70557,0.03543234547954136
44.0,CH001L2,ZÃ¼rich,2018,53,127664,127717,0.04149799948323246
45.0,CH002L2,GenÃ¨ve,2018,103,53794,53897,0.1911052563222443
46.0,CH003L2,Basel,2018,131,69289,69420,0.18870642466148083
47.0,CH004L2,Bern,2018,153,78135,78288,0.1954322501532802
48.0,CH005L2,Lausanne,2018,21,77484,77505,0.027095026127346624
49.0,CH006L1,Winterthur,2018,0,13291,13291,0.0
50.0,CH007L2,St. Gallen,2018,62,31847,31909,0.19430254787050674
51.0,CH008L2,Luzern,2018,3,29256,29259,0.010253255408592229
52.0,CH009L2,Lugano,2018,23,30602,30625,0.07510204081632653
53.0,CH010L1,Biel/Bienne,2018,5,9090,9095,0.054975261132490384
54.0,CY001L2,Lefkosia,2018,30,162598,162628,0.01844700789531938
55.0,CY501L2,Lemesos,2018,957,124942,125899,0.7601331225823874
56.0,CZ001L2,Praha,2018,321,570241,570562,0.05626031877341989
57.0,CZ002L2,Brno,2018,698,267217,267915,0.26053039210197265
58.0,CZ003L2,Ostrava,2018,100,142566,142666,0.07009378548497891
59.0,CZ004L2,PlzeÅ,2018,114,195843,195957,0.058176028414397035
60.0,CZ005L2,ÃstÃ­ nad Labem,2018,9,35902,35911,0.025061958731307957
61.0,CZ006L2,Olomouc,2018,6,93558,93564,0.006412722842118764
62.0,CZ007L2,Liberec,2018,2,61314,61316,0.0032617913758236023
63.0,CZ008L2,ÄeskÃ© BudÄjovice,2018,627,128777,129404,0.48452907174430465
64.0,CZ009L2,Hradec KrÃ¡lovÃ©,2018,55,79450,79505,0.06917803911703667
65.0,CZ010L2,Pardubice,2018,105,86252,86357,0.121588290468636
66.0,CZ011L2,ZlÃ­n,2018,1,57951,57952,0.0017255659856432912
67.0,CZ013L2,Karlovy Vary,2018,63,46921,46984,0.13408820023837903
68.0,CZ014L2,Jihlava,2018,22,96005,96027,0.022910223166401116
69.0,CZ016L2,Most,2018,127,27651,27778,0.45719634242926055
70.0,CZ018L2,Chomutov-Jirkov,2018,19,45667,45686,0.04158823271899487
71.0,DE001L1,Berlin,2018,14305,1733960,1748265,0.818239797742333
72.0,DE002L1,Hamburg,2018,12440,721734,734174,1.6944212134997971
73.0,DE003L1,MÃ¼nchen,2018,9221,540720,549941,1.676725321443573
74.0,DE004L1,KÃ¶ln,2018,971,161659,162630,0.597060812888151
75.0,DE005L1,Frankfurt am Main,2018,1061,429270,430331,0.2465543964994388
76.0,DE007L1,Stuttgart,2018,73,365097,365170,0.019990689268012157
77.0,DE008L2,Leipzig,2018,4428,393261,397689,1.113432858339054
78.0,DE009L2,Dresden,2018,5312,577884,583196,0.9108430098971874
79.0,DE011L1,DÃ¼sseldorf,2018,1041,119276,120317,0.865214391981183
80.0,DE012L1,Bremen,2018,2096,587443,589539,0.35553203435226505
81.0,DE013L1,Hannover,2018,2604,294708,297312,0.8758475944462383
82.0,DE014L1,NÃ¼rnberg,2018,169,293332,293501,0.05758072374540461
83.0,DE017L0,Bielefeld,2018,3,25880,25883,0.011590619325425955
84.0,DE018L1,Halle an der Saale,2018,1480,156106,157586,0.9391697231987612
85.0,DE019L2,Magdeburg,2018,163,416871,417034,0.03908554218600881
86.0,DE020L1,Wiesbaden,2018,374,101064,101438,0.3686981210197362
87.0,DE021L1,GÃ¶ttingen,2018,76,238881,238957,0.031804885397791235
88.0,DE025L1,Darmstadt,2018,87,78100,78187,0.11127169478302021
89.0,DE026L1,Trier,2018,239,120888,121127,0.19731356344993273
90.0,DE027L1,Freiburg im Breisgau,2018,2808,218388,221196,1.2694623772581781
91.0,DE028L1,Regensburg,2018,176,253486,253662,0.0693836680306865
92.0,DE029L0,Frankfurt (Oder),2018,157,14687,14844,1.0576663971975209
93.0,DE030L1,Weimar,2018,8,89020,89028,0.008985937008581569
94.0,DE031L1,Schwerin,2018,3238,486765,490003,0.6608122807411384
95.0,DE032L1,Erfurt,2018,266,285246,285512,0.09316596150074252
96.0,DE033L1,Augsburg,2018,208,199726,199934,0.10403433132933869
97.0,DE034L1,Bonn,2018,549,128788,129337,0.42447250206824033
98.0,DE035L1,Karlsruhe,2018,916,124896,125812,0.7280704543286809
99.0,DE036L0,MÃ¶nchengladbach,2018,1,17022,17023,0.005874405216471833
100.0,DE037L1,Mainz,2018,595,69710,70305,0.8463124955550815
101.0,DE038L1,Ruhrgebiet,2018,3414,440338,443752,0.7693486451892048
102.0,DE039L1,Kiel,2018,6058,333704,339762,1.78301281485275
103.0,DE040L1,SaarbrÃ¼cken,2018,13,153669,153682,0.008459025780507801
104.0,DE042L1,Koblenz,2018,689,91487,92176,0.7474830758548863
105.0,DE043L2,Rostock,2018,2701,359103,361804,0.7465367989298073
106.0,DE044L1,Kaiserslautern,2018,4,135523,135527,0.0029514414101987057
107.0,DE045L1,Iserlohn,2018,113,105994,106107,0.10649627263045794
108.0,DE048L1,Wilhelmshaven,2018,547,73500,74047,0.7387200021607898
109.0,DE050L1,TÃ¼bingen,2018,0,52025,52025,0.0
110.0,DE051L1,Villingen-Schwenningen,2018,2596,99964,102560,2.5312012480499217
111.0,DE052L1,Flensburg,2018,1027,204448,205475,0.49981749604574766
112.0,DE053L1,Marburg,2018,6,126236,126242,0.004752776413554918
113.0,DE054L1,Konstanz,2018,125,81775,81900,0.15262515262515264
114.0,DE055L0,NeumÃ¼nster,2018,1,7175,7176,0.013935340022296544
115.0,DE056L0,Brandenburg an der Havel,2018,1563,21267,22830,6.846254927726675
116.0,DE057L1,GieÃen,2018,46,85482,85528,0.05378355626227668
117.0,DE058L1,LÃ¼neburg,2018,15,132487,132502,0.011320583840243922
118.0,DE059L1,Bayreuth,2018,2,199918,199920,0.0010004001600640256
119.0,DE060L1,Celle,2018,16,155031,155047,0.01031945152115165
120.0,DE061L1,Aschaffenburg,2018,164,147452,147616,0.1110990678517234
121.0,DE062L1,Bamberg,2018,43,122112,122155,0.035201178830174776
122.0,DE063L1,Plauen,2018,362,140926,141288,0.25621425740331805
123.0,DE064L1,Neubrandenburg,2018,20795,563196,583991,3.5608425472310365
124.0,DE065L1,Fulda,2018,1,138224,138225,0.0007234581298607343
125.0,DE066L1,Kempten (AllgÃ¤u),2018,429,158738,159167,0.2695282313544893
126.0,DE067L1,Landshut,2018,74,141379,141453,0.05231419623479177
127.0,DE069L1,Rosenheim,2018,68,147695,147763,0.04601963955794076
128.0,DE071L1,Stralsund,2018,17068,321180,338248,5.046001750195123
129.0,DE072L1,Friedrichshafen,2018,52,66567,66619,0.07805580990408141
130.0,DE073L1,Offenburg,2018,682,185202,185884,0.3668954832045792
131.0,DE074L1,GÃ¶rlitz,2018,2241,208866,211107,1.061546988020293
132.0,DE077L1,Schweinfurt,2018,65,201275,201340,0.03228369921525777
133.0,DE078L1,Greifswald,2018,3480,346314,349794,0.9948712670886293
134.0,DE079L1,Wetzlar,2018,6,106484,106490,0.00563433186214668
135.0,DE081L1,Passau,2018,540,159526,160066,0.3373608386540552
136.0,DE082L0,Dessau-RoÃlau,2018,39,24609,24648,0.15822784810126583
137.0,DE083L1,Braunschweig-Salzgitter-Wolfsburg,2018,191,412653,412844,0.04626444855683987
138.0,DE084L1,Mannheim-Ludwigshafen,2018,1108,203320,204428,0.5420001174007475
139.0,DE504L1,MÃ¼nster,2018,90,141673,141763,0.06348624112074377
140.0,DE505L0,Chemnitz,2018,4,22189,22193,0.01802370116703465
141.0,DE507L1,Aachen,2018,153,70367,70520,0.21695972773681224
142.0,DE508L0,Krefeld,2018,119,13561,13680,0.8698830409356725
143.0,DE510L1,LÃ¼beck,2018,3925,158224,162149,2.420613139766511
144.0,DE513L1,Kassel,2018,71,139790,139861,0.05076468779717005
145.0,DE516L0,Solingen,2018,0,8954,8954,0.0
146.0,DE517L1,OsnabrÃ¼ck,2018,30,224100,224130,0.01338508901084192
147.0,DE520L1,Oldenburg (Oldenburg),2018,154,189815,189969,0.08106585811369224
148.0,DE522L1,Heidelberg,2018,316,116789,117105,0.26984330301865844
149.0,DE523L1,Paderborn,2018,36,124647,124683,0.028873222492240322
150.0,DE524L2,WÃ¼rzburg,2018,216,305713,305929,0.0706046174112294
151.0,DE527L1,Bremerhaven,2018,915,213564,214479,0.42661519309582757
152.0,DE529L1,Heilbronn,2018,19,119965,119984,0.01583544472596346
153.0,DE530L0,Remscheid,2018,6,7363,7369,0.08142217397204506
154.0,DE532L1,Ulm,2018,216,199092,199308,0.10837497742187971
155.0,DE533L1,Pforzheim,2018,10,67138,67148,0.01489247632096265
156.0,DE534L1,Ingolstadt,2018,312,284523,284835,0.10953710042656276
157.0,DE535L1,Gera,2018,121,99665,99786,0.12125949531998476
158.0,DE537L1,Reutlingen,2018,8,109274,109282,0.0073205102395636976
159.0,DE539L1,Cottbus,2018,1126,181154,182280,0.6177309633530832
160.0,DE540L2,Siegen,2018,8,177556,177564,0.004505417764862247
161.0,DE542L1,Hildesheim,2018,21,120789,120810,0.017382666997765087
162.0,DE544L1,Zwickau,2018,84,94720,94804,0.08860385637736805
163.0,DE546L0,Wuppertal,2018,6,16827,16833,0.03564427018356799
164.0,DE547L2,Jena,2018,2,93066,93068,0.002148966347187003
165.0,DE548L1,DÃ¼ren,2018,331,93707,94038,0.35198536761734617
166.0,DE549L1,Bocholt,2018,128,142137,142265,0.08997293782729414
167.0,DK001L2,KÃ¸benhavn,2018,11951,279272,291223,4.103728070928464
168.0,DK002L3,Ãrhus,2018,3365,459159,462524,0.7275298146690766
169.0,DK003L2,Odense,2018,7137,352702,359839,1.9833870147482624
170.0,DK004L3,Aalborg,2018,3531,616928,620459,0.5690948152899709
171.0,EE001L1,Tallinn,2018,4455,434606,439061,1.0146653881806855
172.0,EE002L1,Tartu,2018,353,299289,299642,0.11780724998498208
173.0,EE003L0,Narva,2018,315,6574,6889,4.57250689505008
174.0,EL001L1,Athina,2018,5096,304291,309387,1.6471280305895206
175.0,EL002L1,Thessaloniki,2018,2166,139953,142119,1.524074894982374
176.0,EL003L1,Patra,2018,664,50926,51590,1.2870711378174065
177.0,EL004L1,Irakleio,2018,1083,60301,61384,1.76430340153786
178.0,EL005L1,Larisa,2018,122,155397,155519,0.07844700647509308
179.0,EL006L1,Volos,2018,264,30552,30816,0.8566978193146416
180.0,EL007L1,Ioannina,2018,2007,130634,132641,1.513106807095845
181.0,EL008L1,Kavala,2018,308,35260,35568,0.8659469185784976
182.0,EL009L1,Kalamata,2018,269,44183,44452,0.6051471249887519
183.0,ES001L3,Madrid,2018,2380,785223,787603,0.30218269864385994
184.0,ES002L2,Barcelona,2018,1303,263304,264607,0.49242839380666426
185.0,ES003L3,Valencia,2018,3096,172024,175120,1.767930561900411
186.0,ES004L3,Sevilla,2018,4240,464186,468426,0.9051589792197701
187.0,ES005L2,Zaragoza,2018,199,275939,276138,0.07206541656707878
188.0,ES006L2,MÃ¡laga,2018,915,151827,152742,0.5990493773814668
189.0,ES007L2,Murcia,2018,88,120048,120136,0.07325031630818406
190.0,ES008L2,Las Palmas,2018,762,75834,76596,0.9948300172332759
191.0,ES009L2,Valladolid,2018,198,115331,115529,0.17138553956149538
192.0,ES010L2,Palma de Mallorca,2018,2247,201987,204234,1.1002085842709832
193.0,ES011L2,Santiago de Compostela,2018,5,126251,126256,0.003960207831707007
194.0,ES012L2,Vitoria/Gasteiz,2018,1449,157872,159321,0.9094846253789519
195.0,ES013L2,Oviedo,2018,11,93476,93487,0.011766341844320601
196.0,ES014L3,Pamplona/IruÃ±a,2018,162,169352,169514,0.0955673277723374
197.0,ES015L2,Santander,2018,485,68998,69483,0.6980124634802757
198.0,ES016L2,Toledo,2018,462,92936,93398,0.49465727317501446
199.0,ES017L2,Badajoz,2018,713,218036,218749,0.3259443471741585
200.0,ES018L2,LogroÃ±o,2018,57,46081,46138,0.12354241622957216
201.0,ES019L3,Bilbao,2018,741,152580,153321,0.4832997436750347
202.0,ES020L2,CÃ³rdoba,2018,1275,185627,186902,0.6821756856534441
203.0,ES021L2,Alicante/Alacant,2018,399,35659,36058,1.1065505574352432
204.0,ES022L2,Vigo,2018,982,135489,136471,0.7195667944105341
205.0,ES023L2,GijÃ³n,2018,539,52863,53402,1.0093254934272125
206.0,ES025L3,Santa Cruz de Tenerife,2018,1085,65898,66983,1.6198139826523148
207.0,ES026L2,CoruÃ±a (A),2018,524,75451,75975,0.6897005593945377
208.0,ES028L1,Reus,2018,0,11534,11534,0.0
209.0,ES031L1,Lugo,2018,3,134008,134011,0.002238622202655006
210.0,ES033L1,Girona,2018,2,39619,39621,0.005047828171929028
211.0,ES034L1,CÃ¡ceres,2018,1945,236328,238273,0.816290557469793
212.0,ES035L1,Torrevieja,2018,1757,7081,8838,19.880063362751756
213.0,ES039L1,AvilÃ©s,2018,230,18912,19142,1.2015463378957267
214.0,ES040L1,Talavera de la Reina,2018,551,82715,83266,0.6617346816227512
215.0,ES041L1,Palencia,2018,3,28378,28381,0.010570452062999895
216.0,ES043L1,Ferrol,2018,627,46343,46970,1.334894613583138
217.0,ES044L1,Pontevedra,2018,112,51504,51616,0.21698698078115314
218.0,ES046L1,Gandia,2018,242,17095,17337,1.3958585683797657
219.0,ES048L1,Guadalajara,2018,3,45380,45383,0.006610404777119186
220.0,ES050L1,Manresa,2018,3,29600,29603,0.010134108029591596
221.0,ES053L1,Ciudad Real,2018,581,95764,96345,0.6030411541854793
222.0,ES054L1,Benidorm,2018,317,20356,20673,1.5334010545155516
223.0,ES057L1,Ponferrada,2018,247,62096,62343,0.396195242449032
224.0,ES059L1,Zamora,2018,322,33858,34180,0.9420713867758923
225.0,ES070L1,Irun,2018,66,7176,7242,0.9113504556752278
226.0,ES072L1,Arrecife,2018,3401,55533,58934,5.770862320561985
227.0,ES501L3,Granada,2018,373,162251,162624,0.22936343959071231
228.0,ES505L1,Elche/Elx,2018,773,38045,38818,1.991344221752795
229.0,ES506L1,Cartagena,2018,1509,59439,60948,2.4758810789525496
230.0,ES508L1,Jerez de la Frontera,2018,168,125938,126106,0.13322125830650405
231.0,ES510L1,Donostia-San SebastiÃ¡n,2018,230,33090,33320,0.6902761104441777
232.0,ES514L1,AlmerÃ­a,2018,748,39982,40730,1.8364841640068745
233.0,ES515L1,Burgos,2018,3,149388,149391,0.0020081531015924657
234.0,ES516L1,Salamanca,2018,17,45627,45644,0.03724476382437999
235.0,ES519L1,Albacete,2018,1,245324,245325,0.0004076225415265464
236.0,ES520L1,CastellÃ³n/CastellÃ³,2018,345,32449,32794,1.0520217112886505
237.0,ES521L1,Huelva,2018,3812,93608,97420,3.9129542188462327
238.0,ES522L1,CÃ¡diz,2018,1316,23517,24833,5.299399991946201
239.0,ES523L1,LeÃ³n,2018,1,118886,118887,0.0008411348591519679
240.0,ES525L1,Tarragona,2018,443,21297,21740,2.0377184912603497
241.0,ES527L1,JaÃ©n,2018,32,99899,99931,0.03202209524571955
242.0,ES528L1,Lleida,2018,113,70562,70675,0.15988680580120268
243.0,ES529L1,Ourense,2018,0,65168,65168,0.0
244.0,ES532L1,Algeciras,2018,485,41809,42294,1.1467347614318815
245.0,ES533L1,Marbella,2018,573,68632,69205,0.8279748573079979
246.0,ES537L1,Alcoy,2018,0,20529,20529,0.0
247.0,ES538L1,Ãvila,2018,473,53173,53646,0.8817059985833055
248.0,ES542L1,Cuenca,2018,74,164508,164582,0.04496238956872562
249.0,ES543L1,Eivissa,2018,2093,57309,59402,3.5234503888757955
250.0,ES544L1,Linares,2018,13,25763,25776,0.05043451272501552
251.0,ES545L1,Lorca,2018,143,182064,182207,0.07848216588824798
252.0,ES546L1,MÃ©rida,2018,877,127422,128299,0.6835594977357579
253.0,ES547L1,Sagunto,2018,201,15327,15528,1.294435857805255
254.0,ES550L1,Puerto de la Cruz,2018,1348,26124,27472,4.906814210832848
255.0,ES552L1,Igualada,2018,0,25426,25426,0.0
256.0,FI001L3,Helsinki,2018,17248,474270,491518,3.509128862015226
257.0,FI002L3,Tampere,2018,85120,603523,688643,12.360540947922217
258.0,FI003L4,Turku,2018,19376,447068,466444,4.15398204286045
259.0,FI004L4,Oulu,2018,7144,716677,723821,0.9869843511033806
260.0,FI007L2,Lahti,2018,31177,304226,335403,9.29538495481555
261.0,FI008L2,Kuopio,2018,130472,789934,920406,14.175483427965485
262.0,FI009L2,JyvÃ¤skylÃ¤,2018,50635,426307,476942,10.61659488994469
263.0,FR001L1,Paris,2018,2369,1207583,1209952,0.19579289095765784
264.0,FR003L2,Lyon,2018,1201,366030,367231,0.3270421070116629
265.0,FR004L2,Toulouse,2018,264,524408,524672,0.050317150524518184
266.0,FR006L2,Strasbourg,2018,939,202944,203883,0.4605582613557776
267.0,FR007L2,Bordeaux,2018,4830,550924,555754,0.8690895612087363
268.0,FR008L2,Nantes,2018,2626,313993,316619,0.8293880026151305
269.0,FR009L2,Lille,2018,40,144413,144453,0.027690667552768028
270.0,FR010L2,Montpellier,2018,7357,216561,223918,3.285577756142874
271.0,FR011L2,Saint-Etienne,2018,167,180888,181055,0.09223716550219548
272.0,FR012L2,Le Havre,2018,878,75560,76438,1.1486433449331483
273.0,FR013L2,Rennes,2018,146,381991,382137,0.03820619306688439
274.0,FR014L2,Amiens,2018,51,244744,244795,0.02083375885945383
275.0,FR016L2,Nancy,2018,280,283229,283509,0.09876229678775629
276.0,FR017L2,Metz,2018,134,176796,176930,0.07573616684564517
277.0,FR018L2,Reims,2018,29,243122,243151,0.011926745109006338
278.0,FR019L2,OrlÃ©ans,2018,1042,290925,291967,0.3568896484876715
279.0,FR020L2,Dijon,2018,136,385625,385761,0.035254989488310115
280.0,FR021L2,Poitiers,2018,67,250375,250442,0.02675270122423555
281.0,FR022L2,Clermont-Ferrand,2018,20,266106,266126,0.007515237143308057
282.0,FR023L2,Caen,2018,268,226005,226273,0.11844099826316
283.0,FR024L2,Limoges,2018,9,317825,317834,0.0028316668449568016
284.0,FR025L2,BesanÃ§on,2018,20,239016,239036,0.008366940544520491
285.0,FR026L2,Grenoble,2018,3291,262557,265848,1.2379254310733954
286.0,FR027L2,Ajaccio,2018,1492,145517,147009,1.0149038494241849
289.0,FR032L2,Toulon,2018,2206,104850,107056,2.060603796144074
290.0,FR034L2,Valenciennes,2018,31,78415,78446,0.03951762996201208
291.0,FR035L2,Tours,2018,711,284137,284848,0.24960680784137504
292.0,FR036L2,Angers,2018,677,230574,231251,0.29275549078706686
293.0,FR037L2,Brest,2018,543,134451,134994,0.40224009955998047
294.0,FR038L2,Le Mans,2018,65,224046,224111,0.029003484880260225
295.0,FR039L1,Avignon,2018,1472,85753,87225,1.6875895672112353
296.0,FR040L2,Mulhouse,2018,88,129678,129766,0.0678143735647242
297.0,FR042L2,Dunkerque,2018,730,90395,91125,0.8010973936899862
298.0,FR043L2,Perpignan,2018,1509,181521,183030,0.82445500737584
299.0,FR044L2,NÃ®mes,2018,1373,149118,150491,0.9123469177558791
300.0,FR045L2,Pau,2018,93,201666,201759,0.04609459801049767
301.0,FR046L2,Bayonne,2018,1478,101152,102630,1.4401247198674851
302.0,FR047L0,Annemasse,2018,0,7800,7800,0.0
303.0,FR048L2,Annecy,2018,1943,117100,119043,1.6321833287131542
304.0,FR049L2,Lorient,2018,530,112652,113182,0.46827234012475477
305.0,FR050L2,MontbÃ©liard,2018,22,123035,123057,0.017877893984088674
306.0,FR051L2,Troyes,2018,1367,259583,260950,0.5238551446637287
307.0,FR052L2,Saint-Nazaire,2018,250,106885,107135,0.23335044569935132
308.0,FR053L2,La Rochelle,2018,247,111093,111340,0.2218430034129693
309.0,FR056L2,AngoulÃªme,2018,20,214272,214292,0.009333059563586134
310.0,FR057L2,Boulogne-sur-Mer,2018,114,68424,68538,0.16633108640462224
311.0,FR058L2,ChambÃ©ry,2018,884,100805,101689,0.8693172319523252
312.0,FR059L2,Chalon-sur-SaÃ´ne,2018,289,156069,156358,0.1848322439529797
313.0,FR060L2,Chartres,2018,96,161264,161360,0.05949429846306396
314.0,FR061L2,Niort,2018,6,178913,178919,0.003353472800541027
315.0,FR062L2,Calais,2018,99,50131,50230,0.1970933704957197
316.0,FR063L2,BÃ©ziers,2018,408,84735,85143,0.4791938268559952
317.0,FR064L2,Arras,2018,10,107553,107563,0.009296877178955588
318.0,FR065L2,Bourges,2018,134,250185,250319,0.05353169355901869
319.0,FR066L2,Saint-Brieuc,2018,54,115127,115181,0.04688273239509989
320.0,FR067L2,Quimper,2018,590,121332,121922,0.4839159462607241
321.0,FR068L2,Vannes,2018,462,120572,121034,0.3817109242031165
322.0,FR069L2,Cherbourg,2018,448,90270,90718,0.49383804757600475
323.0,FR073L2,Tarbes,2018,144,104185,104329,0.1380249019927345
324.0,FR074L2,CompiÃ¨gne,2018,188,98549,98737,0.1904048127854806
325.0,FR076L2,Belfort,2018,50,65569,65619,0.07619744281381917
326.0,FR077L2,Roanne,2018,103,123097,123200,0.08360389610389611
327.0,FR079L2,Saint-Quentin,2018,18,99356,99374,0.01811338982027492
328.0,FR082L2,Beauvais,2018,37,131105,131142,0.028213692028488203
329.0,FR084L2,Creil,2018,70,29573,29643,0.23614344027257703
330.0,FR086L2,Evreux,2018,28,126542,126570,0.02212214584814727
331.0,FR090L2,ChÃ¢teauroux,2018,218,260959,261177,0.08346829927596994
332.0,FR093L2,Brive-la-Gaillarde,2018,1,132581,132582,0.0007542501998763029
333.0,FR096L2,Albi,2018,114,134124,134238,0.08492379207079963
334.0,FR099L2,FrÃ©jus,2018,436,43977,44413,0.9816945488933421
335.0,FR104L2,ChÃ¢lons-en-Champagne,2018,13,152796,152809,0.00850735231563586
336.0,FR203L2,Marseille,2018,2826,422950,425776,0.6637292848821916
337.0,FR205L2,Nice,2018,1472,305868,307340,0.4789483959133207
338.0,FR207L2,Lens - LiÃ©vin,2018,9,25299,25308,0.03556187766714083
339.0,FR208L1,HÃ©nin - Carvin,2018,0,11598,11598,0.0
340.0,FR209L2,Douai,2018,67,45017,45084,0.14861148079141157
341.0,FR214L1,Valence,2018,526,90435,90961,0.5782698079396664
342.0,FR215L2,Rouen,2018,2376,284750,287126,0.8275112668305902
343.0,FR304L1,Melun,2018,41,44795,44836,0.09144437505575877
344.0,FR324L1,Martigues,2018,1691,18765,20456,8.266523269456394
345.0,FR505L1,Charleville-MÃ©ziÃ¨res,2018,71,135298,135369,0.05244923136020803
346.0,FR506L1,Colmar,2018,74,101911,101985,0.07255969015051232
347.0,FR519L1,Cannes,2018,490,19646,20136,2.4334525228446564
348.0,HR001L2,Grad Zagreb,2018,94,505774,505868,0.018581922556872545
349.0,HR002L2,Rijeka,2018,395,106839,107234,0.3683533207751273
350.0,HR003L2,Slavonski Brod,2018,741,97089,97830,0.7574363692118982
351.0,HR004L2,Osijek,2018,1607,171327,172934,0.9292562480483885
352.0,HR005L2,Split,2018,3279,335791,339070,0.9670569498923526
353.0,HR006L1,Pula - Pola,2018,1267,57630,58897,2.1512131347946415
354.0,HR007L1,Zadar,2018,2550,153950,156500,1.6293929712460065
355.0,HU001L2,Budapest,2018,5541,633593,639134,0.8669543476015984
356.0,HU002L2,Miskolc,2018,280,164389,164669,0.17003807638353302
357.0,HU003L2,NyÃ­regyhÃ¡za,2018,245,167980,168225,0.14563828206271362
358.0,HU004L2,PÃ©cs,2018,178,185310,185488,0.09596308116967135
359.0,HU005L2,Debrecen,2018,471,201107,201578,0.23365645060472867
360.0,HU006L2,Szeged,2018,840,160093,160933,0.5219563420802446
361.0,HU007L2,GyÃµr,2018,438,204202,204640,0.21403440187646597
362.0,HU008L2,KecskemÃ©t,2018,59,182080,182139,0.03239284282882853
363.0,HU009L2,SzÃ©kesfehÃ©rvÃ¡r,2018,1285,299838,301123,0.42673591854491355
364.0,HU010L1,Szombathely,2018,34,134243,134277,0.025320792093955033
365.0,HU011L1,Szolnok,2018,706,143269,143975,0.49036291022747003
366.0,HU012L1,TatabÃ¡nya,2018,146,69684,69830,0.20907919232421596
367.0,HU013L1,VeszprÃ©m,2018,7141,124179,131320,5.437861711848919
368.0,HU014L1,BÃ©kÃ©scsaba,2018,89,106074,106163,0.0838333506023756
369.0,HU015L1,KaposvÃ¡r,2018,40,145520,145560,0.02748007694421544
370.0,HU016L1,Eger,2018,94,100484,100578,0.09345980234246058
371.0,HU017L1,DunaÃºjvÃ¡ros,2018,721,60949,61670,1.1691259931895575
372.0,HU018L1,Zalaegerszeg,2018,295,139684,139979,0.21074589759892556
373.0,HU019L1,Sopron,2018,504,80166,80670,0.6247675715879508
374.0,IE001L1,Dublin,2018,3888,699714,703602,0.5525851262503517
375.0,IE002L1,Cork,2018,1746,327917,329663,0.5296317754798082
376.0,IE003L1,Limerick,2018,25,156433,156458,0.015978729115801046
377.0,IE004L1,Galway,2018,725,225558,226283,0.3203952572663435
378.0,IE005L1,Waterford,2018,1057,94800,95857,1.1026842066828713
379.0,IS001L1,ReykjavÃ­k,2018,345503,951727,1297230,26.63390455046522
380.0,IT001L3,Roma,2018,8834,608382,617216,1.4312655537121526
381.0,IT002L3,Milano,2018,18,384027,384045,0.004686950747959224
382.0,IT003L3,Napoli,2018,2961,149981,152942,1.9360280367721097
383.0,IT004L2,Torino,2018,69,170110,170179,0.040545543222136694
384.0,IT005L3,Palermo,2018,1528,148545,150073,1.0181711567037375
385.0,IT006L3,Genova,2018,605,120159,120764,0.5009771123844854
386.0,IT007L3,Firenze,2018,102,163669,163771,0.0622820890145386
387.0,IT008L3,Bari,2018,497,112932,113429,0.43815955355332414
388.0,IT009L1,Bologna,2018,90,185167,185257,0.04858116022606433
389.0,IT010L2,Catania,2018,533,60892,61425,0.8677248677248678
390.0,IT011L2,Venezia,2018,1842,65195,67037,2.747736324716201
391.0,IT012L3,Verona,2018,54,73107,73161,0.07380981670562184
392.0,IT013L3,Cremona,2018,377,60020,60397,0.624203188900111
393.0,IT014L3,Trento,2018,675,97512,98187,0.6874637171927037
394.0,IT015L1,Trieste,2018,326,21311,21637,1.506678375005777
395.0,IT016L3,Perugia,2018,5542,125486,131028,4.229630308025765
396.0,IT017L3,Ancona,2018,479,43764,44243,1.082657143502927
397.0,IT019L2,Pescara,2018,244,16199,16443,1.4839141275922885
398.0,IT020L3,Campobasso,2018,480,102355,102835,0.4667671512617299
399.0,IT021L2,Caserta,2018,1,9341,9342,0.010704345964461572
400.0,IT022L2,Taranto,2018,3479,103449,106928,3.253591201556187
401.0,IT023L2,Potenza,2018,177,138278,138455,0.12783937019248132
402.0,IT024L3,Catanzaro,2018,351,89732,90083,0.3896406647203135
403.0,IT025L3,Reggio di Calabria,2018,573,47675,48248,1.1876139943624606
404.0,IT026L3,Sassari,2018,2207,151018,153225,1.4403654756077664
405.0,IT027L2,Cagliari,2018,4879,190413,195292,2.4983102226409684
406.0,IT028L3,Padova,2018,5,61440,61445,0.008137358613394093
407.0,IT029L3,Brescia,2018,96,60173,60269,0.1592858683568667
408.0,IT030L3,Modena,2018,129,69139,69268,0.18623318126696312
409.0,IT031L3,Foggia,2018,4,89707,89711,0.004458762024723836
410.0,IT032L3,Salerno,2018,328,37511,37839,0.8668305187769234
411.0,IT033L2,Piacenza,2018,184,93943,94127,0.19548057411794703
412.0,IT034L1,Bolzano,2018,915,105841,106756,0.8570946832028177
413.0,IT035L2,Udine,2018,0,71830,71830,0.0
414.0,IT036L2,La Spezia,2018,649,42270,42919,1.5121507956848947
415.0,IT037L1,Lecce,2018,338,61172,61510,0.5495041456673712
416.0,IT038L1,Barletta,2018,230,14867,15097,1.5234814863880242
417.0,IT039L2,Pesaro,2018,104,25587,25691,0.40481102331555796
418.0,IT040L2,Como,2018,679,19062,19741,3.4395420698039616
419.0,IT041L2,Pisa,2018,510,47543,48053,1.061328116870955
420.0,IT042L1,Treviso,2018,35,24010,24045,0.1455604075691412
421.0,IT043L2,Varese,2018,513,23151,23664,2.167849898580122
422.0,IT045L2,Asti,2018,7,54829,54836,0.012765336640163397
423.0,IT046L2,Pavia,2018,7,36197,36204,0.019334880123743233
424.0,IT047L1,Massa,2018,301,10942,11243,2.677221382193365
425.0,IT048L2,Cosenza,2018,162,92317,92479,0.17517490457293006
426.0,IT052L1,Savona,2018,180,28525,28705,0.6270684549730012
427.0,IT054L1,Matera,2018,596,77193,77789,0.7661751661545977
428.0,IT056L1,Acireale,2018,52,5936,5988,0.8684034736138945
429.0,IT057L2,Avellino,2018,4,39755,39759,0.010060615206619885
430.0,IT058L2,Pordenone,2018,15,37035,37050,0.04048582995951417
431.0,IT060L1,Lecco,2018,1310,28902,30212,4.33602542036277
432.0,IT061L0,Altamura,2018,0,42800,42800,0.0
433.0,IT064L1,Battipaglia,2018,53,6433,6486,0.8171446191797719
434.0,IT065L0,Bisceglie,2018,83,6861,6944,1.1952764976958525
435.0,IT066L1,Carpi,2018,7,20615,20622,0.03394433129667345
436.0,IT067L0,Cerignola,2018,138,58759,58897,0.2343073501197005
437.0,IT068L1,Gallarate,2018,0,5319,5319,0.0
438.0,IT069L1,Gela,2018,407,57488,57895,0.7029968045599793
439.0,IT073L1,Sassuolo,2018,1,24061,24062,0.004155930512841825
440.0,IT501L2,Messina,2018,796,33647,34443,2.3110646575501557
441.0,IT502L2,Prato,2018,10,40949,40959,0.024414658561000026
442.0,IT503L3,Parma,2018,155,113352,113507,0.13655545472966424
443.0,IT504L3,Livorno,2018,343,25471,25814,1.3287363446191989
444.0,IT505L3,Reggio nell'Emilia,2018,1,69033,69034,0.0014485615783526957
445.0,IT506L2,Ravenna,2018,3533,77656,81189,4.351574720713397
446.0,IT507L2,Ferrara,2018,816,90667,91483,0.8919689997048632
447.0,IT508L3,Rimini,2018,204,32375,32579,0.6261702323582676
448.0,IT509L3,Siracusa,2018,544,33598,34142,1.593345439634468
449.0,IT511L2,Bergamo,2018,0,18556,18556,0.0
450.0,IT512L3,ForlÃ¬,2018,0,72751,72751,0.0
451.0,IT513L3,Latina,2018,527,65966,66493,0.7925646308633991
452.0,IT514L2,Vicenza,2018,1,34981,34982,0.0028586130009719286
453.0,IT515L2,Terni,2018,128,102204,102332,0.1250830629715045
454.0,IT516L2,Novara,2018,0,54165,54165,0.0
455.0,IT518L1,Alessandria,2018,6,76908,76914,0.007800920508620017
456.0,IT519L1,Arezzo,2018,13,88614,88627,0.014668216232073747
457.0,IT520L1,Grosseto,2018,472,119127,119599,0.3946521291984047
458.0,IT521L1,Brindisi,2018,853,63134,63987,1.3330832825417662
459.0,IT522L1,Trapani,2018,910,49880,50790,1.7916912778105927
460.0,IT523L1,Ragusa,2018,255,52595,52850,0.48249763481551566
461.0,IT524L0,Andria,2018,0,39880,39880,0.0
462.0,IT525L0,Trani,2018,112,10267,10379,1.0791020329511514
463.0,IT526L1,L'Aquila,2018,1044,139225,140269,0.7442841967933043
464.0,LT001L1,Vilnius,2018,1682,422887,424569,0.3961664652859724
465.0,LT002L1,Kaunas,2018,349,161702,162051,0.2153642988935582
466.0,LT003L1,PanevÄÅ¾ys,2018,8,222800,222808,0.003590535348820509
467.0,LT004L0,Alytus,2018,0,3959,3959,0.0
468.0,LT501L0,KlaipÄda,2018,87,8836,8923,0.9750084052448729
469.0,LT502L0,Å iauliai,2018,1095,6950,8045,13.610938471100061
470.0,LU001L1,Luxembourg,2018,230,259485,259715,0.08855861232504862
471.0,LV001L1,RÄ«ga,2018,8459,607790,616249,1.3726594282505935
472.0,LV002L2,LiepÄja,2018,3366,268691,272057,1.2372407252891857
473.0,LV003L1,Jelgava,2018,93,166366,166459,0.055869613538468935
474.0,LV501L1,Daugavpils,2018,2354,257321,259675,0.9065177625878502
475.0,ME001L1,Podgorica,2018,1268,183213,184481,0.6873336549563369
476.0,MK001L1,Skopje,2018,7,224346,224353,0.003120083083355248
477.0,MK003L1,Bitola,2018,373,119289,119662,0.31171132021861575
478.0,MK004L1,Tetovo,2018,8,105613,105621,0.007574251332594843
479.0,MK005L1,Prilep,2018,47,86784,86831,0.05412813396137325
480.0,MT001L1,Valletta,2018,980,24976,25956,3.7756202804746493
481.0,NL001L3,s' Gravenhage,2018,1232,41475,42707,2.8847729880347486
482.0,NL002L3,Amsterdam,2018,72105,260852,332957,21.65594956706121
483.0,NL003L3,Rotterdam,2018,27547,189624,217171,12.684474446403987
484.0,NL004L3,Utrecht,2018,806,96481,97287,0.8284765693258093
485.0,NL005L3,Eindhoven,2018,32,144374,144406,0.022159744054956163
486.0,NL006L3,Tilburg,2018,51,43183,43234,0.11796271453023083
487.0,NL007L3,Groningen,2018,2734,205426,208160,1.313412759415834
488.0,NL008L3,Enschede,2018,107,84849,84956,0.12594754931964783
489.0,NL009L3,Arnhem,2018,559,55339,55898,1.0000357794554366
490.0,NL010L3,Heerlen,2018,17,33326,33343,0.05098521428785652
491.0,NL012L3,Breda,2018,1623,71747,73370,2.2120757802916726
492.0,NL013L3,Nijmegen,2018,784,39052,39836,1.9680690832412893
493.0,NL014L3,Apeldoorn,2018,79,71045,71124,0.1110736179067544
494.0,NL015L3,Leeuwarden,2018,977,109946,110923,0.8807911794668375
495.0,NL016L3,Sittard-Geleen,2018,55,22857,22912,0.24004888268156424
496.0,NL020L3,Roosendaal,2018,2,24572,24574,0.008138683161064541
497.0,NL026L0,Alphen aan den Rijn,2018,38,13172,13210,0.28766086298258897
498.0,NL028L3,Bergen op Zoom,2018,1882,32899,34781,5.411000258761968
499.0,NL030L0,Gouda,2018,7,1781,1788,0.39149888143176736
500.0,NL032L3,MiddelburgÂ Â Â Â Â Â ,2018,1159,22229,23388,4.9555327518385495
501.0,NL503L3,s-Hertogenbosch,2018,701,36158,36859,1.9018421552402398
502.0,NL504L3,Amersfoort,2018,4,12240,12244,0.03266906239790918
503.0,NL505L3,Maastricht,2018,35,20350,20385,0.17169487368162864
504.0,NL507L3,Leiden,2018,271,19510,19781,1.370001516606845
505.0,NL511L3,Zwolle,2018,722,122298,123020,0.5868964396033165
506.0,NL512L3,Ede,2018,36,35229,35265,0.10208421948107188
507.0,NL513L3,Deventer,2018,90,25155,25245,0.35650623885918004
508.0,NL514L3,Alkmaar,2018,272,47520,47792,0.5691329092735186
509.0,NL515L3,Venlo,2018,98,51138,51236,0.191271762042314
510.0,NL519L3,Almelo,2018,4,42021,42025,0.009518143961927425
511.0,NL520L3,Lelystad,2018,57961,60881,118842,48.77147809696908
512.0,NL521L3,Oss,2018,60,33086,33146,0.18101731732335727
513.0,NL522L3,Assen,2018,48,70814,70862,0.06773729220174424
514.0,NL524L3,Veenendaal,2018,4,8181,8185,0.04886988393402566
515.0,NL529L3,Soest,2018,0,7942,7942,0.0
516.0,NO001L1,Oslo,2018,15069,731574,746643,2.0182336136547185
517.0,NO002L1,Bergen,2018,18747,338996,357743,5.240354108955311
518.0,NO003L1,Trondheim,2018,14408,658848,673256,2.140047767862448
519.0,NO004L1,Stavanger,2018,6875,282202,289077,2.378259079760756
520.0,NO005L1,Kristiansand,2018,6933,308529,315462,2.1977290450196856
521.0,NO006L1,TromsÃ¸,2018,38654,335959,374613,10.318381903457702
522.0,PL001L2,Warszawa,2018,2182,859061,861243,0.25335474424755844
523.0,PL002L2,ÅÃ³dÅº,2018,4,169496,169500,0.002359882005899705
524.0,PL003L2,KrakÃ³w,2018,445,375303,375748,0.1184304374208246
525.0,PL004L2,WrocÅaw,2018,129,264571,264700,0.048734416320362677
526.0,PL005L2,PoznaÅ,2018,1517,307811,309328,0.49041793824031443
527.0,PL006L2,GdaÅsk,2018,1881,261635,263516,0.7138086491901819
528.0,PL007L2,Szczecin,2018,4679,108381,113060,4.138510525384752
529.0,PL008L2,Bydgoszcz,2018,2019,208117,210136,0.960806334944988
530.0,PL009L2,Lublin,2018,28,322756,322784,0.008674531575294934
531.0,PL010L2,Katowice,2018,1744,392851,394595,0.4419721486587514
532.0,PL011L2,BiaÅystok,2018,19,223303,223322,0.008507894430463635
533.0,PL012L2,Kielce,2018,36,224193,224229,0.016055015185368532
534.0,PL013L2,ToruÅ,2018,683,158250,158933,0.42974083418799114
535.0,PL014L2,Olsztyn,2018,2228,200316,202544,1.1000078995181293
536.0,PL015L2,RzeszÃ³w,2018,79,229270,229349,0.03444532132252593
537.0,PL016L2,Opole,2018,1245,175371,176616,0.7049191466231824
538.0,PL017L2,GorzÃ³w Wielkopolski,2018,173,97247,97420,0.17758160541983165
539.0,PL018L2,Zielona GÃ³ra,2018,252,169032,169284,0.14886226695966542
540.0,PL019L2,Jelenia GÃ³ra,2018,238,83103,83341,0.28557372721709606
541.0,PL020L2,Nowy SÄcz,2018,335,130083,130418,0.2568663834746738
542.0,PL021L2,SuwaÅki,2018,1128,71005,72133,1.5637780211553658
543.0,PL022L2,Konin,2018,169,117994,118163,0.14302277362626203
544.0,PL024L2,CzÄstochowa,2018,3,193895,193898,0.001547205231616623
545.0,PL025L2,Radom,2018,2,68020,68022,0.002940225221251948
546.0,PL026L2,PÅock,2018,1121,169954,171075,0.6552681572409761
547.0,PL027L2,Kalisz,2018,82,148941,149023,0.055025063245270865
548.0,PL028L2,Koszalin,2018,394,129277,129671,0.30384588689838127
549.0,PL029L1,SÅupsk,2018,8091,226913,235004,3.442920120508587
550.0,PL030L1,JastrzÄbie-ZdrÃ³j,2018,5,29566,29571,0.01690845761049677
551.0,PL031L1,Siedlce,2018,16,126153,126169,0.01268140351433395
552.0,PL032L1,PiotrkÃ³w Trybunalski,2018,73,116849,116922,0.06243478558355142
553.0,PL033L1,Lubin,2018,149,93157,93306,0.159689623389707
554.0,PL034L1,PiÅa,2018,118,52074,52192,0.2260882893930104
555.0,PL035L1,InowrocÅaw,2018,3,20125,20128,0.014904610492845785
556.0,PL036L1,Ostrowiec ÅwiÄtokrzyski,2018,0,61460,61460,0.0
557.0,PL037L1,Gniezno,2018,123,66448,66571,0.18476513797299124
558.0,PL038L1,Stargard SzczeciÅski,2018,2187,34477,36664,5.964979271219725
559.0,PL039L1,OstrÃ³w Wielkopolski,2018,15,84746,84761,0.017696818112103444
560.0,PL040L1,PrzemyÅl,2018,230,84859,85089,0.27030520983910966
561.0,PL041L1,ZamoÅÄ,2018,266,112441,112707,0.2360101857027514
562.0,PL042L1,CheÅm,2018,61,46509,46570,0.1309856130556152
563.0,PL043L1,Pabianice,2018,0,32959,32959,0.0
564.0,PL044L1,GÅogÃ³w,2018,112,63969,64081,0.1747787955868354
565.0,PL045L1,Stalowa Wola,2018,164,190149,190313,0.08617382942836276
566.0,PL046L1,TomaszÃ³w Mazowiecki,2018,95,19068,19163,0.4957470124719512
567.0,PL047L1,ÅomÅ¼a,2018,1,56001,56002,0.001785650512481697
568.0,PL048L1,Leszno,2018,243,77329,77572,0.31325736090341877
569.0,PL049L1,Åwidnica,2018,2,47988,47990,0.004167534903104814
570.0,PL051L1,Tczew,2018,90,27034,27124,0.331809467630143
571.0,PL052L1,EÅk,2018,1009,39043,40052,2.5192250074902627
572.0,PL506L2,Bielsko-BiaÅa,2018,88,73347,73435,0.1198338666848233
573.0,PL508L1,Rybnik,2018,12,14869,14881,0.08063974195282575
574.0,PL511L2,WaÅbrzych,2018,1,51509,51510,0.0019413706076490003
575.0,PL512L2,ElblÄg,2018,7,96468,96475,0.007255765742420316
576.0,PL513L2,WÅocÅawek,2018,1548,120931,122479,1.2638901362682582
577.0,PL514L2,TarnÃ³w,2018,158,125169,125327,0.12607020035586905
578.0,PL516L2,Legnica,2018,80,56420,56500,0.1415929203539823
579.0,PL517L2,GrudziÄdz,2018,0,55043,55043,0.0
580.0,PT001L3,Lisboa,2018,7492,431789,439281,1.7055142380389774
581.0,PT002L2,Porto,2018,1150,94590,95740,1.2011698349697097
582.0,PT003L1,Braga,2018,46,49303,49349,0.09321364161381183
583.0,PT004L2,Funchal,2018,1053,34909,35962,2.9280907624714976
584.0,PT005L2,Coimbra,2018,413,162374,162787,0.25370576274518236
585.0,PT007L1,Ponta Delgada,2018,1169,54125,55294,2.114153434369009
586.0,PT008L2,Aveiro,2018,1939,41391,43330,4.474959612277868
587.0,PT009L1,Faro,2018,2506,46644,49150,5.0986775178026456
588.0,PT014L1,Viseu,2018,5,70869,70874,0.007054773259587437
589.0,PT016L0,Viana do Castelo,2018,390,31862,32252,1.2092273347389308
590.0,PT019L0,PÃ³voa de Varzim,2018,38,8368,8406,0.45205805377111585
591.0,PT505L1,GuimarÃ£es,2018,0,26541,26541,0.0
592.0,RO001L1,BucureÅti,2018,653,107189,107842,0.6055154763450232
593.0,RO002L1,Cluj-Napoca,2018,26,59276,59302,0.04384337796364372
594.0,RO003L1,TimiÅoara,2018,0,23654,23654,0.0
595.0,RO004L1,Craiova,2018,102,34294,34396,0.2965461100127922
596.0,RO005L1,BrÄila,2018,1204,22325,23529,5.117089549067109
597.0,RO006L1,Oradea,2018,14,20325,20339,0.06883327597227003
598.0,RO007L1,BacÄu,2018,58,22035,22093,0.26252659213325485
599.0,RO008L1,Arad,2018,124,51484,51608,0.24027282591846225
600.0,RO009L1,Sibiu,2018,16,56324,56340,0.028399006034788784
601.0,RO010L1,TÃ¢rgu MureÅ,2018,29,13711,13740,0.21106259097525473
602.0,RO011L1,Piatra NeamÅ£,2018,92,14907,14999,0.6133742249483298
603.0,RO012L1,CÇlÇraÅi,2018,531,24013,24544,2.1634615384615383
604.0,RO013L1,Giurgiu,2018,534,10416,10950,4.876712328767123
605.0,RO014L1,Alba Iulia,2018,16,25986,26002,0.06153372817475579
606.0,RO015L1,FocÅani,2018,7,27095,27102,0.025828352151132754
607.0,RO016L1,TÃ¢rgu Jiu,2018,9,24513,24522,0.03670173721556154
608.0,RO017L1,Tulcea,2018,1652,39295,40947,4.034483600752192
609.0,RO018L1,TÃ¢rgoviÅte,2018,3,20254,20257,0.014809695413930986
610.0,RO019L1,Slatina,2018,292,6831,7123,4.099396321774533
611.0,RO020L1,BÃ¢rlad,2018,56,26263,26319,0.21277404156692883
612.0,RO021L1,Roman,2018,4,14386,14390,0.02779708130646282
613.0,RO022L1,BistriÅ£a,2018,6,42625,42631,0.014074265206070698
614.0,RO501L1,Constanta,2018,5806,53545,59351,9.782480497379993
615.0,RO502L1,Iasi,2018,238,79698,79936,0.29773819055244194
616.0,RO503L1,Galati,2018,1998,39234,41232,4.8457508731082655
617.0,RO504L1,Brasov,2018,55,98448,98503,0.0558358628671208
618.0,RO505L1,Ploiesti,2018,17,34320,34337,0.04950927570841949
619.0,RO506L1,Pitesti,2018,57,24827,24884,0.22906285163157047
620.0,RO507L1,Baia Mare,2018,65,52476,52541,0.12371290991796884
621.0,RO508L1,Buzau,2018,10,38530,38540,0.02594706798131811
622.0,RO509L1,Satu Mare,2018,24,70820,70844,0.033877251425667665
623.0,RO510L1,Botosani,2018,26,37314,37340,0.06963042313872522
624.0,RO511L1,Ramnicu Valcea,2018,653,28520,29173,2.2383710965618895
625.0,RO512L1,Suceava,2018,130,39548,39678,0.3276374817279097
626.0,RO513L1,Drobeta-Turnu Severin,2018,1986,30948,32934,6.030242302787393
627.0,RS001L1,Beograd,2018,6591,306433,313024,2.1055893477816396
628.0,RS002L1,Novi Sad,2018,2615,186828,189443,1.3803624309158955
629.0,RS003L1,NiÅ¡,2018,36,341528,341564,0.010539752432926186
630.0,RS004L1,Kragujevac,2018,206,143869,144075,0.14298108623980565
631.0,RS005L1,Subotica,2018,287,160005,160292,0.17904823696753425
632.0,RS006L1,Novi Pazar,2018,15,140776,140791,0.010654090105191383
633.0,RS008L1,Zrenjanin,2018,894,184237,185131,0.48290129691947864
634.0,RS009L1,Kraljevo,2018,4,176508,176512,0.0022661348803480782
635.0,RS011L0,ÄaÄak,2018,19,63668,63687,0.02983340399139542
636.0,RS012L1,KruÅ¡evac,2018,26,122623,122649,0.021198705248310218
637.0,RS013L1,Leskovac,2018,5,166277,166282,0.0030069400175605295
638.0,RS014L1,Valjevo,2018,6,141656,141662,0.004235433637813951
639.0,RS015L1,Vranje,2018,1,195355,195356,0.0005118859927516943
640.0,RS016L1,Smederevo,2018,2604,157620,160224,1.6252246854403833
641.0,SE001L1,Stockholm,2018,54977,700749,755726,7.274726554333184
642.0,SE002L1,GÃ¶teborg,2018,11598,423661,435259,2.6646203754546143
643.0,SE003L1,MalmÃ¶,2018,2260,185756,188016,1.2020253595438686
644.0,SE004L1,JÃ¶nkÃ¶ping,2018,44400,302791,347191,12.788349928425562
645.0,SE005L1,UmeÃ¥,2018,21429,966820,988249,2.1683806409113493
646.0,SE006L1,Uppsala,2018,8231,689296,697527,1.1800260061617687
647.0,SE007L1,LinkÃ¶ping,2018,11482,411714,423196,2.713163640488095
648.0,SE008L1,Ãrebro,2018,21846,346751,368597,5.926798101992149
649.0,SE501L1,VÃ¤sterÃ¥s,2018,15796,274619,290415,5.439112993474855
650.0,SE502L1,NorrkÃ¶ping,2018,12501,299237,311738,4.010098223508202
651.0,SE503L1,Helsingborg,2018,1134,113288,114422,0.9910681512296586
652.0,SE505L1,BorÃ¥s,2018,1432,95930,97362,1.4707996959799512
653.0,SI001L2,Ljubljana,2018,303,232984,233287,0.1298829338968738
654.0,SI002L1,Maribor,2018,548,216437,216985,0.2525520197248658
655.0,SK001L1,Bratislava,2018,1591,203350,204941,0.7763209899434471
656.0,SK002L1,KoÅ¡ice,2018,414,177220,177634,0.23306349009761645
657.0,SK003L1,BanskÃ¡ Bystrica,2018,0,80880,80880,0.0
658.0,SK004L1,Nitra,2018,18,87109,87127,0.02065949705602167
659.0,SK005L1,PreÅ¡ov,2018,152,93147,93299,0.16291707306616363
660.0,SK006L1,Å½ilina,2018,153,81295,81448,0.18784991651114824
661.0,SK007L1,Trnava,2018,24,74196,74220,0.03233629749393695
662.0,SK008L1,TrenÄÃ­n,2018,24,67399,67423,0.03559616154724649
739.0,UK001L3,London,2018,1219,696951,698170,0.1745993096237306
740.0,UK002L3,West Midlands urban area,2018,202,215107,215309,0.09381865133366464
741.0,UK003L2,Leeds,2018,401,512026,512427,0.07825504901185926
742.0,UK004L1,Glasgow,2018,2681,335003,337684,0.7939375273924734
743.0,UK006L3,Liverpool,2018,593,99910,100503,0.590032138344129
744.0,UK007L1,Edinburgh,2018,705,174713,175418,0.4018971827292524
745.0,UK008L3,Greater Manchester,2018,1057,311189,312246,0.33851514510994535
746.0,UK009L1,Cardiff,2018,152,84339,84491,0.17990081783858636
747.0,UK010L3,Sheffield,2018,129,125958,126087,0.10231030954816911
748.0,UK011L2,Bristol,2018,217,98168,98385,0.22056207755247245
749.0,UK012L2,Belfast,2018,19856,175289,195145,10.174998078351996
750.0,UK013L2,Newcastle upon Tyne,2018,1498,545210,546708,0.2740036728930252
751.0,UK014L1,Leicester,2018,57,139724,139781,0.04077807427332756
752.0,UK016L1,Aberdeen,2018,923,653025,653948,0.14114272082795576
753.0,UK017L2,Cambridge,2018,69,159550,159619,0.04322793652384741
754.0,UK018L3,Exeter,2018,1116,246610,247726,0.4504977273277734
755.0,UK019L3,Lincoln,2018,46,211497,211543,0.021744988016620736
756.0,UK023L1,Portsmouth,2018,279,20574,20853,1.3379369874838154
757.0,UK024L1,Worcester,2018,14,61188,61202,0.022875069442175093
758.0,UK025L3,Coventry,2018,163,81284,81447,0.20013014598450526
759.0,UK026L1,Kingston upon Hull,2018,366,251332,251698,0.1454123592559337
760.0,UK027L1,Stoke-on-Trent,2018,72,88104,88176,0.08165487207403374
761.0,UK029L1,Nottingham,2018,74,90215,90289,0.08195904262977771
762.0,UK033L1,Guildford,2018,0,61691,61691,0.0
763.0,UK050L1,Burnley,2018,10,27964,27974,0.03574747980267391
764.0,UK056L1,Hastings,2018,56,54694,54750,0.10228310502283106
765.0,UK515L1,Brighton and Hove,2018,300,42107,42407,0.7074303770603909
766.0,UK516L1,Plymouth,2018,753,215022,215775,0.34897462634688914
767.0,UK517L1,Swansea,2018,393,83649,84042,0.4676233311915471
768.0,UK518L1,Derby,2018,57,68045,68102,0.08369798243810754
769.0,UK520L2,Southampton,2018,835,152517,153352,0.5444989305649747
770.0,UK528L1,Northampton,2018,233,154312,154545,0.15076514930926266
771.0,UK539L1,Bournemouth,2018,727,93066,93793,0.7751111490196497
772.0,UK546L1,Colchester,2018,808,68687,69495,1.1626735736383913
773.0,UK550L0,Dundee City,2018,258,226158,226416,0.11394954420182318
774.0,UK551L1,Falkirk,2018,64,29725,29789,0.21484440565309343
775.0,UK552L0,Reading,2018,0,21921,21921,0.0
776.0,UK553L1,Blackpool,2018,53,48902,48955,0.1082626902257175
777.0,UK557L1,Blackburn with Darwen,2018,17,79537,79554,0.021369132916006738
778.0,UK558L1,Newport,2018,44,31656,31700,0.138801261829653
779.0,UK559L2,Middlesbrough,2018,780,60989,61769,1.2627693503213586
780.0,UK560L1,Oxford,2018,80,192843,192923,0.041467321159218966
781.0,UK562L2,Preston,2018,28,25734,25762,0.10868721372564241
782.0,UK566L1,Norwich,2018,26,150214,150240,0.017305644302449415
783.0,UK568L1,Cheshire West and Chester,2018,281,135864,136145,0.20639759080392228
784.0,UK569L2,Ipswich,2018,1469,154177,155646,0.9438083856957454
785.0,UK571L1,Cheltenham,2018,0,46183,46183,0.0
786.0,XK001L1,Pristina,2018,2,255805,255807,0.0007818394336355143
787.0,XK002L1,Prizren,2018,4,127629,127633,0.0031339857246950238
788.0,XK003L1,MitrovicÃ«,2018,0,117914,117914,0.0
1.0,AL001L1,Tirana,2019,1594,165527,167121,0.953799941359853
2.0,AL003L1,Elbasan,2019,662,125342,126004,0.5253801466620107
3.0,AL004L1,ShkodÃ«r,2019,7214,178115,185329,3.892537055722526
4.0,AL005L0,VlorÃ«,2019,2353,61380,63733,3.6919649161344985
5.0,AT001L3,Wien,2019,2746,915744,918490,0.2989689599233525
6.0,AT002L3,Graz,2019,205,290927,291132,0.07041479466358902
7.0,AT003L3,Linz,2019,829,358401,359230,0.23077137210143917
8.0,AT004L3,Salzburg,2019,1787,135689,137476,1.2998632488579824
9.0,AT005L3,Innsbruck,2019,12517,200305,212822,5.881440828485776
10.0,AT006L2,Klagenfurt,2019,2606,180654,183260,1.422023354796464
11.0,BA001L1,Sarajevo,2019,11,263763,263774,0.004170236641973811
12.0,BA002L1,Banja Luka,2019,10,275292,275302,0.003632374628589694
13.0,BA003L1,Mostar,2019,1314,181033,182347,0.7206041229085205
14.0,BA004L1,Tuzla,2019,754,111507,112261,0.6716491034286173
15.0,BA005L1,Zenica,2019,6,86710,86716,0.0069191383366391445
16.0,BE001L2,Bruxelles / Brussel,2019,53,326598,326651,0.016225267946523965
17.0,BE002L2,Antwerpen,2019,4193,115019,119212,3.5172633627487166
18.0,BE003L2,Gent,2019,379,101462,101841,0.37214874166593026
19.0,BE004L2,Charleroi,2019,363,109402,109765,0.3307065093609074
20.0,BE005L2,LiÃ¨ge,2019,249,141149,141398,0.17609867183411362
21.0,BE006L2,Brugge,2019,873,55666,56539,1.544066927253754
22.0,BE007L2,Namur,2019,73,84034,84107,0.08679420262284947
23.0,BE008L1,Leuven,2019,15,45061,45076,0.033277131954920575
24.0,BE009L1,Mons,2019,36,39164,39200,0.09183673469387754
25.0,BE010L1,Kortrijk,2019,7,22332,22339,0.031335332825999374
26.0,BE011L1,Oostende,2019,96,20836,20932,0.45862793808522834
27.0,BG001L2,Sofia,2019,3134,568640,571774,0.5481186622686586
28.0,BG002L2,Plovdiv,2019,237,276849,277086,0.0855330114116195
29.0,BG003L2,Varna,2019,3712,201086,204798,1.8125177003681676
30.0,BG004L2,Burgas,2019,5289,290611,295900,1.7874281851977019
31.0,BG005L1,Pleven,2019,1041,178035,179076,0.581317429471286
32.0,BG006L2,Ruse,2019,2503,131514,134017,1.8676735041076877
33.0,BG007L2,Vidin,2019,1751,59213,60964,2.8721868643789774
34.0,BG008L2,Stara Zagora,2019,7,132061,132068,0.005300299845534119
35.0,BG009L1,Sliven,2019,45,136729,136774,0.03290098995423107
36.0,BG010L1,Dobrich,2019,22,140316,140338,0.01567643831321524
37.0,BG011L1,Shumen,2019,74,94433,94507,0.07830107822700963
38.0,BG013L1,Yambol,2019,383,130423,130806,0.2928000244637096
39.0,BG014L1,Haskovo,2019,400,73568,73968,0.5407743889249406
40.0,BG015L1,Pazardzhik,2019,11,63811,63822,0.01723543605653223
41.0,BG016L1,Blagoevgrad,2019,17,135462,135479,0.0125480701806184
42.0,BG017L1,Veliko Tarnovo,2019,0,88539,88539,0.0
43.0,BG018L1,Vratsa,2019,72,70485,70557,0.10204515498107912
44.0,CH001L2,ZÃ¼rich,2019,62,127655,127717,0.048544829584158726
45.0,CH002L2,GenÃ¨ve,2019,162,53735,53897,0.30057331576896673
46.0,CH003L2,Basel,2019,255,69165,69420,0.3673292999135696
47.0,CH004L2,Bern,2019,93,78195,78288,0.11879215205395463
48.0,CH005L2,Lausanne,2019,28,77477,77505,0.03612670150312883
49.0,CH006L1,Winterthur,2019,0,13291,13291,0.0
50.0,CH007L2,St. Gallen,2019,126,31783,31909,0.3948729198658686
51.0,CH008L2,Luzern,2019,13,29246,29259,0.044430773437232986
52.0,CH009L2,Lugano,2019,100,30525,30625,0.326530612244898
53.0,CH010L1,Biel/Bienne,2019,8,9087,9095,0.0879604178119846
54.0,CY001L2,Lefkosia,2019,47,162581,162628,0.028900312369333696
55.0,CY501L2,Lemesos,2019,952,124947,125899,0.7561616851603269
56.0,CZ001L2,Praha,2019,441,570121,570562,0.07729221364198807
57.0,CZ002L2,Brno,2019,508,267407,267915,0.1896123770598884
58.0,CZ003L2,Ostrava,2019,143,142523,142666,0.10023411324351983
59.0,CZ004L2,PlzeÅ,2019,257,195700,195957,0.13115122195175472
60.0,CZ005L2,ÃstÃ­ nad Labem,2019,336,35575,35911,0.9356464593021637
61.0,CZ006L2,Olomouc,2019,18,93546,93564,0.019238168526356292
62.0,CZ007L2,Liberec,2019,1,61315,61316,0.0016308956879118011
63.0,CZ008L2,ÄeskÃ© BudÄjovice,2019,955,128449,129404,0.7379988253840685
64.0,CZ009L2,Hradec KrÃ¡lovÃ©,2019,36,79469,79505,0.045280171058423996
65.0,CZ010L2,Pardubice,2019,64,86293,86357,0.07411095799993052
66.0,CZ011L2,ZlÃ­n,2019,4,57948,57952,0.006902263942573165
67.0,CZ013L2,Karlovy Vary,2019,68,46916,46984,0.14473012089221862
68.0,CZ014L2,Jihlava,2019,49,95978,96027,0.051027315234257034
69.0,CZ016L2,Most,2019,128,27650,27778,0.460796313629491
70.0,CZ018L2,Chomutov-Jirkov,2019,567,45119,45686,1.2410804185089526
71.0,DE001L1,Berlin,2019,14768,1733497,1748265,0.8447231969981668
72.0,DE002L1,Hamburg,2019,12414,721760,734174,1.6908798186805851
73.0,DE003L1,MÃ¼nchen,2019,2293,547648,549941,0.41695381868236775
74.0,DE004L1,KÃ¶ln,2019,802,161828,162630,0.4931439463813565
75.0,DE005L1,Frankfurt am Main,2019,1338,428993,430331,0.3109234519474544
76.0,DE007L1,Stuttgart,2019,68,365102,365170,0.01862146397568256
77.0,DE008L2,Leipzig,2019,3410,394279,397689,0.8574539401391539
78.0,DE009L2,Dresden,2019,5579,577617,583196,0.9566252169082092
79.0,DE011L1,DÃ¼sseldorf,2019,1121,119196,120317,0.9317054115378541
80.0,DE012L1,Bremen,2019,2736,586803,589539,0.46409143415448345
81.0,DE013L1,Hannover,2019,2848,294464,297312,0.9579162630502637
82.0,DE014L1,NÃ¼rnberg,2019,49,293452,293501,0.016695002742750452
83.0,DE017L0,Bielefeld,2019,7,25876,25883,0.027044778425993895
84.0,DE018L1,Halle an der Saale,2019,1704,155882,157586,1.0813143299531685
85.0,DE019L2,Magdeburg,2019,46,416988,417034,0.011030275708935004
86.0,DE020L1,Wiesbaden,2019,860,100578,101438,0.8478085135747944
87.0,DE021L1,GÃ¶ttingen,2019,89,238868,238957,0.03724519474215026
88.0,DE025L1,Darmstadt,2019,98,78089,78187,0.12534052975558596
89.0,DE026L1,Trier,2019,4,121123,121127,0.0033023190535553595
90.0,DE027L1,Freiburg im Breisgau,2019,359,220837,221196,0.16229949908678276
91.0,DE028L1,Regensburg,2019,95,253567,253662,0.03745141172110919
92.0,DE029L0,Frankfurt (Oder),2019,221,14623,14844,1.4888170304500135
93.0,DE030L1,Weimar,2019,5,89023,89028,0.005616210630363481
94.0,DE031L1,Schwerin,2019,8355,481648,490003,1.705091601479991
95.0,DE032L1,Erfurt,2019,588,284924,285512,0.20594580963322032
96.0,DE033L1,Augsburg,2019,4,199930,199934,0.0020006602178718976
97.0,DE034L1,Bonn,2019,452,128885,129337,0.34947462829662046
98.0,DE035L1,Karlsruhe,2019,1169,124643,125812,0.9291641496836549
99.0,DE036L0,MÃ¶nchengladbach,2019,0,17023,17023,0.0
100.0,DE037L1,Mainz,2019,1101,69204,70305,1.566033710262428
101.0,DE038L1,Ruhrgebiet,2019,3019,440733,443752,0.6803349618705944
102.0,DE039L1,Kiel,2019,11516,328246,339762,3.389431425527281
103.0,DE040L1,SaarbrÃ¼cken,2019,63,153619,153682,0.04099374032092242
104.0,DE042L1,Koblenz,2019,866,91310,92176,0.9395070300295087
105.0,DE043L2,Rostock,2019,5391,356413,361804,1.490033277686261
106.0,DE044L1,Kaiserslautern,2019,17,135510,135527,0.0125436259933445
107.0,DE045L1,Iserlohn,2019,89,106018,106107,0.08387759525761732
108.0,DE048L1,Wilhelmshaven,2019,646,73401,74047,0.8724188690966549
109.0,DE050L1,TÃ¼bingen,2019,5,52020,52025,0.009610764055742432
110.0,DE051L1,Villingen-Schwenningen,2019,26,102534,102560,0.02535101404056162
111.0,DE052L1,Flensburg,2019,1319,204156,205475,0.6419272417569047
112.0,DE053L1,Marburg,2019,17,126225,126242,0.013466199838405602
113.0,DE054L1,Konstanz,2019,130,81770,81900,0.15873015873015872
114.0,DE055L0,NeumÃ¼nster,2019,76,7100,7176,1.0590858416945375
115.0,DE056L0,Brandenburg an der Havel,2019,363,22467,22830,1.5900131406044677
116.0,DE057L1,GieÃen,2019,27,85501,85528,0.031568609110466744
117.0,DE058L1,LÃ¼neburg,2019,241,132261,132502,0.18188404703325234
118.0,DE059L1,Bayreuth,2019,0,199920,199920,0.0
119.0,DE060L1,Celle,2019,45,155002,155047,0.02902345740323902
120.0,DE061L1,Aschaffenburg,2019,355,147261,147616,0.24048883589854758
121.0,DE062L1,Bamberg,2019,86,122069,122155,0.07040235766034955
122.0,DE063L1,Plauen,2019,234,141054,141288,0.16561916086291828
123.0,DE064L1,Neubrandenburg,2019,19255,564736,583991,3.2971398531826686
124.0,DE065L1,Fulda,2019,1,138224,138225,0.0007234581298607343
125.0,DE066L1,Kempten (AllgÃ¤u),2019,478,158689,159167,0.3003135071968436
126.0,DE067L1,Landshut,2019,138,141315,141453,0.09755890649190897
127.0,DE069L1,Rosenheim,2019,399,147364,147763,0.27002700270027
128.0,DE071L1,Stralsund,2019,19828,318420,338248,5.8619710981291835
129.0,DE072L1,Friedrichshafen,2019,78,66541,66619,0.11708371485612214
130.0,DE073L1,Offenburg,2019,1014,184870,185884,0.5455014955563685
131.0,DE074L1,GÃ¶rlitz,2019,483,210624,211107,0.228793929144936
132.0,DE077L1,Schweinfurt,2019,128,201212,201340,0.06357405383927685
133.0,DE078L1,Greifswald,2019,3023,346771,349794,0.8642229426462432
134.0,DE079L1,Wetzlar,2019,70,106420,106490,0.06573387172504461
135.0,DE081L1,Passau,2019,477,159589,160066,0.29800207414441543
136.0,DE082L0,Dessau-RoÃlau,2019,7,24641,24648,0.02839987017202207
137.0,DE083L1,Braunschweig-Salzgitter-Wolfsburg,2019,300,412544,412844,0.0726666731259265
138.0,DE084L1,Mannheim-Ludwigshafen,2019,1419,203009,204428,0.6941319193065529
139.0,DE504L1,MÃ¼nster,2019,80,141683,141763,0.05643221432955003
140.0,DE505L0,Chemnitz,2019,0,22193,22193,0.0
141.0,DE507L1,Aachen,2019,197,70323,70520,0.2793533749290981
142.0,DE508L0,Krefeld,2019,147,13533,13680,1.074561403508772
143.0,DE510L1,LÃ¼beck,2019,5195,156954,162149,3.2038433786208977
144.0,DE513L1,Kassel,2019,38,139823,139861,0.02716983290552763
145.0,DE516L0,Solingen,2019,0,8954,8954,0.0
146.0,DE517L1,OsnabrÃ¼ck,2019,169,223961,224130,0.07540266809440949
147.0,DE520L1,Oldenburg (Oldenburg),2019,453,189516,189969,0.23845995925651028
148.0,DE522L1,Heidelberg,2019,421,116684,117105,0.35950642585713677
149.0,DE523L1,Paderborn,2019,74,124609,124683,0.05935051290071622
150.0,DE524L2,WÃ¼rzburg,2019,67,305862,305929,0.021900506326631344
151.0,DE527L1,Bremerhaven,2019,924,213555,214479,0.4308114081098849
152.0,DE529L1,Heilbronn,2019,49,119935,119984,0.04083877850380051
153.0,DE530L0,Remscheid,2019,8,7361,7369,0.1085628986293934
154.0,DE532L1,Ulm,2019,124,199184,199308,0.06221526481626428
155.0,DE533L1,Pforzheim,2019,9,67139,67148,0.013403228688866385
156.0,DE534L1,Ingolstadt,2019,124,284711,284835,0.043533975810556985
157.0,DE535L1,Gera,2019,3,99783,99786,0.003006433768264085
158.0,DE537L1,Reutlingen,2019,0,109282,109282,0.0
159.0,DE539L1,Cottbus,2019,1444,180836,182280,0.7921878428790872
160.0,DE540L2,Siegen,2019,49,177515,177564,0.027595683809781262
161.0,DE542L1,Hildesheim,2019,116,120694,120810,0.09601854151146429
162.0,DE544L1,Zwickau,2019,46,94758,94804,0.04852115944474916
163.0,DE546L0,Wuppertal,2019,0,16833,16833,0.0
164.0,DE547L2,Jena,2019,1,93067,93068,0.0010744831735935015
165.0,DE548L1,DÃ¼ren,2019,260,93778,94038,0.27648397456347434
166.0,DE549L1,Bocholt,2019,173,142092,142265,0.12160404878220221
167.0,DK001L2,KÃ¸benhavn,2019,13775,277448,291223,4.730052228017705
168.0,DK002L3,Ãrhus,2019,5518,457006,462524,1.1930191730591277
169.0,DK003L2,Odense,2019,8478,351361,359839,2.356053679562249
170.0,DK004L3,Aalborg,2019,2958,617501,620459,0.4767438299710376
171.0,EE001L1,Tallinn,2019,4776,434285,439061,1.087775958238149
172.0,EE002L1,Tartu,2019,1198,298444,299642,0.3998104404589477
173.0,EE003L0,Narva,2019,292,6597,6889,4.2386413122369
174.0,EL001L1,Athina,2019,5111,304276,309387,1.6519763273828572
175.0,EL002L1,Thessaloniki,2019,1483,140636,142119,1.043491721726159
176.0,EL003L1,Patra,2019,665,50925,51590,1.289009497964722
177.0,EL004L1,Irakleio,2019,1084,60300,61384,1.7659324905512839
178.0,EL005L1,Larisa,2019,143,155376,155519,0.09195017972080582
179.0,EL006L1,Volos,2019,279,30537,30816,0.9053738317757009
180.0,EL007L1,Ioannina,2019,2010,130631,132641,1.515368551202117
181.0,EL008L1,Kavala,2019,309,35259,35568,0.8687584345479082
182.0,EL009L1,Kalamata,2019,269,44183,44452,0.6051471249887519
183.0,ES001L3,Madrid,2019,2341,785262,787603,0.29723096534675464
184.0,ES002L2,Barcelona,2019,1306,263301,264607,0.4935621506611692
185.0,ES003L3,Valencia,2019,3089,172031,175120,1.7639333028780266
186.0,ES004L3,Sevilla,2019,4564,463862,468426,0.9743267880092052
187.0,ES005L2,Zaragoza,2019,162,275976,276138,0.058666319014405846
188.0,ES006L2,MÃ¡laga,2019,976,151766,152742,0.6389860025402312
189.0,ES007L2,Murcia,2019,88,120048,120136,0.07325031630818406
190.0,ES008L2,Las Palmas,2019,732,75864,76596,0.9556634811217296
191.0,ES009L2,Valladolid,2019,165,115364,115529,0.14282128296791283
192.0,ES010L2,Palma de Mallorca,2019,2222,202012,204234,1.0879677232977858
193.0,ES011L2,Santiago de Compostela,2019,14,126242,126256,0.011088581928779623
194.0,ES012L2,Vitoria/Gasteiz,2019,1273,158048,159321,0.799015823400556
195.0,ES013L2,Oviedo,2019,0,93487,93487,0.0
196.0,ES014L3,Pamplona/IruÃ±a,2019,63,169451,169514,0.03716507191146454
197.0,ES015L2,Santander,2019,235,69248,69483,0.33821222457291716
198.0,ES016L2,Toledo,2019,464,92934,93398,0.49679864665196255
199.0,ES017L2,Badajoz,2019,714,218035,218749,0.3264014921211068
200.0,ES018L2,LogroÃ±o,2019,16,46122,46138,0.03467857297672201
201.0,ES019L3,Bilbao,2019,723,152598,153321,0.47155966892989215
202.0,ES020L2,CÃ³rdoba,2019,1294,185608,186902,0.692341440969064
203.0,ES021L2,Alicante/Alacant,2019,413,35645,36058,1.1453768927838484
204.0,ES022L2,Vigo,2019,1000,135471,136471,0.7327564097866947
205.0,ES023L2,GijÃ³n,2019,440,52962,53402,0.8239391783079286
206.0,ES025L3,Santa Cruz de Tenerife,2019,1258,65725,66983,1.878088470208859
207.0,ES026L2,CoruÃ±a (A),2019,360,75615,75975,0.47384007897334646
208.0,ES028L1,Reus,2019,0,11534,11534,0.0
209.0,ES031L1,Lugo,2019,10,134001,134011,0.00746207400885002
210.0,ES033L1,Girona,2019,2,39619,39621,0.005047828171929028
211.0,ES034L1,CÃ¡ceres,2019,1945,236328,238273,0.816290557469793
212.0,ES035L1,Torrevieja,2019,1711,7127,8838,19.359583616202762
213.0,ES039L1,AvilÃ©s,2019,171,18971,19142,0.8933235816529099
214.0,ES040L1,Talavera de la Reina,2019,551,82715,83266,0.6617346816227512
215.0,ES041L1,Palencia,2019,2,28379,28381,0.007046968041999929
216.0,ES043L1,Ferrol,2019,733,46237,46970,1.5605705769640197
217.0,ES044L1,Pontevedra,2019,208,51408,51616,0.402975821450713
218.0,ES046L1,Gandia,2019,242,17095,17337,1.3958585683797657
219.0,ES048L1,Guadalajara,2019,3,45380,45383,0.006610404777119186
220.0,ES050L1,Manresa,2019,3,29600,29603,0.010134108029591596
221.0,ES053L1,Ciudad Real,2019,612,95733,96345,0.6352171882297992
222.0,ES054L1,Benidorm,2019,319,20354,20673,1.5430755091181736
223.0,ES057L1,Ponferrada,2019,247,62096,62343,0.396195242449032
224.0,ES059L1,Zamora,2019,327,33853,34180,0.9566998244587479
225.0,ES070L1,Irun,2019,54,7188,7242,0.7456503728251864
226.0,ES072L1,Arrecife,2019,3534,55400,58934,5.996538500695694
227.0,ES501L3,Granada,2019,270,162354,162624,0.1660271546635183
228.0,ES505L1,Elche/Elx,2019,798,38020,38818,2.055747333711165
229.0,ES506L1,Cartagena,2019,1507,59441,60948,2.4725995930957536
230.0,ES508L1,Jerez de la Frontera,2019,167,125939,126106,0.1324282746261082
231.0,ES510L1,Donostia-San SebastiÃ¡n,2019,11,33309,33320,0.033013205282112844
232.0,ES514L1,AlmerÃ­a,2019,750,39980,40730,1.8413945494721333
233.0,ES515L1,Burgos,2019,1,149390,149391,0.0006693843671974885
234.0,ES516L1,Salamanca,2019,17,45627,45644,0.03724476382437999
235.0,ES519L1,Albacete,2019,9,245316,245325,0.003668602873738918
236.0,ES520L1,CastellÃ³n/CastellÃ³,2019,344,32450,32794,1.0489723729950602
237.0,ES521L1,Huelva,2019,3826,93594,97420,3.927324984602751
238.0,ES522L1,CÃ¡diz,2019,1468,23365,24833,5.911488744815366
239.0,ES523L1,LeÃ³n,2019,1,118886,118887,0.0008411348591519679
240.0,ES525L1,Tarragona,2019,444,21296,21740,2.0423183072677094
241.0,ES527L1,JaÃ©n,2019,31,99900,99931,0.03102140476929081
242.0,ES528L1,Lleida,2019,108,70567,70675,0.1528121683763707
243.0,ES529L1,Ourense,2019,203,64965,65168,0.31150257795236924
244.0,ES532L1,Algeciras,2019,570,41724,42294,1.3477088948787064
245.0,ES533L1,Marbella,2019,569,68636,69205,0.8221949281121306
246.0,ES537L1,Alcoy,2019,0,20529,20529,0.0
247.0,ES538L1,Ãvila,2019,472,53174,53646,0.8798419267046936
248.0,ES542L1,Cuenca,2019,83,164499,164582,0.050430788300057115
249.0,ES543L1,Eivissa,2019,2052,57350,59402,3.4544291437998718
250.0,ES544L1,Linares,2019,14,25762,25776,0.05431409062693979
251.0,ES545L1,Lorca,2019,152,182055,182207,0.08342160290219366
252.0,ES546L1,MÃ©rida,2019,884,127415,128299,0.6890155028488141
253.0,ES547L1,Sagunto,2019,204,15324,15528,1.313755795981453
254.0,ES550L1,Puerto de la Cruz,2019,1362,26110,27472,4.957775189283634
255.0,ES552L1,Igualada,2019,2,25424,25426,0.007865963973884999
256.0,FI001L3,Helsinki,2019,12124,479394,491518,2.4666441513840796
257.0,FI002L3,Tampere,2019,76308,612335,688643,11.080922916518428
258.0,FI003L4,Turku,2019,19971,446473,466444,4.28154290761592
259.0,FI004L4,Oulu,2019,6886,716935,723821,0.9513401794089975
260.0,FI007L2,Lahti,2019,21890,313513,335403,6.526477103663354
261.0,FI008L2,Kuopio,2019,111176,809230,920406,12.079017303233574
262.0,FI009L2,JyvÃ¤skylÃ¤,2019,30514,446428,476942,6.397842924296874
263.0,FR001L1,Paris,2019,1094,1208858,1209952,0.09041680992303827
264.0,FR003L2,Lyon,2019,838,366393,367231,0.22819424286076068
265.0,FR004L2,Toulouse,2019,284,524388,524672,0.054129055867284705
266.0,FR006L2,Strasbourg,2019,1603,202280,203883,0.78623524276178
267.0,FR007L2,Bordeaux,2019,5054,550700,555754,0.9093951640474022
268.0,FR008L2,Nantes,2019,2096,314523,316619,0.6619943844178651
269.0,FR009L2,Lille,2019,32,144421,144453,0.02215253404221442
270.0,FR010L2,Montpellier,2019,7317,216601,223918,3.267714073902053
271.0,FR011L2,Saint-Etienne,2019,102,180953,181055,0.05633647234265831
272.0,FR012L2,Le Havre,2019,834,75604,76438,1.0910803527041524
273.0,FR013L2,Rennes,2019,152,381985,382137,0.03977631059018101
274.0,FR014L2,Amiens,2019,8,244787,244795,0.0032680406054045224
275.0,FR016L2,Nancy,2019,54,283455,283509,0.019047014380495858
276.0,FR017L2,Metz,2019,291,176639,176930,0.1644718250155429
277.0,FR018L2,Reims,2019,10,243141,243151,0.0041126707272435645
278.0,FR019L2,OrlÃ©ans,2019,373,291594,291967,0.12775416399798606
279.0,FR020L2,Dijon,2019,147,385614,385761,0.03810649599104109
280.0,FR021L2,Poitiers,2019,45,250397,250442,0.01796823216553134
281.0,FR022L2,Clermont-Ferrand,2019,16,266110,266126,0.006012189714646446
282.0,FR023L2,Caen,2019,181,226092,226273,0.07999186822997
283.0,FR024L2,Limoges,2019,279,317555,317834,0.08778167219366084
284.0,FR025L2,BesanÃ§on,2019,52,238984,239036,0.02175404541575328
285.0,FR026L2,Grenoble,2019,958,264890,265848,0.36035629382203366
286.0,FR027L2,Ajaccio,2019,1473,145536,147009,1.0019794706446543
289.0,FR032L2,Toulon,2019,2163,104893,107056,2.020437901658945
290.0,FR034L2,Valenciennes,2019,19,78427,78446,0.02422048287994289
291.0,FR035L2,Tours,2019,476,284372,284848,0.1671066674156041
292.0,FR036L2,Angers,2019,577,230674,231251,0.24951243454082359
293.0,FR037L2,Brest,2019,303,134691,134994,0.22445442019645317
294.0,FR038L2,Le Mans,2019,92,224019,224111,0.04105108629206063
295.0,FR039L1,Avignon,2019,1471,85754,87225,1.686443106907423
296.0,FR040L2,Mulhouse,2019,363,129403,129766,0.2797342909544873
297.0,FR042L2,Dunkerque,2019,564,90561,91125,0.6189300411522634
298.0,FR043L2,Perpignan,2019,1561,181469,183030,0.8528656504398185
299.0,FR044L2,NÃ®mes,2019,1377,149114,150491,0.9150048840129975
300.0,FR045L2,Pau,2019,65,201694,201759,0.032216654523466115
301.0,FR046L2,Bayonne,2019,876,101754,102630,0.8535515931014324
302.0,FR047L0,Annemasse,2019,1,7799,7800,0.01282051282051282
303.0,FR048L2,Annecy,2019,2093,116950,119043,1.758188217702847
304.0,FR049L2,Lorient,2019,401,112781,113182,0.3542966196038239
305.0,FR050L2,MontbÃ©liard,2019,75,122982,123057,0.06094736585484775
306.0,FR051L2,Troyes,2019,430,260520,260950,0.16478252538800536
307.0,FR052L2,Saint-Nazaire,2019,326,106809,107135,0.3042889811919541
308.0,FR053L2,La Rochelle,2019,235,111105,111340,0.2110652056763068
309.0,FR056L2,AngoulÃªme,2019,11,214281,214292,0.005133182759972374
310.0,FR057L2,Boulogne-sur-Mer,2019,130,68408,68538,0.18967580028597275
311.0,FR058L2,ChambÃ©ry,2019,2261,99428,101689,2.223445997108832
312.0,FR059L2,Chalon-sur-SaÃ´ne,2019,253,156105,156358,0.16180815820105143
313.0,FR060L2,Chartres,2019,16,161344,161360,0.00991571641051066
314.0,FR061L2,Niort,2019,5,178914,178919,0.0027945606671175224
315.0,FR062L2,Calais,2019,52,50178,50230,0.10352379056340832
316.0,FR063L2,BÃ©ziers,2019,464,84679,85143,0.5449655285813279
317.0,FR064L2,Arras,2019,1,107562,107563,0.000929687717895559
318.0,FR065L2,Bourges,2019,0,250319,250319,0.0
319.0,FR066L2,Saint-Brieuc,2019,96,115085,115181,0.08334707981351092
320.0,FR067L2,Quimper,2019,489,121433,121922,0.4010760978330408
321.0,FR068L2,Vannes,2019,587,120447,121034,0.4849876894095874
322.0,FR069L2,Cherbourg,2019,353,90365,90718,0.38911792588020017
323.0,FR073L2,Tarbes,2019,82,104247,104329,0.0785975136347516
324.0,FR074L2,CompiÃ¨gne,2019,212,98525,98737,0.21471181016235047
325.0,FR076L2,Belfort,2019,119,65500,65619,0.18134991389688962
326.0,FR077L2,Roanne,2019,83,123117,123200,0.06737012987012987
327.0,FR079L2,Saint-Quentin,2019,24,99350,99374,0.024151186427033226
328.0,FR082L2,Beauvais,2019,6,131136,131142,0.004575193301917006
329.0,FR084L2,Creil,2019,75,29568,29643,0.25301082886347537
330.0,FR086L2,Evreux,2019,4,126566,126570,0.0031603065497353244
331.0,FR090L2,ChÃ¢teauroux,2019,108,261069,261177,0.041351267531214465
332.0,FR093L2,Brive-la-Gaillarde,2019,0,132582,132582,0.0
333.0,FR096L2,Albi,2019,2,134236,134238,0.001489891088961397
334.0,FR099L2,FrÃ©jus,2019,431,43982,44413,0.9704365838830973
335.0,FR104L2,ChÃ¢lons-en-Champagne,2019,46,152763,152809,0.030102938963019195
336.0,FR203L2,Marseille,2019,2808,422968,425776,0.6595017098192477
337.0,FR205L2,Nice,2019,991,306349,307340,0.3224441986074055
338.0,FR207L2,Lens - LiÃ©vin,2019,25,25283,25308,0.09878299351983562
339.0,FR208L1,HÃ©nin - Carvin,2019,3,11595,11598,0.02586652871184687
340.0,FR209L2,Douai,2019,17,45067,45084,0.037707390648567124
341.0,FR214L1,Valence,2019,499,90462,90961,0.5485867569617748
342.0,FR215L2,Rouen,2019,806,286320,287126,0.2807129970814207
343.0,FR304L1,Melun,2019,35,44801,44836,0.07806227138906235
344.0,FR324L1,Martigues,2019,1668,18788,20456,8.154086820492765
345.0,FR505L1,Charleville-MÃ©ziÃ¨res,2019,26,135343,135369,0.019206760779794486
346.0,FR506L1,Colmar,2019,118,101867,101985,0.11570328969946561
347.0,FR519L1,Cannes,2019,495,19641,20136,2.458283671036949
348.0,HR001L2,Grad Zagreb,2019,64,505804,505868,0.012651521740849391
349.0,HR002L2,Rijeka,2019,645,106589,107234,0.601488333923942
350.0,HR003L2,Slavonski Brod,2019,443,97387,97830,0.45282633139118883
351.0,HR004L2,Osijek,2019,1513,171421,172934,0.874900250962795
352.0,HR005L2,Split,2019,3115,335955,339070,0.9186893561801399
353.0,HR006L1,Pula - Pola,2019,1266,57631,58897,2.149515255445948
354.0,HR007L1,Zadar,2019,2492,154008,156500,1.5923322683706072
355.0,HU001L2,Budapest,2019,7331,631803,639134,1.147020812536964
356.0,HU002L2,Miskolc,2019,7,164662,164669,0.004250951909588326
357.0,HU003L2,NyÃ­regyhÃ¡za,2019,124,168101,168225,0.07371080398276118
358.0,HU004L2,PÃ©cs,2019,99,185389,185488,0.053372724920210474
359.0,HU005L2,Debrecen,2019,377,201201,201578,0.18702437766026056
360.0,HU006L2,Szeged,2019,683,160250,160933,0.42440021623905605
361.0,HU007L2,GyÃµr,2019,490,204150,204640,0.23944487881157156
362.0,HU008L2,KecskemÃ©t,2019,56,182083,182139,0.03074574912566776
363.0,HU009L2,SzÃ©kesfehÃ©rvÃ¡r,2019,1782,299341,301123,0.5917847524101447
364.0,HU010L1,Szombathely,2019,0,134277,134277,0.0
365.0,HU011L1,Szolnok,2019,631,143344,143975,0.4382705330786595
366.0,HU012L1,TatabÃ¡nya,2019,164,69666,69830,0.2348560790491193
367.0,HU013L1,VeszprÃ©m,2019,7140,124180,131320,5.437100213219616
368.0,HU014L1,BÃ©kÃ©scsaba,2019,45,106118,106163,0.04238764918097643
369.0,HU015L1,KaposvÃ¡r,2019,0,145560,145560,0.0
370.0,HU016L1,Eger,2019,9,100569,100578,0.008948278947682395
371.0,HU017L1,DunaÃºjvÃ¡ros,2019,815,60855,61670,1.3215501864764068
372.0,HU018L1,Zalaegerszeg,2019,200,139779,139979,0.14287857464333936
373.0,HU019L1,Sopron,2019,263,80407,80670,0.326019585967522
374.0,IE001L1,Dublin,2019,53276,650326,703602,7.571894337992218
375.0,IE002L1,Cork,2019,1912,327751,329663,0.5799862283604772
376.0,IE003L1,Limerick,2019,210,156248,156458,0.13422132457272878
377.0,IE004L1,Galway,2019,12420,213863,226283,5.48870220034205
378.0,IE005L1,Waterford,2019,2215,93642,95857,2.310733697069593
379.0,IS001L1,ReykjavÃ­k,2019,160605,1136625,1297230,12.380610994195324
380.0,IT001L3,Roma,2019,8941,608275,617216,1.4486014620489425
381.0,IT002L3,Milano,2019,64,383981,384045,0.016664713770521682
382.0,IT003L3,Napoli,2019,2947,149995,152942,1.926874239907939
383.0,IT004L2,Torino,2019,96,170083,170179,0.056411190569929305
384.0,IT005L3,Palermo,2019,1520,148553,150073,1.0128404176634038
385.0,IT006L3,Genova,2019,652,120112,120764,0.5398959954953463
386.0,IT007L3,Firenze,2019,103,163668,163771,0.0628926977303674
387.0,IT008L3,Bari,2019,731,112698,113429,0.644456003314849
388.0,IT009L1,Bologna,2019,54,185203,185257,0.029148696135638596
389.0,IT010L2,Catania,2019,522,60903,61425,0.8498168498168498
390.0,IT011L2,Venezia,2019,1851,65186,67037,2.7611617464982023
391.0,IT012L3,Verona,2019,62,73099,73161,0.08474460436571397
392.0,IT013L3,Cremona,2019,263,60134,60397,0.43545209199132406
393.0,IT014L3,Trento,2019,621,97566,98187,0.6324666198172875
394.0,IT015L1,Trieste,2019,325,21312,21637,1.502056662199011
395.0,IT016L3,Perugia,2019,5762,125266,131028,4.397533351650029
396.0,IT017L3,Ancona,2019,552,43691,44243,1.2476549962705965
397.0,IT019L2,Pescara,2019,254,16189,16443,1.5447302803624643
398.0,IT020L3,Campobasso,2019,277,102558,102835,0.26936354354062336
399.0,IT021L2,Caserta,2019,1,9341,9342,0.010704345964461572
400.0,IT022L2,Taranto,2019,3426,103502,106928,3.204025138410893
401.0,IT023L2,Potenza,2019,87,138368,138455,0.06283630060308404
402.0,IT024L3,Catanzaro,2019,289,89794,90083,0.3208152481600302
403.0,IT025L3,Reggio di Calabria,2019,586,47662,48248,1.2145581163986072
404.0,IT026L3,Sassari,2019,2266,150959,153225,1.4788709414260075
405.0,IT027L2,Cagliari,2019,4869,190423,195292,2.4931896851893574
406.0,IT028L3,Padova,2019,5,61440,61445,0.008137358613394093
407.0,IT029L3,Brescia,2019,73,60196,60269,0.12112362906303406
408.0,IT030L3,Modena,2019,139,69129,69268,0.20066986198533235
409.0,IT031L3,Foggia,2019,4,89707,89711,0.004458762024723836
410.0,IT032L3,Salerno,2019,325,37514,37839,0.8589021908612807
411.0,IT033L2,Piacenza,2019,306,93821,94127,0.32509269391354234
412.0,IT034L1,Bolzano,2019,809,105947,106756,0.7578028401213983
413.0,IT035L2,Udine,2019,0,71830,71830,0.0
414.0,IT036L2,La Spezia,2019,691,42228,42919,1.6100095528786784
415.0,IT037L1,Lecce,2019,340,61170,61510,0.5527556494878881
416.0,IT038L1,Barletta,2019,231,14866,15097,1.5301053189375373
417.0,IT039L2,Pesaro,2019,115,25576,25691,0.4476275738585497
418.0,IT040L2,Como,2019,1012,18729,19741,5.126386707866876
419.0,IT041L2,Pisa,2019,476,47577,48053,0.990572909079558
420.0,IT042L1,Treviso,2019,31,24014,24045,0.1289249324183822
421.0,IT043L2,Varese,2019,509,23155,23664,2.150946585530764
422.0,IT045L2,Asti,2019,16,54820,54836,0.029177912320373478
423.0,IT046L2,Pavia,2019,148,36056,36204,0.40879460833057124
424.0,IT047L1,Massa,2019,253,10990,11243,2.250289068753891
425.0,IT048L2,Cosenza,2019,649,91830,92479,0.7017809448631581
426.0,IT052L1,Savona,2019,181,28524,28705,0.6305521686117401
427.0,IT054L1,Matera,2019,587,77202,77789,0.7546054069341424
428.0,IT056L1,Acireale,2019,52,5936,5988,0.8684034736138945
429.0,IT057L2,Avellino,2019,5,39754,39759,0.012575769008274857
430.0,IT058L2,Pordenone,2019,5,37045,37050,0.013495276653171389
431.0,IT060L1,Lecco,2019,1249,28963,30212,4.134118893155038
432.0,IT061L0,Altamura,2019,0,42800,42800,0.0
433.0,IT064L1,Battipaglia,2019,53,6433,6486,0.8171446191797719
434.0,IT065L0,Bisceglie,2019,85,6859,6944,1.224078341013825
435.0,IT066L1,Carpi,2019,12,20610,20622,0.05819028222286878
436.0,IT067L0,Cerignola,2019,127,58770,58897,0.21563067728407218
437.0,IT068L1,Gallarate,2019,0,5319,5319,0.0
438.0,IT069L1,Gela,2019,409,57486,57895,0.7064513343121167
439.0,IT073L1,Sassuolo,2019,2,24060,24062,0.00831186102568365
440.0,IT501L2,Messina,2019,773,33670,34443,2.2442876636762183
441.0,IT502L2,Prato,2019,5,40954,40959,0.012207329280500013
442.0,IT503L3,Parma,2019,126,113381,113507,0.11100636965121094
443.0,IT504L3,Livorno,2019,347,25467,25814,1.3442318121949328
444.0,IT505L3,Reggio nell'Emilia,2019,1,69033,69034,0.0014485615783526957
445.0,IT506L2,Ravenna,2019,3464,77725,81189,4.26658783825395
446.0,IT507L2,Ferrara,2019,852,90631,91483,0.9313205732212542
447.0,IT508L3,Rimini,2019,289,32290,32579,0.8870744958408792
448.0,IT509L3,Siracusa,2019,544,33598,34142,1.593345439634468
449.0,IT511L2,Bergamo,2019,0,18556,18556,0.0
450.0,IT512L3,ForlÃ¬,2019,0,72751,72751,0.0
451.0,IT513L3,Latina,2019,527,65966,66493,0.7925646308633991
452.0,IT514L2,Vicenza,2019,1,34981,34982,0.0028586130009719286
453.0,IT515L2,Terni,2019,146,102186,102332,0.14267286870187232
454.0,IT516L2,Novara,2019,4,54161,54165,0.007384842610541863
455.0,IT518L1,Alessandria,2019,85,76829,76914,0.11051304053878357
456.0,IT519L1,Arezzo,2019,1,88626,88627,0.0011283243255441344
457.0,IT520L1,Grosseto,2019,444,119155,119599,0.3712405622120586
458.0,IT521L1,Brindisi,2019,817,63170,63987,1.276821854439183
459.0,IT522L1,Trapani,2019,943,49847,50790,1.8566646977751524
460.0,IT523L1,Ragusa,2019,257,52593,52850,0.4862819299905393
461.0,IT524L0,Andria,2019,0,39880,39880,0.0
462.0,IT525L0,Trani,2019,114,10265,10379,1.0983717121109933
463.0,IT526L1,L'Aquila,2019,323,139946,140269,0.2302718348316449
464.0,LT001L1,Vilnius,2019,2102,422467,424569,0.4950903151195683
465.0,LT002L1,Kaunas,2019,153,161898,162051,0.09441472129144529
466.0,LT003L1,PanevÄÅ¾ys,2019,11,222797,222808,0.0049369861046282
467.0,LT004L0,Alytus,2019,1,3958,3959,0.025258903763576663
468.0,LT501L0,KlaipÄda,2019,91,8832,8923,1.0198363778998096
469.0,LT502L0,Å iauliai,2019,1048,6997,8045,13.02672467371038
470.0,LU001L1,Luxembourg,2019,122,259593,259715,0.04697456827676492
471.0,LV001L1,RÄ«ga,2019,8644,607605,616249,1.4026797609407886
472.0,LV002L2,LiepÄja,2019,2953,269104,272057,1.0854343023704591
473.0,LV003L1,Jelgava,2019,57,166402,166459,0.03424266636228741
474.0,LV501L1,Daugavpils,2019,1922,257753,259675,0.7401559641860017
475.0,ME001L1,Podgorica,2019,1283,183198,184481,0.6954645735875239
476.0,MK001L1,Skopje,2019,4,224349,224353,0.0017829046190601418
477.0,MK003L1,Bitola,2019,5,119657,119662,0.0041784359278634825
478.0,MK004L1,Tetovo,2019,1,105620,105621,0.0009467814165743554
479.0,MK005L1,Prilep,2019,95,86736,86831,0.10940793034745655
480.0,MT001L1,Valletta,2019,944,25012,25956,3.6369240252735398
481.0,NL001L3,s' Gravenhage,2019,3282,39425,42707,7.684922846371789
482.0,NL002L3,Amsterdam,2019,67495,265462,332957,20.271386395240228
483.0,NL003L3,Rotterdam,2019,26875,190296,217171,12.375040866414023
484.0,NL004L3,Utrecht,2019,389,96898,97287,0.399847872788759
485.0,NL005L3,Eindhoven,2019,258,144148,144406,0.1786629364430841
486.0,NL006L3,Tilburg,2019,61,43173,43234,0.1410926585557663
487.0,NL007L3,Groningen,2019,3234,204926,208160,1.5536126056879322
488.0,NL008L3,Enschede,2019,75,84881,84956,0.08828099251377183
489.0,NL009L3,Arnhem,2019,270,55628,55898,0.4830226483952914
490.0,NL010L3,Heerlen,2019,15,33328,33343,0.04498695378340281
491.0,NL012L3,Breda,2019,1106,72264,73370,1.5074281041297533
492.0,NL013L3,Nijmegen,2019,610,39226,39836,1.5312782407872276
493.0,NL014L3,Apeldoorn,2019,9,71115,71124,0.012653956470389742
494.0,NL015L3,Leeuwarden,2019,649,110274,110923,0.5850905583152276
495.0,NL016L3,Sittard-Geleen,2019,70,22842,22912,0.3055167597765363
496.0,NL020L3,Roosendaal,2019,6,24568,24574,0.024416049483193623
497.0,NL026L0,Alphen aan den Rijn,2019,1,13209,13210,0.00757002271006813
498.0,NL028L3,Bergen op Zoom,2019,1754,33027,34781,5.042983237974756
499.0,NL030L0,Gouda,2019,4,1784,1788,0.22371364653243847
500.0,NL032L3,MiddelburgÂ Â Â Â Â Â ,2019,1068,22320,23388,4.56644433042586
501.0,NL503L3,s-Hertogenbosch,2019,542,36317,36859,1.4704685422827533
502.0,NL504L3,Amersfoort,2019,1,12243,12244,0.008167265599477294
503.0,NL505L3,Maastricht,2019,52,20333,20385,0.2550895266127054
504.0,NL507L3,Leiden,2019,80,19701,19781,0.4044284919872605
505.0,NL511L3,Zwolle,2019,374,122646,123020,0.3040156072183385
506.0,NL512L3,Ede,2019,3,35262,35265,0.008507018290089324
507.0,NL513L3,Deventer,2019,1,25244,25245,0.003961180431768667
508.0,NL514L3,Alkmaar,2019,287,47505,47792,0.6005189152996318
509.0,NL515L3,Venlo,2019,555,50681,51236,1.0832227340151455
510.0,NL519L3,Almelo,2019,1,42024,42025,0.002379535990481856
511.0,NL520L3,Lelystad,2019,57076,61766,118842,48.026791874926374
512.0,NL521L3,Oss,2019,165,32981,33146,0.49779762263923244
513.0,NL522L3,Assen,2019,24,70838,70862,0.03386864610087212
514.0,NL524L3,Veenendaal,2019,9,8176,8185,0.10995723885155771
515.0,NL529L3,Soest,2019,1,7941,7942,0.012591286829513975
516.0,NO001L1,Oslo,2019,22386,724257,746643,2.9982200328671134
517.0,NO002L1,Bergen,2019,10213,347530,357743,2.854842722289465
518.0,NO003L1,Trondheim,2019,17978,655278,673256,2.670306688688998
519.0,NO004L1,Stavanger,2019,13465,275612,289077,4.657928510396884
520.0,NO005L1,Kristiansand,2019,7863,307599,315462,2.4925347585446107
521.0,NO006L1,TromsÃ¸,2019,45009,329604,374613,12.014799272849581
522.0,PL001L2,Warszawa,2019,2713,858530,861243,0.31500981720606147
523.0,PL002L2,ÅÃ³dÅº,2019,28,169472,169500,0.016519174041297935
524.0,PL003L2,KrakÃ³w,2019,404,375344,375748,0.10751886902924301
525.0,PL004L2,WrocÅaw,2019,830,263870,264700,0.31356252361163583
526.0,PL005L2,PoznaÅ,2019,795,308533,309328,0.2570087415300264
527.0,PL006L2,GdaÅsk,2019,1679,261837,263516,0.6371529622489716
528.0,PL007L2,Szczecin,2019,1747,111313,113060,1.5451972404033256
529.0,PL008L2,Bydgoszcz,2019,856,209280,210136,0.40735523660867246
530.0,PL009L2,Lublin,2019,128,322656,322784,0.03965500148706256
531.0,PL010L2,Katowice,2019,2854,391741,394595,0.7232732295138053
532.0,PL011L2,BiaÅystok,2019,34,223288,223322,0.015224653191355977
533.0,PL012L2,Kielce,2019,49,224180,224229,0.02185265955786272
534.0,PL013L2,ToruÅ,2019,1029,157904,158933,0.6474426330592137
535.0,PL014L2,Olsztyn,2019,2097,200447,202544,1.0353305948337153
536.0,PL015L2,RzeszÃ³w,2019,71,229278,229349,0.03095718751771318
537.0,PL016L2,Opole,2019,1499,175117,176616,0.8487339765366672
538.0,PL017L2,GorzÃ³w Wielkopolski,2019,118,97302,97420,0.12112502566208172
539.0,PL018L2,Zielona GÃ³ra,2019,110,169174,169284,0.06497956097445712
540.0,PL019L2,Jelenia GÃ³ra,2019,144,83197,83341,0.17278410386244464
541.0,PL020L2,Nowy SÄcz,2019,901,129517,130418,0.6908555567483017
542.0,PL021L2,SuwaÅki,2019,395,71738,72133,0.5475995730109658
543.0,PL022L2,Konin,2019,888,117275,118163,0.7515042779888798
544.0,PL024L2,CzÄstochowa,2019,40,193858,193898,0.020629403088221643
545.0,PL025L2,Radom,2019,2,68020,68022,0.002940225221251948
546.0,PL026L2,PÅock,2019,2283,168792,171075,1.3345024112231478
547.0,PL027L2,Kalisz,2019,44,148979,149023,0.02952564369258437
548.0,PL028L2,Koszalin,2019,89,129582,129671,0.06863523841105568
549.0,PL029L1,SÅupsk,2019,7752,227252,235004,3.298667256727545
550.0,PL030L1,JastrzÄbie-ZdrÃ³j,2019,20,29551,29571,0.06763383044198708
551.0,PL031L1,Siedlce,2019,17,126152,126169,0.013473991233979821
552.0,PL032L1,PiotrkÃ³w Trybunalski,2019,149,116773,116922,0.1274353842732762
553.0,PL033L1,Lubin,2019,176,93130,93306,0.18862666923884852
554.0,PL034L1,PiÅa,2019,6,52186,52192,0.011496014714898835
555.0,PL035L1,InowrocÅaw,2019,4,20124,20128,0.01987281399046105
556.0,PL036L1,Ostrowiec ÅwiÄtokrzyski,2019,0,61460,61460,0.0
557.0,PL037L1,Gniezno,2019,72,66499,66571,0.10815520271589732
558.0,PL038L1,Stargard SzczeciÅski,2019,1980,34684,36664,5.400392755836788
559.0,PL039L1,OstrÃ³w Wielkopolski,2019,139,84622,84761,0.1639905145054919
560.0,PL040L1,PrzemyÅl,2019,360,84729,85089,0.4230864154003455
561.0,PL041L1,ZamoÅÄ,2019,111,112596,112707,0.09848545343235116
562.0,PL042L1,CheÅm,2019,124,46446,46570,0.2662658363753489
563.0,PL043L1,Pabianice,2019,3,32956,32959,0.009102217907096696
564.0,PL044L1,GÅogÃ³w,2019,1,64080,64081,0.0015605249605967447
565.0,PL045L1,Stalowa Wola,2019,169,190144,190313,0.08880108032556894
566.0,PL046L1,TomaszÃ³w Mazowiecki,2019,569,18594,19163,2.969263685226739
567.0,PL047L1,ÅomÅ¼a,2019,2,56000,56002,0.003571301024963394
568.0,PL048L1,Leszno,2019,196,77376,77572,0.25266848862991803
569.0,PL049L1,Åwidnica,2019,10,47980,47990,0.02083767451552407
570.0,PL051L1,Tczew,2019,103,27021,27124,0.37973750184338595
571.0,PL052L1,EÅk,2019,1278,38774,40052,3.1908518925396985
572.0,PL506L2,Bielsko-BiaÅa,2019,497,72938,73435,0.6767889970722408
573.0,PL508L1,Rybnik,2019,61,14820,14881,0.4099186882601975
574.0,PL511L2,WaÅbrzych,2019,2,51508,51510,0.0038827412152980007
575.0,PL512L2,ElblÄg,2019,12,96463,96475,0.012438455558434829
576.0,PL513L2,WÅocÅawek,2019,1374,121105,122479,1.121824965912524
577.0,PL514L2,TarnÃ³w,2019,330,124997,125327,0.26331117795846065
578.0,PL516L2,Legnica,2019,35,56465,56500,0.061946902654867256
579.0,PL517L2,GrudziÄdz,2019,60,54983,55043,0.10900568646331049
580.0,PT001L3,Lisboa,2019,7520,431761,439281,1.7118882901832766
581.0,PT002L2,Porto,2019,1114,94626,95740,1.1635679966576142
582.0,PT003L1,Braga,2019,45,49304,49349,0.0911872581004681
583.0,PT004L2,Funchal,2019,640,35322,35962,1.779656303876314
584.0,PT005L2,Coimbra,2019,456,162331,162787,0.28012064845472917
585.0,PT007L1,Ponta Delgada,2019,1548,53746,55294,2.7995804246392013
586.0,PT008L2,Aveiro,2019,1911,41419,43330,4.410339256865912
587.0,PT009L1,Faro,2019,2523,46627,49150,5.133265513733469
588.0,PT014L1,Viseu,2019,5,70869,70874,0.007054773259587437
589.0,PT016L0,Viana do Castelo,2019,396,31856,32252,1.227830832196453
590.0,PT019L0,PÃ³voa de Varzim,2019,33,8373,8406,0.39257673090649536
591.0,PT505L1,GuimarÃ£es,2019,1,26540,26541,0.0037677555480200445
592.0,RO001L1,BucureÅti,2019,800,107042,107842,0.7418260047105951
593.0,RO002L1,Cluj-Napoca,2019,17,59285,59302,0.028666824053151664
594.0,RO003L1,TimiÅoara,2019,1,23653,23654,0.00422761477974127
595.0,RO004L1,Craiova,2019,39,34357,34396,0.1133852773578323
596.0,RO005L1,BrÄila,2019,1212,22317,23529,5.151090144077521
597.0,RO006L1,Oradea,2019,64,20275,20339,0.31466640444466293
598.0,RO007L1,BacÄu,2019,134,21959,22093,0.6065269542388992
599.0,RO008L1,Arad,2019,40,51568,51608,0.07750736319950395
600.0,RO009L1,Sibiu,2019,8,56332,56340,0.014199503017394392
601.0,RO010L1,TÃ¢rgu MureÅ,2019,22,13718,13740,0.16011644832605532
602.0,RO011L1,Piatra NeamÅ£,2019,28,14971,14999,0.18667911194079606
603.0,RO012L1,CÇlÇraÅi,2019,561,23983,24544,2.2856910039113427
604.0,RO013L1,Giurgiu,2019,536,10414,10950,4.894977168949772
605.0,RO014L1,Alba Iulia,2019,23,25979,26002,0.08845473425121145
606.0,RO015L1,FocÅani,2019,4,27098,27102,0.014759058372075862
607.0,RO016L1,TÃ¢rgu Jiu,2019,1,24521,24522,0.00407797080172906
608.0,RO017L1,Tulcea,2019,1954,38993,40947,4.772022370381224
609.0,RO018L1,TÃ¢rgoviÅte,2019,1,20256,20257,0.004936565137976996
610.0,RO019L1,Slatina,2019,164,6959,7123,2.3024006738733678
611.0,RO020L1,BÃ¢rlad,2019,7,26312,26319,0.026596755195866104
612.0,RO021L1,Roman,2019,0,14390,14390,0.0
613.0,RO022L1,BistriÅ£a,2019,7,42624,42631,0.01641997607374915
614.0,RO501L1,Constanta,2019,5848,53503,59351,9.853245943623527
615.0,RO502L1,Iasi,2019,111,79825,79936,0.13886108887109688
616.0,RO503L1,Galati,2019,2533,38699,41232,6.143286767559177
617.0,RO504L1,Brasov,2019,96,98407,98503,0.09745896064079267
618.0,RO505L1,Ploiesti,2019,24,34313,34337,0.06989544805894515
619.0,RO506L1,Pitesti,2019,197,24687,24884,0.7916733644108664
620.0,RO507L1,Baia Mare,2019,12,52529,52541,0.022839306446394245
621.0,RO508L1,Buzau,2019,18,38522,38540,0.0467047223663726
622.0,RO509L1,Satu Mare,2019,1,70843,70844,0.0014115521427361527
623.0,RO510L1,Botosani,2019,168,37172,37340,0.4499196572040707
624.0,RO511L1,Ramnicu Valcea,2019,403,28770,29173,1.3814143214616255
625.0,RO512L1,Suceava,2019,103,39575,39678,0.2595896970613438
626.0,RO513L1,Drobeta-Turnu Severin,2019,2152,30782,32934,6.5342806825772755
627.0,RS001L1,Beograd,2019,6641,306383,313024,2.1215625638928644
628.0,RS002L1,Novi Sad,2019,2700,186743,189443,1.4252308082114409
629.0,RS003L1,NiÅ¡,2019,55,341509,341564,0.016102399550303896
630.0,RS004L1,Kragujevac,2019,227,143848,144075,0.1575568280409509
631.0,RS005L1,Subotica,2019,135,160157,160292,0.08422129613455444
632.0,RS006L1,Novi Pazar,2019,10,140781,140791,0.007102726736794254
633.0,RS008L1,Zrenjanin,2019,961,184170,185131,0.5190918862859273
634.0,RS009L1,Kraljevo,2019,0,176512,176512,0.0
635.0,RS011L0,ÄaÄak,2019,1,63686,63687,0.0015701791574418641
636.0,RS012L1,KruÅ¡evac,2019,0,122649,122649,0.0
637.0,RS013L1,Leskovac,2019,4,166278,166282,0.002405552014048424
638.0,RS014L1,Valjevo,2019,22,141640,141662,0.015529923338651155
639.0,RS015L1,Vranje,2019,4,195352,195356,0.0020475439710067773
640.0,RS016L1,Smederevo,2019,2819,157405,160224,1.759411823447174
641.0,SE001L1,Stockholm,2019,64981,690745,755726,8.598486753135395
642.0,SE002L1,GÃ¶teborg,2019,16540,418719,435259,3.8000363002258424
643.0,SE003L1,MalmÃ¶,2019,2589,185427,188016,1.3770104671942813
644.0,SE004L1,JÃ¶nkÃ¶ping,2019,46733,300458,347191,13.460314351466485
645.0,SE005L1,UmeÃ¥,2019,23767,964482,988249,2.404960693104673
646.0,SE006L1,Uppsala,2019,12498,685029,697527,1.7917585985918825
647.0,SE007L1,LinkÃ¶ping,2019,19889,403307,423196,4.699713607879091
648.0,SE008L1,Ãrebro,2019,20646,347951,368597,5.601239293862945
649.0,SE501L1,VÃ¤sterÃ¥s,2019,17707,272708,290415,6.097136855878657
650.0,SE502L1,NorrkÃ¶ping,2019,12616,299122,311738,4.046988175968281
651.0,SE503L1,Helsingborg,2019,911,113511,114422,0.7961755606439321
652.0,SE505L1,BorÃ¥s,2019,1639,95723,97362,1.683408311250796
653.0,SI001L2,Ljubljana,2019,644,232643,233287,0.27605481659929615
654.0,SI002L1,Maribor,2019,594,216391,216985,0.2737516418185589
655.0,SK001L1,Bratislava,2019,1332,203609,204941,0.649943154371258
656.0,SK002L1,KoÅ¡ice,2019,26,177608,177634,0.014636837542362384
657.0,SK003L1,BanskÃ¡ Bystrica,2019,3,80877,80880,0.0037091988130563795
658.0,SK004L1,Nitra,2019,2,87125,87127,0.0022954996728912964
659.0,SK005L1,PreÅ¡ov,2019,4,93295,93299,0.0042872913964779906
660.0,SK006L1,Å½ilina,2019,65,81383,81448,0.07980552008643552
661.0,SK007L1,Trnava,2019,107,74113,74220,0.1441659929938022
662.0,SK008L1,TrenÄÃ­n,2019,29,67394,67423,0.04301202853625617
739.0,UK001L3,London,2019,1654,696516,698170,0.23690505177822022
740.0,UK002L3,West Midlands urban area,2019,98,215211,215309,0.04551597935989671
741.0,UK003L2,Leeds,2019,526,511901,512427,0.10264876753176551
742.0,UK004L1,Glasgow,2019,2000,335684,337684,0.5922696959287381
743.0,UK006L3,Liverpool,2019,479,100024,100503,0.47660268847696086
744.0,UK007L1,Edinburgh,2019,971,174447,175418,0.5535349850072399
745.0,UK008L3,Greater Manchester,2019,1592,310654,312246,0.5098544096641751
746.0,UK009L1,Cardiff,2019,117,84374,84491,0.13847628741522766
747.0,UK010L3,Sheffield,2019,122,125965,126087,0.09675858732462506
748.0,UK011L2,Bristol,2019,202,98183,98385,0.20531585099354577
749.0,UK012L2,Belfast,2019,21682,173463,195145,11.110712547080375
750.0,UK013L2,Newcastle upon Tyne,2019,2037,544671,546708,0.3725937794947211
751.0,UK014L1,Leicester,2019,147,139634,139781,0.10516450733647634
752.0,UK016L1,Aberdeen,2019,1368,652580,653948,0.20919094484576753
753.0,UK017L2,Cambridge,2019,87,159532,159619,0.05450478953006847
754.0,UK018L3,Exeter,2019,1138,246588,247726,0.45937850689875104
755.0,UK019L3,Lincoln,2019,44,211499,211543,0.020799553755028528
756.0,UK023L1,Portsmouth,2019,312,20541,20853,1.4961875989066322
757.0,UK024L1,Worcester,2019,15,61187,61202,0.024509002973759027
758.0,UK025L3,Coventry,2019,34,81413,81447,0.04174493842621582
759.0,UK026L1,Kingston upon Hull,2019,424,251274,251698,0.16845584788119095
760.0,UK027L1,Stoke-on-Trent,2019,98,88078,88176,0.11114135365632372
761.0,UK029L1,Nottingham,2019,79,90210,90289,0.08749681578043837
762.0,UK033L1,Guildford,2019,30,61661,61691,0.048629459726702434
763.0,UK050L1,Burnley,2019,5,27969,27974,0.017873739901336956
764.0,UK056L1,Hastings,2019,104,54646,54750,0.18995433789954339
765.0,UK515L1,Brighton and Hove,2019,268,42139,42407,0.6319711368406159
766.0,UK516L1,Plymouth,2019,1134,214641,215775,0.5255474452554744
767.0,UK517L1,Swansea,2019,362,83680,84042,0.43073701244615786
768.0,UK518L1,Derby,2019,42,68060,68102,0.061672197585973976
769.0,UK520L2,Southampton,2019,1125,152227,153352,0.7336063435755648
770.0,UK528L1,Northampton,2019,260,154285,154545,0.16823578892879096
771.0,UK539L1,Bournemouth,2019,679,93114,93793,0.7239346219867154
772.0,UK546L1,Colchester,2019,487,69008,69495,0.7007698395568027
773.0,UK550L0,Dundee City,2019,421,225995,226416,0.18594092290297504
774.0,UK551L1,Falkirk,2019,105,29684,29789,0.3524791030246064
775.0,UK552L0,Reading,2019,5,21916,21921,0.02280917841339355
776.0,UK553L1,Blackpool,2019,31,48924,48955,0.06332346032070268
777.0,UK557L1,Blackburn with Darwen,2019,13,79541,79554,0.01634110164165221
778.0,UK558L1,Newport,2019,24,31676,31700,0.07570977917981073
779.0,UK559L2,Middlesbrough,2019,1047,60722,61769,1.6950250125467465
780.0,UK560L1,Oxford,2019,130,192793,192923,0.06738439688373081
781.0,UK562L2,Preston,2019,24,25738,25762,0.0931604689076935
782.0,UK566L1,Norwich,2019,16,150224,150240,0.010649627263045794
783.0,UK568L1,Cheshire West and Chester,2019,217,135928,136145,0.15938888684858055
784.0,UK569L2,Ipswich,2019,1514,154132,155646,0.9727201470002441
785.0,UK571L1,Cheltenham,2019,4,46179,46183,0.008661195678063355
786.0,XK001L1,Pristina,2019,21,255786,255807,0.008209314053172899
787.0,XK002L1,Prizren,2019,3,127630,127633,0.002350489293521268
788.0,XK003L1,MitrovicÃ«,2019,0,117914,117914,0.0
1.0,AL001L1,Tirana,2020,1638,165483,167121,0.9801281706069256
2.0,AL003L1,Elbasan,2020,737,125267,126004,0.5849020666010603
3.0,AL004L1,ShkodÃ«r,2020,6741,178588,185329,3.6373152609683315
4.0,AL005L0,VlorÃ«,2020,2382,61351,63733,3.7374672461676055
5.0,AT001L3,Wien,2020,2758,915732,918490,0.30027545210073053
6.0,AT002L3,Graz,2020,275,290857,291132,0.0944588708901804
7.0,AT003L3,Linz,2020,1904,357326,359230,0.5300225482281546
8.0,AT004L3,Salzburg,2020,3148,134328,137476,2.289854229101807
9.0,AT005L3,Innsbruck,2020,14317,198505,212822,6.727218050765428
10.0,AT006L2,Klagenfurt,2020,3479,179781,183260,1.898395721925134
11.0,BA001L1,Sarajevo,2020,1,263773,263774,0.00037911242199761917
12.0,BA002L1,Banja Luka,2020,26,275276,275302,0.009444174034333204
13.0,BA003L1,Mostar,2020,1152,181195,182347,0.6317625187143193
14.0,BA004L1,Tuzla,2020,810,111451,112261,0.7215328564684085
15.0,BA005L1,Zenica,2020,7,86709,86716,0.008072328059412335
16.0,BE001L2,Bruxelles / Brussel,2020,105,326546,326651,0.03214439876198144
17.0,BE002L2,Antwerpen,2020,4391,114821,119212,3.6833540247626075
18.0,BE003L2,Gent,2020,565,101276,101841,0.5547863826945926
19.0,BE004L2,Charleroi,2020,476,109289,109765,0.4336537147542477
20.0,BE005L2,LiÃ¨ge,2020,103,141295,141398,0.07284402891130001
21.0,BE006L2,Brugge,2020,910,55629,56539,1.6095084808716107
22.0,BE007L2,Namur,2020,61,84046,84107,0.07252666246566873
23.0,BE008L1,Leuven,2020,12,45064,45076,0.02662170556393646
24.0,BE009L1,Mons,2020,7,39193,39200,0.017857142857142856
25.0,BE010L1,Kortrijk,2020,49,22290,22339,0.21934732978199561
26.0,BE011L1,Oostende,2020,183,20749,20932,0.8742595069749665
27.0,BG001L2,Sofia,2020,3400,568374,571774,0.5946405397936947
28.0,BG002L2,Plovdiv,2020,324,276762,277086,0.11693120547411273
29.0,BG003L2,Varna,2020,3640,201158,204798,1.777361107042061
30.0,BG004L2,Burgas,2020,6625,289275,295900,2.2389320716458263
31.0,BG005L1,Pleven,2020,1102,177974,179076,0.6153811789407849
32.0,BG006L2,Ruse,2020,2535,131482,134017,1.8915510718789406
33.0,BG007L2,Vidin,2020,1762,59202,60964,2.890230299849091
34.0,BG008L2,Stara Zagora,2020,20,132048,132068,0.015143713844383195
35.0,BG009L1,Sliven,2020,67,136707,136774,0.048985918376299585
36.0,BG010L1,Dobrich,2020,27,140311,140338,0.019239265202582335
37.0,BG011L1,Shumen,2020,86,94421,94507,0.09099855037193012
38.0,BG013L1,Yambol,2020,458,130348,130806,0.3501368438756632
39.0,BG014L1,Haskovo,2020,420,73548,73968,0.5678131083711876
40.0,BG015L1,Pazardzhik,2020,51,63771,63822,0.07990974898937671
41.0,BG016L1,Blagoevgrad,2020,70,135409,135479,0.05166852427313458
42.0,BG017L1,Veliko Tarnovo,2020,13,88526,88539,0.014682795152418708
43.0,BG018L1,Vratsa,2020,160,70397,70557,0.22676701106906474
44.0,CH001L2,ZÃ¼rich,2020,297,127420,127717,0.23254539333056679
45.0,CH002L2,GenÃ¨ve,2020,619,53278,53897,1.1484869287715458
46.0,CH003L2,Basel,2020,174,69246,69420,0.25064822817631804
47.0,CH004L2,Bern,2020,9,78279,78288,0.011496014714898835
48.0,CH005L2,Lausanne,2020,23,77482,77505,0.02967550480614154
49.0,CH006L1,Winterthur,2020,0,13291,13291,0.0
50.0,CH007L2,St. Gallen,2020,132,31777,31909,0.4136763922404338
51.0,CH008L2,Luzern,2020,3,29256,29259,0.010253255408592229
52.0,CH009L2,Lugano,2020,272,30353,30625,0.8881632653061226
53.0,CH010L1,Biel/Bienne,2020,8,9087,9095,0.0879604178119846
54.0,CY001L2,Lefkosia,2020,29,162599,162628,0.017832107632142068
55.0,CY501L2,Lemesos,2020,1041,124858,125899,0.8268532712730046
56.0,CZ001L2,Praha,2020,452,570110,570562,0.0792201373382735
57.0,CZ002L2,Brno,2020,1133,266782,267915,0.4228953212772708
58.0,CZ003L2,Ostrava,2020,579,142087,142666,0.40584301795802785
59.0,CZ004L2,PlzeÅ,2020,86,195871,195957,0.04388717933015917
60.0,CZ005L2,ÃstÃ­ nad Labem,2020,159,35752,35911,0.44276127091977385
61.0,CZ006L2,Olomouc,2020,43,93521,93564,0.045957847035184476
62.0,CZ007L2,Liberec,2020,0,61316,61316,0.0
63.0,CZ008L2,ÄeskÃ© BudÄjovice,2020,635,128769,129404,0.4907112608574697
64.0,CZ009L2,Hradec KrÃ¡lovÃ©,2020,179,79326,79505,0.22514307276271933
65.0,CZ010L2,Pardubice,2020,289,86068,86357,0.33465729471843625
66.0,CZ011L2,ZlÃ­n,2020,87,57865,57952,0.15012424075096634
67.0,CZ013L2,Karlovy Vary,2020,15,46969,46984,0.03192576196151881
68.0,CZ014L2,Jihlava,2020,59,95968,96027,0.06144105303716663
69.0,CZ016L2,Most,2020,38,27740,27778,0.13679890560875513
70.0,CZ018L2,Chomutov-Jirkov,2020,213,45473,45686,0.46622597732346893
71.0,DE001L1,Berlin,2020,13809,1734456,1748265,0.7898688127943989
72.0,DE002L1,Hamburg,2020,14152,720022,734174,1.927608441595589
73.0,DE003L1,MÃ¼nchen,2020,6167,543774,549941,1.121393022160559
74.0,DE004L1,KÃ¶ln,2020,723,161907,162630,0.44456742298468915
75.0,DE005L1,Frankfurt am Main,2020,1176,429155,430331,0.2732780115771348
76.0,DE007L1,Stuttgart,2020,83,365087,365170,0.022729139852671356
77.0,DE008L2,Leipzig,2020,3748,393941,397689,0.9424449758479616
78.0,DE009L2,Dresden,2020,5955,577241,583196,1.0210975383918957
79.0,DE011L1,DÃ¼sseldorf,2020,1154,119163,120317,0.959132957104981
80.0,DE012L1,Bremen,2020,2613,586926,589539,0.4432276745049946
81.0,DE013L1,Hannover,2020,2979,294333,297312,1.0019777203745561
82.0,DE014L1,NÃ¼rnberg,2020,409,293092,293501,0.13935216575071294
83.0,DE017L0,Bielefeld,2020,7,25876,25883,0.027044778425993895
84.0,DE018L1,Halle an der Saale,2020,948,156638,157586,0.6015762821570445
85.0,DE019L2,Magdeburg,2020,354,416680,417034,0.0848851652383259
86.0,DE020L1,Wiesbaden,2020,939,100499,101438,0.9256885979613163
87.0,DE021L1,GÃ¶ttingen,2020,80,238877,238957,0.03347882673451709
88.0,DE025L1,Darmstadt,2020,22,78165,78187,0.028137669945131547
89.0,DE026L1,Trier,2020,279,120848,121127,0.23033675398548634
90.0,DE027L1,Freiburg im Breisgau,2020,345,220851,221196,0.1559702707101394
91.0,DE028L1,Regensburg,2020,618,253044,253662,0.24363128888047875
92.0,DE029L0,Frankfurt (Oder),2020,88,14756,14844,0.5928321207221773
93.0,DE030L1,Weimar,2020,24,89004,89028,0.026957811025744707
94.0,DE031L1,Schwerin,2020,9327,480676,490003,1.9034577339322412
95.0,DE032L1,Erfurt,2020,560,284952,285512,0.1961388663173527
96.0,DE033L1,Augsburg,2020,32,199902,199934,0.01600528174297518
97.0,DE034L1,Bonn,2020,266,129071,129337,0.20566427240464835
98.0,DE035L1,Karlsruhe,2020,833,124979,125812,0.6620990048644009
99.0,DE036L0,MÃ¶nchengladbach,2020,0,17023,17023,0.0
100.0,DE037L1,Mainz,2020,1138,69167,70305,1.618661546120475
101.0,DE038L1,Ruhrgebiet,2020,3722,440030,443752,0.83875678306802
102.0,DE039L1,Kiel,2020,12812,326950,339762,3.770874906552234
103.0,DE040L1,SaarbrÃ¼cken,2020,69,153613,153682,0.04489790606577218
104.0,DE042L1,Koblenz,2020,1007,91169,92176,1.0924752647109877
105.0,DE043L2,Rostock,2020,4333,357471,361804,1.197609755558258
106.0,DE044L1,Kaiserslautern,2020,24,135503,135527,0.017708648461192238
107.0,DE045L1,Iserlohn,2020,139,105968,106107,0.1309998397843686
108.0,DE048L1,Wilhelmshaven,2020,761,73286,74047,1.0277256337191243
109.0,DE050L1,TÃ¼bingen,2020,4,52021,52025,0.007688611244593945
110.0,DE051L1,Villingen-Schwenningen,2020,22,102538,102560,0.021450858034321372
111.0,DE052L1,Flensburg,2020,1573,203902,205475,0.7655432534371578
112.0,DE053L1,Marburg,2020,25,126217,126242,0.019803235056478827
113.0,DE054L1,Konstanz,2020,222,81678,81900,0.27106227106227104
114.0,DE055L0,NeumÃ¼nster,2020,116,7060,7176,1.6164994425863992
115.0,DE056L0,Brandenburg an der Havel,2020,1458,21372,22830,6.386333771353482
116.0,DE057L1,GieÃen,2020,25,85503,85528,0.029230193620802546
117.0,DE058L1,LÃ¼neburg,2020,482,132020,132502,0.3637680940665047
118.0,DE059L1,Bayreuth,2020,18,199902,199920,0.00900360144057623
119.0,DE060L1,Celle,2020,68,154979,155047,0.043857668964894514
120.0,DE061L1,Aschaffenburg,2020,246,147370,147616,0.1666486017775851
121.0,DE062L1,Bamberg,2020,259,121896,122155,0.21202570504686669
122.0,DE063L1,Plauen,2020,130,141158,141288,0.09201064492384349
123.0,DE064L1,Neubrandenburg,2020,20118,563873,583991,3.4449161031591244
124.0,DE065L1,Fulda,2020,4,138221,138225,0.0028938325194429373
125.0,DE066L1,Kempten (AllgÃ¤u),2020,361,158806,159167,0.22680580773652828
126.0,DE067L1,Landshut,2020,220,141233,141453,0.15552869150884038
127.0,DE069L1,Rosenheim,2020,525,147238,147763,0.3552986877635132
128.0,DE071L1,Stralsund,2020,20029,318219,338248,5.921394952815685
129.0,DE072L1,Friedrichshafen,2020,107,66512,66619,0.16061483961032139
130.0,DE073L1,Offenburg,2020,440,185444,185884,0.236706763357793
131.0,DE074L1,GÃ¶rlitz,2020,2229,208878,211107,1.0558626667993007
132.0,DE077L1,Schweinfurt,2020,113,201227,201340,0.05612396940498659
133.0,DE078L1,Greifswald,2020,4543,345251,349794,1.2987644156274836
134.0,DE079L1,Wetzlar,2020,10,106480,106490,0.0093905531035778
135.0,DE081L1,Passau,2020,710,159356,160066,0.4435670286007022
136.0,DE082L0,Dessau-RoÃlau,2020,114,24534,24648,0.4625121713729309
137.0,DE083L1,Braunschweig-Salzgitter-Wolfsburg,2020,750,412094,412844,0.18166668281481624
138.0,DE084L1,Mannheim-Ludwigshafen,2020,1376,203052,204428,0.6730976187215059
139.0,DE504L1,MÃ¼nster,2020,122,141641,141763,0.08605912685256378
140.0,DE505L0,Chemnitz,2020,3,22190,22193,0.01351777587527599
141.0,DE507L1,Aachen,2020,118,70402,70520,0.1673284174702212
142.0,DE508L0,Krefeld,2020,67,13613,13680,0.489766081871345
143.0,DE510L1,LÃ¼beck,2020,5708,156441,162149,3.52021905778019
144.0,DE513L1,Kassel,2020,28,139833,139861,0.020019876877757203
145.0,DE516L0,Solingen,2020,8,8946,8954,0.08934554389099844
146.0,DE517L1,OsnabrÃ¼ck,2020,253,223877,224130,0.11288091732476688
147.0,DE520L1,Oldenburg (Oldenburg),2020,487,189482,189969,0.25635761624265013
148.0,DE522L1,Heidelberg,2020,276,116829,117105,0.23568592288971435
149.0,DE523L1,Paderborn,2020,243,124440,124683,0.19489425182262216
150.0,DE524L2,WÃ¼rzburg,2020,187,305742,305929,0.06112529377731435
151.0,DE527L1,Bremerhaven,2020,1251,213228,214479,0.5832738869539675
152.0,DE529L1,Heilbronn,2020,61,119923,119984,0.050840112014935324
153.0,DE530L0,Remscheid,2020,9,7360,7369,0.12213326095806758
154.0,DE532L1,Ulm,2020,259,199049,199308,0.1299496257049391
155.0,DE533L1,Pforzheim,2020,4,67144,67148,0.00595699052838506
156.0,DE534L1,Ingolstadt,2020,597,284238,284835,0.2095950287008268
157.0,DE535L1,Gera,2020,113,99673,99786,0.11324233860461387
158.0,DE537L1,Reutlingen,2020,8,109274,109282,0.0073205102395636976
159.0,DE539L1,Cottbus,2020,940,181340,182280,0.5156901470265526
160.0,DE540L2,Siegen,2020,37,177527,177564,0.02083755716248789
161.0,DE542L1,Hildesheim,2020,138,120672,120810,0.114228954556742
162.0,DE544L1,Zwickau,2020,76,94728,94804,0.08016539386523776
163.0,DE546L0,Wuppertal,2020,16,16817,16833,0.0950513871561813
164.0,DE547L2,Jena,2020,2,93066,93068,0.002148966347187003
165.0,DE548L1,DÃ¼ren,2020,43,93995,94038,0.04572619579318998
166.0,DE549L1,Bocholt,2020,185,142080,142265,0.13003901170351106
167.0,DK001L2,KÃ¸benhavn,2020,16568,274655,291223,5.689111093560604
168.0,DK002L3,Ãrhus,2020,6059,456465,462524,1.3099860763981979
169.0,DK003L2,Odense,2020,8698,351141,359839,2.417192133148436
170.0,DK004L3,Aalborg,2020,3380,617079,620459,0.5447579936788732
171.0,EE001L1,Tallinn,2020,5621,433440,439061,1.280232131753902
172.0,EE002L1,Tartu,2020,1014,298628,299642,0.3384038285687587
173.0,EE003L0,Narva,2020,329,6560,6889,4.775729423718973
174.0,EL001L1,Athina,2020,5107,304280,309387,1.6506834482379673
175.0,EL002L1,Thessaloniki,2020,2350,139769,142119,1.6535438611304611
176.0,EL003L1,Patra,2020,666,50924,51590,1.2909478581120373
177.0,EL004L1,Irakleio,2020,1086,60298,61384,1.7691906685781311
178.0,EL005L1,Larisa,2020,92,155427,155519,0.05915675898121773
179.0,EL006L1,Volos,2020,274,30542,30816,0.8891484942886811
180.0,EL007L1,Ioannina,2020,1938,130703,132641,1.4610866926515933
181.0,EL008L1,Kavala,2020,308,35260,35568,0.8659469185784976
182.0,EL009L1,Kalamata,2020,269,44183,44452,0.6051471249887519
183.0,ES001L3,Madrid,2020,2301,785302,787603,0.2921522645292108
184.0,ES002L2,Barcelona,2020,1320,263287,264607,0.49885301598219245
185.0,ES003L3,Valencia,2020,3117,172003,175120,1.7799223389675651
186.0,ES004L3,Sevilla,2020,4716,463710,468426,1.0067758834906686
187.0,ES005L2,Zaragoza,2020,177,275961,276138,0.06409838558981379
188.0,ES006L2,MÃ¡laga,2020,989,151753,152742,0.6474970865904597
189.0,ES007L2,Murcia,2020,122,120014,120136,0.10155157488180064
190.0,ES008L2,Las Palmas,2020,782,75814,76596,1.02094104130764
191.0,ES009L2,Valladolid,2020,207,115322,115529,0.17917579135974518
192.0,ES010L2,Palma de Mallorca,2020,2266,201968,204234,1.1095116386106134
193.0,ES011L2,Santiago de Compostela,2020,0,126256,126256,0.0
194.0,ES012L2,Vitoria/Gasteiz,2020,945,158376,159321,0.593142146986273
195.0,ES013L2,Oviedo,2020,17,93470,93487,0.018184346486677293
196.0,ES014L3,Pamplona/IruÃ±a,2020,66,169448,169514,0.0389348372405819
197.0,ES015L2,Santander,2020,28,69455,69483,0.04029762675762417
198.0,ES016L2,Toledo,2020,459,92939,93398,0.4914452129595923
199.0,ES017L2,Badajoz,2020,670,218079,218749,0.30628711445538037
200.0,ES018L2,LogroÃ±o,2020,67,46071,46138,0.1452165243400234
201.0,ES019L3,Bilbao,2020,699,152622,153321,0.4559062359363688
202.0,ES020L2,CÃ³rdoba,2020,1291,185611,186902,0.6907363217087029
203.0,ES021L2,Alicante/Alacant,2020,415,35643,36058,1.1509235121193633
204.0,ES022L2,Vigo,2020,933,135538,136471,0.6836617303309861
205.0,ES023L2,GijÃ³n,2020,627,52775,53402,1.1741133290887982
206.0,ES025L3,Santa Cruz de Tenerife,2020,1175,65808,66983,1.7541764328262395
207.0,ES026L2,CoruÃ±a (A),2020,529,75446,75975,0.6962816716025009
208.0,ES028L1,Reus,2020,0,11534,11534,0.0
209.0,ES031L1,Lugo,2020,4,134007,134011,0.002984829603540008
210.0,ES033L1,Girona,2020,2,39619,39621,0.005047828171929028
211.0,ES034L1,CÃ¡ceres,2020,1945,236328,238273,0.816290557469793
212.0,ES035L1,Torrevieja,2020,1733,7105,8838,19.608508712378367
213.0,ES039L1,AvilÃ©s,2020,106,19036,19142,0.5537561383345523
214.0,ES040L1,Talavera de la Reina,2020,552,82714,83266,0.6629356520068216
215.0,ES041L1,Palencia,2020,4,28377,28381,0.014093936083999859
216.0,ES043L1,Ferrol,2020,911,46059,46970,1.9395358739621036
217.0,ES044L1,Pontevedra,2020,76,51540,51616,0.14724116553006822
218.0,ES046L1,Gandia,2020,244,17093,17337,1.407394589606045
219.0,ES048L1,Guadalajara,2020,3,45380,45383,0.006610404777119186
220.0,ES050L1,Manresa,2020,3,29600,29603,0.010134108029591596
221.0,ES053L1,Ciudad Real,2020,584,95761,96345,0.6061549639317038
222.0,ES054L1,Benidorm,2020,330,20343,20673,1.5962850094325933
223.0,ES057L1,Ponferrada,2020,248,62095,62343,0.39779927177068797
224.0,ES059L1,Zamora,2020,328,33852,34180,0.959625511995319
225.0,ES070L1,Irun,2020,13,7229,7242,0.17950842308754486
226.0,ES072L1,Arrecife,2020,2427,56507,58934,4.118166084094072
227.0,ES501L3,Granada,2020,382,162242,162624,0.23489767807949624
228.0,ES505L1,Elche/Elx,2020,780,38038,38818,2.0093770931011385
229.0,ES506L1,Cartagena,2020,1518,59430,60948,2.4906477653081316
230.0,ES508L1,Jerez de la Frontera,2020,155,125951,126106,0.12291247046135792
231.0,ES510L1,Donostia-San SebastiÃ¡n,2020,82,33238,33320,0.2460984393757503
232.0,ES514L1,AlmerÃ­a,2020,738,39992,40730,1.8119322366805795
233.0,ES515L1,Burgos,2020,6,149385,149391,0.004016306203184931
234.0,ES516L1,Salamanca,2020,17,45627,45644,0.03724476382437999
235.0,ES519L1,Albacete,2020,3,245322,245325,0.0012228676245796392
236.0,ES520L1,CastellÃ³n/CastellÃ³,2020,358,32436,32794,1.0916631091053242
237.0,ES521L1,Huelva,2020,3824,93596,97420,3.925272018066105
238.0,ES522L1,CÃ¡diz,2020,1095,23738,24833,4.4094551604719525
239.0,ES523L1,LeÃ³n,2020,1,118886,118887,0.0008411348591519679
240.0,ES525L1,Tarragona,2020,451,21289,21740,2.0745170193192273
241.0,ES527L1,JaÃ©n,2020,32,99899,99931,0.03202209524571955
242.0,ES528L1,Lleida,2020,116,70559,70675,0.16413158825610188
243.0,ES529L1,Ourense,2020,164,65004,65168,0.25165725509452497
244.0,ES532L1,Algeciras,2020,426,41868,42294,1.0072350688040859
245.0,ES533L1,Marbella,2020,573,68632,69205,0.8279748573079979
246.0,ES537L1,Alcoy,2020,0,20529,20529,0.0
247.0,ES538L1,Ãvila,2020,538,53108,53646,1.002870670693062
248.0,ES542L1,Cuenca,2020,59,164523,164582,0.03584839168317313
249.0,ES543L1,Eivissa,2020,2057,57345,59402,3.462846368809131
250.0,ES544L1,Linares,2020,14,25762,25776,0.05431409062693979
251.0,ES545L1,Lorca,2020,286,181921,182207,0.15696433177649596
252.0,ES546L1,MÃ©rida,2020,881,127418,128299,0.6866772149432185
253.0,ES547L1,Sagunto,2020,207,15321,15528,1.3330757341576507
254.0,ES550L1,Puerto de la Cruz,2020,1362,26110,27472,4.957775189283634
255.0,ES552L1,Igualada,2020,0,25426,25426,0.0
256.0,FI001L3,Helsinki,2020,18131,473387,491518,3.6887764028987746
257.0,FI002L3,Tampere,2020,85748,602895,688643,12.451734788562433
258.0,FI003L4,Turku,2020,15828,450616,466444,3.393333390503469
259.0,FI004L4,Oulu,2020,8630,715191,723821,1.1922837276066873
260.0,FI007L2,Lahti,2020,28422,306981,335403,8.473985026967558
261.0,FI008L2,Kuopio,2020,135238,785168,920406,14.693298392231254
262.0,FI009L2,JyvÃ¤skylÃ¤,2020,57243,419699,476942,12.002088304238251
263.0,FR001L1,Paris,2020,1540,1208412,1209952,0.12727777630848167
264.0,FR003L2,Lyon,2020,1622,365609,367231,0.4416838447734532
265.0,FR004L2,Toulouse,2020,670,524002,524672,0.1276988289826787
266.0,FR006L2,Strasbourg,2020,792,203091,203883,0.38845808625535233
267.0,FR007L2,Bordeaux,2020,5118,550636,555754,0.9209110505727354
268.0,FR008L2,Nantes,2020,2149,314470,316619,0.6787337462375915
269.0,FR009L2,Lille,2020,104,144349,144453,0.07199573563719687
270.0,FR010L2,Montpellier,2020,7371,216547,223918,3.291830044927161
271.0,FR011L2,Saint-Etienne,2020,109,180946,181055,0.06020270083676231
272.0,FR012L2,Le Havre,2020,941,75497,76438,1.2310630838064838
273.0,FR013L2,Rennes,2020,312,381825,382137,0.08164611121142418
274.0,FR014L2,Amiens,2020,76,244719,244795,0.03104638575134296
275.0,FR016L2,Nancy,2020,346,283163,283509,0.12204198103058456
276.0,FR017L2,Metz,2020,238,176692,176930,0.1345164754422653
277.0,FR018L2,Reims,2020,27,243124,243151,0.011104210963557626
278.0,FR019L2,OrlÃ©ans,2020,961,291006,291967,0.32914678713690243
279.0,FR020L2,Dijon,2020,349,385412,385761,0.09047052449573699
280.0,FR021L2,Poitiers,2020,35,250407,250442,0.013975291684302154
281.0,FR022L2,Clermont-Ferrand,2020,47,266079,266126,0.017660807286773935
282.0,FR023L2,Caen,2020,236,226037,226273,0.10429878951531998
283.0,FR024L2,Limoges,2020,482,317352,317834,0.1516514910299087
284.0,FR025L2,BesanÃ§on,2020,75,238961,239036,0.03137602704195184
285.0,FR026L2,Grenoble,2020,1679,264169,265848,0.6315639011766122
286.0,FR027L2,Ajaccio,2020,1468,145541,147009,0.9985783183342516
289.0,FR032L2,Toulon,2020,2187,104869,107056,2.0428560753250635
290.0,FR034L2,Valenciennes,2020,105,78341,78446,0.13385003696810546
291.0,FR035L2,Tours,2020,518,284330,284848,0.18185137336403978
292.0,FR036L2,Angers,2020,773,230478,231251,0.33426882478346037
293.0,FR037L2,Brest,2020,806,134188,134994,0.5970635731958458
294.0,FR038L2,Le Mans,2020,60,224051,224111,0.02677244758177867
295.0,FR039L1,Avignon,2020,1474,85751,87225,1.6898824878188592
296.0,FR040L2,Mulhouse,2020,94,129672,129766,0.07243808085322812
297.0,FR042L2,Dunkerque,2020,827,90298,91125,0.9075445816186557
298.0,FR043L2,Perpignan,2020,1471,181559,183030,0.8036933835983173
299.0,FR044L2,NÃ®mes,2020,1412,149079,150491,0.9382620887627832
300.0,FR045L2,Pau,2020,11,201748,201759,0.005452049227048112
301.0,FR046L2,Bayonne,2020,1120,101510,102630,1.091298840494982
302.0,FR047L0,Annemasse,2020,1,7799,7800,0.01282051282051282
303.0,FR048L2,Annecy,2020,1985,117058,119043,1.6674646976302678
304.0,FR049L2,Lorient,2020,396,112786,113182,0.3498789560177413
305.0,FR050L2,MontbÃ©liard,2020,88,122969,123057,0.0715115759363547
306.0,FR051L2,Troyes,2020,176,260774,260950,0.06744587085648591
307.0,FR052L2,Saint-Nazaire,2020,362,106773,107135,0.33789144537266064
308.0,FR053L2,La Rochelle,2020,251,111089,111340,0.22543560265852344
309.0,FR056L2,AngoulÃªme,2020,11,214281,214292,0.005133182759972374
310.0,FR057L2,Boulogne-sur-Mer,2020,179,68359,68538,0.2611689865476086
311.0,FR058L2,ChambÃ©ry,2020,2000,99689,101689,1.9667810677654416
312.0,FR059L2,Chalon-sur-SaÃ´ne,2020,482,155876,156358,0.30826692590081733
313.0,FR060L2,Chartres,2020,24,161336,161360,0.01487357461576599
314.0,FR061L2,Niort,2020,21,178898,178919,0.011737154801893595
315.0,FR062L2,Calais,2020,113,50117,50230,0.22496516026279118
316.0,FR063L2,BÃ©ziers,2020,404,84739,85143,0.4744958481613286
317.0,FR064L2,Arras,2020,23,107540,107563,0.021382817511597856
318.0,FR065L2,Bourges,2020,185,250134,250319,0.07390569633148103
319.0,FR066L2,Saint-Brieuc,2020,94,115087,115181,0.0816106823173961
320.0,FR067L2,Quimper,2020,728,121194,121922,0.5971030658945884
321.0,FR068L2,Vannes,2020,785,120249,121034,0.6485780854966373
322.0,FR069L2,Cherbourg,2020,411,90307,90718,0.45305231596816503
323.0,FR073L2,Tarbes,2020,36,104293,104329,0.03450622549818363
324.0,FR074L2,CompiÃ¨gne,2020,266,98471,98737,0.2694025542603077
325.0,FR076L2,Belfort,2020,172,65447,65619,0.2621192032795379
326.0,FR077L2,Roanne,2020,17,123183,123200,0.0137987012987013
327.0,FR079L2,Saint-Quentin,2020,58,99316,99374,0.05836536719866363
328.0,FR082L2,Beauvais,2020,40,131102,131142,0.03050128867944671
329.0,FR084L2,Creil,2020,157,29486,29643,0.5296360017542084
330.0,FR086L2,Evreux,2020,3,126567,126570,0.002370229912301493
331.0,FR090L2,ChÃ¢teauroux,2020,507,260670,261177,0.19412122813264568
332.0,FR093L2,Brive-la-Gaillarde,2020,11,132571,132582,0.008296752198639332
333.0,FR096L2,Albi,2020,72,134166,134238,0.053636079202610286
334.0,FR099L2,FrÃ©jus,2020,432,43981,44413,0.9726881768851463
335.0,FR104L2,ChÃ¢lons-en-Champagne,2020,25,152784,152809,0.016360292914684344
336.0,FR203L2,Marseille,2020,2847,422929,425776,0.6686614557889594
337.0,FR205L2,Nice,2020,961,306379,307340,0.312683022060259
338.0,FR207L2,Lens - LiÃ©vin,2020,39,25269,25308,0.1541014698909436
339.0,FR208L1,HÃ©nin - Carvin,2020,8,11590,11598,0.06897740989825832
340.0,FR209L2,Douai,2020,142,44942,45084,0.3149676160056783
341.0,FR214L1,Valence,2020,311,90650,90961,0.3419047723749739
342.0,FR215L2,Rouen,2020,2224,284902,287126,0.7745728356192055
343.0,FR304L1,Melun,2020,97,44739,44836,0.21634400927825853
344.0,FR324L1,Martigues,2020,1764,18692,20456,8.623386781384434
345.0,FR505L1,Charleville-MÃ©ziÃ¨res,2020,180,135189,135369,0.13296988232165413
346.0,FR506L1,Colmar,2020,86,101899,101985,0.08432612639113596
347.0,FR519L1,Cannes,2020,496,19640,20136,2.4632499006754074
348.0,HR001L2,Grad Zagreb,2020,84,505784,505868,0.016605122284864826
349.0,HR002L2,Rijeka,2020,523,106711,107234,0.48771844750732046
350.0,HR003L2,Slavonski Brod,2020,938,96892,97830,0.9588060922007565
351.0,HR004L2,Osijek,2020,1766,171168,172934,1.0211988388633815
352.0,HR005L2,Split,2020,3135,335935,339070,0.9245878432182145
353.0,HR006L1,Pula - Pola,2020,1326,57571,58897,2.251388016367557
354.0,HR007L1,Zadar,2020,2488,154012,156500,1.589776357827476
355.0,HU001L2,Budapest,2020,7120,632014,639134,1.114007391251287
356.0,HU002L2,Miskolc,2020,225,164444,164669,0.13663773995105333
357.0,HU003L2,NyÃ­regyhÃ¡za,2020,240,167985,168225,0.14266607222469907
358.0,HU004L2,PÃ©cs,2020,179,185309,185488,0.09650219960320883
359.0,HU005L2,Debrecen,2020,543,201035,201578,0.26937463413666174
360.0,HU006L2,Szeged,2020,991,159942,160933,0.6157842083351457
361.0,HU007L2,GyÃµr,2020,704,203936,204640,0.34401876465989056
362.0,HU008L2,KecskemÃ©t,2020,55,182084,182139,0.030196717891280832
363.0,HU009L2,SzÃ©kesfehÃ©rvÃ¡r,2020,1212,299911,301123,0.4024933332890546
364.0,HU010L1,Szombathely,2020,74,134203,134277,0.0551099592633139
365.0,HU011L1,Szolnok,2020,935,143040,143975,0.6494183017885049
366.0,HU012L1,TatabÃ¡nya,2020,244,69586,69830,0.34942002004868966
367.0,HU013L1,VeszprÃ©m,2020,7145,124175,131320,5.440907706366128
368.0,HU014L1,BÃ©kÃ©scsaba,2020,143,106020,106163,0.1346985296195473
369.0,HU015L1,KaposvÃ¡r,2020,117,145443,145560,0.08037922506183018
370.0,HU016L1,Eger,2020,102,100476,100578,0.10141382807373382
371.0,HU017L1,DunaÃºjvÃ¡ros,2020,798,60872,61670,1.293984108967083
372.0,HU018L1,Zalaegerszeg,2020,265,139714,139979,0.18931411140242466
373.0,HU019L1,Sopron,2020,157,80513,80670,0.1946200570224371
374.0,IE001L1,Dublin,2020,2368,701234,703602,0.33655390405371216
375.0,IE002L1,Cork,2020,6907,322756,329663,2.0951699159444646
376.0,IE003L1,Limerick,2020,5312,151146,156458,3.395160362525406
377.0,IE004L1,Galway,2020,7133,219150,226283,3.152247407008039
378.0,IE005L1,Waterford,2020,1232,94625,95857,1.2852478170608301
379.0,IS001L1,ReykjavÃ­k,2020,243804,1053426,1297230,18.794199949122362
380.0,IT001L3,Roma,2020,9066,608150,617216,1.4688536914143508
381.0,IT002L3,Milano,2020,166,383879,384045,0.04322410134229061
382.0,IT003L3,Napoli,2020,2948,149994,152942,1.927528082541094
383.0,IT004L2,Torino,2020,86,170093,170179,0.05053502488556168
384.0,IT005L3,Palermo,2020,1497,148576,150073,0.9975145429224443
385.0,IT006L3,Genova,2020,692,120072,120764,0.5730184492067173
386.0,IT007L3,Firenze,2020,113,163658,163771,0.0689987848886555
387.0,IT008L3,Bari,2020,715,112714,113429,0.6303502631602147
388.0,IT009L1,Bologna,2020,82,185175,185257,0.04426283487263639
389.0,IT010L2,Catania,2020,850,60575,61425,1.3838013838013838
390.0,IT011L2,Venezia,2020,1787,65250,67037,2.665692080492862
391.0,IT012L3,Verona,2020,62,73099,73161,0.08474460436571397
392.0,IT013L3,Cremona,2020,280,60117,60397,0.4635991853900028
393.0,IT014L3,Trento,2020,608,97579,98187,0.6192265778565391
394.0,IT015L1,Trieste,2020,419,21218,21637,1.9364976660350326
395.0,IT016L3,Perugia,2020,5932,125096,131028,4.527276612632415
396.0,IT017L3,Ancona,2020,482,43761,44243,1.0894378771783109
397.0,IT019L2,Pescara,2020,253,16190,16443,1.5386486650854467
398.0,IT020L3,Campobasso,2020,313,102522,102835,0.3043710798852531
399.0,IT021L2,Caserta,2020,1,9341,9342,0.010704345964461572
400.0,IT022L2,Taranto,2020,3484,103444,106928,3.2582672452491397
401.0,IT023L2,Potenza,2020,58,138397,138455,0.04189086706872269
402.0,IT024L3,Catanzaro,2020,378,89705,90083,0.419613023544953
403.0,IT025L3,Reggio di Calabria,2020,605,47643,48248,1.2539379870668215
404.0,IT026L3,Sassari,2020,2271,150954,153225,1.48213411649535
405.0,IT027L2,Cagliari,2020,4869,190423,195292,2.4931896851893574
406.0,IT028L3,Padova,2020,4,61441,61445,0.0065098868907152736
407.0,IT029L3,Brescia,2020,76,60193,60269,0.12610131244918615
408.0,IT030L3,Modena,2020,146,69122,69268,0.21077553848819078
409.0,IT031L3,Foggia,2020,4,89707,89711,0.004458762024723836
410.0,IT032L3,Salerno,2020,330,37509,37839,0.8721160707206851
411.0,IT033L2,Piacenza,2020,477,93650,94127,0.5067621405122866
412.0,IT034L1,Bolzano,2020,967,105789,106756,0.9058038892427591
413.0,IT035L2,Udine,2020,0,71830,71830,0.0
414.0,IT036L2,La Spezia,2020,659,42260,42919,1.5354504997786529
415.0,IT037L1,Lecce,2020,324,61186,61510,0.5267436189237523
416.0,IT038L1,Barletta,2020,228,14869,15097,1.5102338212889979
417.0,IT039L2,Pesaro,2020,134,25557,25691,0.5215834338873535
418.0,IT040L2,Como,2020,1263,18478,19741,6.397852185806189
419.0,IT041L2,Pisa,2020,463,47590,48053,0.9635194472769649
420.0,IT042L1,Treviso,2020,32,24013,24045,0.13308380120607194
421.0,IT043L2,Varese,2020,740,22924,23664,3.12711291413117
422.0,IT045L2,Asti,2020,8,54828,54836,0.014588956160186739
423.0,IT046L2,Pavia,2020,24,36180,36204,0.06629101756711965
424.0,IT047L1,Massa,2020,244,10999,11243,2.17023925998399
425.0,IT048L2,Cosenza,2020,423,92056,92479,0.4574011397182063
426.0,IT052L1,Savona,2020,187,28518,28705,0.6514544504441735
427.0,IT054L1,Matera,2020,585,77204,77789,0.7520343493295967
428.0,IT056L1,Acireale,2020,52,5936,5988,0.8684034736138945
429.0,IT057L2,Avellino,2020,0,39759,39759,0.0
430.0,IT058L2,Pordenone,2020,2,37048,37050,0.005398110661268556
431.0,IT060L1,Lecco,2020,1551,28661,30212,5.1337216999867605
432.0,IT061L0,Altamura,2020,0,42800,42800,0.0
433.0,IT064L1,Battipaglia,2020,53,6433,6486,0.8171446191797719
434.0,IT065L0,Bisceglie,2020,84,6860,6944,1.2096774193548387
435.0,IT066L1,Carpi,2020,9,20613,20622,0.043642711667151585
436.0,IT067L0,Cerignola,2020,127,58770,58897,0.21563067728407218
437.0,IT068L1,Gallarate,2020,0,5319,5319,0.0
438.0,IT069L1,Gela,2020,415,57480,57895,0.7168149235685292
439.0,IT073L1,Sassuolo,2020,4,24058,24062,0.0166237220513673
440.0,IT501L2,Messina,2020,782,33661,34443,2.270417791713846
441.0,IT502L2,Prato,2020,9,40950,40959,0.021973192704900023
442.0,IT503L3,Parma,2020,250,113257,113507,0.22025073343494234
443.0,IT504L3,Livorno,2020,341,25473,25814,1.3209886108313318
444.0,IT505L3,Reggio nell'Emilia,2020,2,69032,69034,0.0028971231567053914
445.0,IT506L2,Ravenna,2020,3507,77682,81189,4.319550678047519
446.0,IT507L2,Ferrara,2020,877,90606,91483,0.958648054829859
447.0,IT508L3,Rimini,2020,254,32325,32579,0.7796433285245097
448.0,IT509L3,Siracusa,2020,548,33594,34142,1.6050612149258976
449.0,IT511L2,Bergamo,2020,0,18556,18556,0.0
450.0,IT512L3,ForlÃ¬,2020,0,72751,72751,0.0
451.0,IT513L3,Latina,2020,528,65965,66493,0.7940685485690223
452.0,IT514L2,Vicenza,2020,1,34981,34982,0.0028586130009719286
453.0,IT515L2,Terni,2020,164,102168,102332,0.16026267443224018
454.0,IT516L2,Novara,2020,3,54162,54165,0.005538631957906397
455.0,IT518L1,Alessandria,2020,146,76768,76914,0.1898223990430871
456.0,IT519L1,Arezzo,2020,66,88561,88627,0.07446940548591287
457.0,IT520L1,Grosseto,2020,465,119134,119599,0.38879923745181816
458.0,IT521L1,Brindisi,2020,842,63145,63987,1.3158922906215325
459.0,IT522L1,Trapani,2020,915,49875,50790,1.8015357353809804
460.0,IT523L1,Ragusa,2020,257,52593,52850,0.4862819299905393
461.0,IT524L0,Andria,2020,0,39880,39880,0.0
462.0,IT525L0,Trani,2020,109,10270,10379,1.0501975142113884
463.0,IT526L1,L'Aquila,2020,993,139276,140269,0.707925486030413
464.0,LT001L1,Vilnius,2020,3860,420709,424569,0.9091572865659056
465.0,LT002L1,Kaunas,2020,1255,160796,162051,0.7744475504625087
466.0,LT003L1,PanevÄÅ¾ys,2020,134,222674,222808,0.060141467092743525
467.0,LT004L0,Alytus,2020,7,3952,3959,0.17681232634503663
468.0,LT501L0,KlaipÄda,2020,94,8829,8923,1.053457357391012
469.0,LT502L0,Å iauliai,2020,1168,6877,8045,14.518334369173399
470.0,LU001L1,Luxembourg,2020,309,259406,259715,0.11897657047147835
471.0,LV001L1,RÄ«ga,2020,10555,605694,616249,1.7127816840270735
472.0,LV002L2,LiepÄja,2020,3515,268542,272057,1.292008659949937
473.0,LV003L1,Jelgava,2020,248,166211,166459,0.14898563610258383
474.0,LV501L1,Daugavpils,2020,722,258953,259675,0.2780398575142004
475.0,ME001L1,Podgorica,2020,1141,183340,184481,0.6184918772122875
476.0,MK001L1,Skopje,2020,10,224343,224353,0.0044572615476503544
477.0,MK003L1,Bitola,2020,194,119468,119662,0.1621233140011031
478.0,MK004L1,Tetovo,2020,1,105620,105621,0.0009467814165743554
479.0,MK005L1,Prilep,2020,81,86750,86831,0.09328465640151558
480.0,MT001L1,Valletta,2020,928,25028,25956,3.575281245184158
481.0,NL001L3,s' Gravenhage,2020,1327,41380,42707,3.107218957079636
482.0,NL002L3,Amsterdam,2020,66427,266530,332957,19.95062425478365
483.0,NL003L3,Rotterdam,2020,28020,189151,217171,12.902275165652874
484.0,NL004L3,Utrecht,2020,926,96361,97287,0.9518229568184855
485.0,NL005L3,Eindhoven,2020,101,144305,144406,0.06994169217345539
486.0,NL006L3,Tilburg,2020,99,43135,43234,0.22898644585280103
487.0,NL007L3,Groningen,2020,3054,205106,208160,1.4671406610299769
488.0,NL008L3,Enschede,2020,145,84811,84956,0.17067658552662554
489.0,NL009L3,Arnhem,2020,572,55326,55898,1.0232924254892841
490.0,NL010L3,Heerlen,2020,16,33327,33343,0.04798608403562967
491.0,NL012L3,Breda,2020,1378,71992,73370,1.878151833174322
492.0,NL013L3,Nijmegen,2020,722,39114,39836,1.8124309669645546
493.0,NL014L3,Apeldoorn,2020,8,71116,71124,0.011247961307013105
494.0,NL015L3,Leeuwarden,2020,1085,109838,110923,0.9781560181387088
495.0,NL016L3,Sittard-Geleen,2020,45,22867,22912,0.19640363128491622
496.0,NL020L3,Roosendaal,2020,0,24574,24574,0.0
497.0,NL026L0,Alphen aan den Rijn,2020,5,13205,13210,0.03785011355034065
498.0,NL028L3,Bergen op Zoom,2020,1792,32989,34781,5.15223829102096
499.0,NL030L0,Gouda,2020,2,1786,1788,0.11185682326621924
500.0,NL032L3,MiddelburgÂ Â Â Â Â Â ,2020,1099,22289,23388,4.69899093552249
501.0,NL503L3,s-Hertogenbosch,2020,512,36347,36859,1.3890772945549257
502.0,NL504L3,Amersfoort,2020,3,12241,12244,0.024501796798431882
503.0,NL505L3,Maastricht,2020,11,20374,20385,0.05396124601422615
504.0,NL507L3,Leiden,2020,253,19528,19781,1.2790051059097114
505.0,NL511L3,Zwolle,2020,921,122099,123020,0.7486587546740368
506.0,NL512L3,Ede,2020,8,35257,35265,0.022685382106904864
507.0,NL513L3,Deventer,2020,13,25232,25245,0.051495345612992675
508.0,NL514L3,Alkmaar,2020,276,47516,47792,0.5775025108804821
509.0,NL515L3,Venlo,2020,343,50893,51236,0.669451167148099
510.0,NL519L3,Almelo,2020,4,42021,42025,0.009518143961927425
511.0,NL520L3,Lelystad,2020,56948,61894,118842,47.919085845071606
512.0,NL521L3,Oss,2020,100,33046,33146,0.30169552887226214
513.0,NL522L3,Assen,2020,149,70713,70862,0.2102678445429144
514.0,NL524L3,Veenendaal,2020,20,8165,8185,0.2443494196701283
515.0,NL529L3,Soest,2020,2,7940,7942,0.02518257365902795
516.0,NO001L1,Oslo,2020,22663,723980,746643,3.0353194230709994
517.0,NO002L1,Bergen,2020,22814,334929,357743,6.377203746823837
518.0,NO003L1,Trondheim,2020,17972,655284,673256,2.669415497225424
519.0,NO004L1,Stavanger,2020,20532,268545,289077,7.102605880094232
520.0,NO005L1,Kristiansand,2020,6129,309333,315462,1.942864750746524
521.0,NO006L1,TromsÃ¸,2020,57125,317488,374613,15.249070373959258
522.0,PL001L2,Warszawa,2020,4012,857231,861243,0.4658383290198005
523.0,PL002L2,ÅÃ³dÅº,2020,85,169415,169500,0.050147492625368724
524.0,PL003L2,KrakÃ³w,2020,273,375475,375748,0.07265507733906768
525.0,PL004L2,WrocÅaw,2020,1192,263508,264700,0.45032111824707216
526.0,PL005L2,PoznaÅ,2020,1559,307769,309328,0.5039957585475612
527.0,PL006L2,GdaÅsk,2020,1697,261819,263516,0.6439836670259111
528.0,PL007L2,Szczecin,2020,2974,110086,113060,2.6304617017512824
529.0,PL008L2,Bydgoszcz,2020,1235,208901,210136,0.5877146229108767
530.0,PL009L2,Lublin,2020,379,322405,322784,0.11741598096559928
531.0,PL010L2,Katowice,2020,2406,392189,394595,0.6097390995831169
532.0,PL011L2,BiaÅystok,2020,28,223294,223322,0.012537949686999042
533.0,PL012L2,Kielce,2020,80,224149,224229,0.03567781152304118
534.0,PL013L2,ToruÅ,2020,1391,157542,158933,0.8752115671383539
535.0,PL014L2,Olsztyn,2020,4887,197657,202544,2.412809068646813
536.0,PL015L2,RzeszÃ³w,2020,147,229202,229349,0.06409445866343433
537.0,PL016L2,Opole,2020,642,175974,176616,0.36350047560809895
538.0,PL017L2,GorzÃ³w Wielkopolski,2020,186,97234,97420,0.19092588790802711
539.0,PL018L2,Zielona GÃ³ra,2020,211,169073,169284,0.12464261241464049
540.0,PL019L2,Jelenia GÃ³ra,2020,262,83079,83341,0.3143710778608368
541.0,PL020L2,Nowy SÄcz,2020,821,129597,130418,0.629514330843902
542.0,PL021L2,SuwaÅki,2020,321,71812,72133,0.4450112985734685
543.0,PL022L2,Konin,2020,1403,116760,118163,1.1873429076783766
544.0,PL024L2,CzÄstochowa,2020,63,193835,193898,0.03249130986394909
545.0,PL025L2,Radom,2020,36,67986,68022,0.05292405398253506
546.0,PL026L2,PÅock,2020,3777,167298,171075,2.207803594914511
547.0,PL027L2,Kalisz,2020,209,148814,149023,0.14024680753977573
548.0,PL028L2,Koszalin,2020,207,129464,129671,0.1596347679897587
549.0,PL029L1,SÅupsk,2020,7925,227079,235004,3.3722830249697875
550.0,PL030L1,JastrzÄbie-ZdrÃ³j,2020,76,29495,29571,0.25700855567955094
551.0,PL031L1,Siedlce,2020,54,126115,126169,0.042799736860877076
552.0,PL032L1,PiotrkÃ³w Trybunalski,2020,231,116691,116922,0.19756760917534769
553.0,PL033L1,Lubin,2020,302,93004,93306,0.32366621653484234
554.0,PL034L1,PiÅa,2020,158,52034,52192,0.302728387492336
555.0,PL035L1,InowrocÅaw,2020,39,20089,20128,0.19375993640699524
556.0,PL036L1,Ostrowiec ÅwiÄtokrzyski,2020,2,61458,61460,0.003254149040026033
557.0,PL037L1,Gniezno,2020,363,66208,66571,0.5452824803593156
558.0,PL038L1,Stargard SzczeciÅski,2020,1921,34743,36664,5.239471961597207
559.0,PL039L1,OstrÃ³w Wielkopolski,2020,234,84527,84761,0.27607036254881373
560.0,PL040L1,PrzemyÅl,2020,160,84929,85089,0.18803840684459802
561.0,PL041L1,ZamoÅÄ,2020,89,112618,112707,0.0789658140133266
562.0,PL042L1,CheÅm,2020,88,46482,46570,0.18896285162121537
563.0,PL043L1,Pabianice,2020,6,32953,32959,0.01820443581419339
564.0,PL044L1,GÅogÃ³w,2020,96,63985,64081,0.1498103962172875
565.0,PL045L1,Stalowa Wola,2020,575,189738,190313,0.30213385317871083
566.0,PL046L1,TomaszÃ³w Mazowiecki,2020,559,18604,19163,2.91707978917706
567.0,PL047L1,ÅomÅ¼a,2020,22,55980,56002,0.03928431127459733
568.0,PL048L1,Leszno,2020,546,77026,77572,0.7038622183262001
569.0,PL049L1,Åwidnica,2020,19,47971,47990,0.03959158157949573
570.0,PL051L1,Tczew,2020,207,26917,27124,0.763161775549329
571.0,PL052L1,EÅk,2020,1495,38557,40052,3.7326475581743734
572.0,PL506L2,Bielsko-BiaÅa,2020,433,73002,73435,0.5896370940287329
573.0,PL508L1,Rybnik,2020,426,14455,14881,2.862710839325314
574.0,PL511L2,WaÅbrzych,2020,28,51482,51510,0.05435837701417201
575.0,PL512L2,ElblÄg,2020,46,96429,96475,0.0476807463073335
576.0,PL513L2,WÅocÅawek,2020,3095,119384,122479,2.526963806040219
577.0,PL514L2,TarnÃ³w,2020,289,125038,125327,0.23059675887877312
578.0,PL516L2,Legnica,2020,197,56303,56500,0.3486725663716814
579.0,PL517L2,GrudziÄdz,2020,878,54165,55043,1.5951165452464438
580.0,PT001L3,Lisboa,2020,7427,431854,439281,1.6907173312754251
581.0,PT002L2,Porto,2020,1058,94682,95740,1.1050762481721328
582.0,PT003L1,Braga,2020,44,49305,49349,0.08916087458712435
583.0,PT004L2,Funchal,2020,736,35226,35962,2.046604749457761
584.0,PT005L2,Coimbra,2020,439,162348,162787,0.2696775541044432
585.0,PT007L1,Ponta Delgada,2020,1001,54293,55294,1.8103230006872355
586.0,PT008L2,Aveiro,2020,2003,41327,43330,4.622663281790907
587.0,PT009L1,Faro,2020,2529,46621,49150,5.145473041709054
588.0,PT014L1,Viseu,2020,7,70867,70874,0.00987668256342241
589.0,PT016L0,Viana do Castelo,2020,390,31862,32252,1.2092273347389308
590.0,PT019L0,PÃ³voa de Varzim,2020,22,8384,8406,0.26171782060433024
591.0,PT505L1,GuimarÃ£es,2020,0,26541,26541,0.0
592.0,RO001L1,BucureÅti,2020,678,107164,107842,0.6286975389922294
593.0,RO002L1,Cluj-Napoca,2020,12,59290,59302,0.02023540521398941
594.0,RO003L1,TimiÅoara,2020,0,23654,23654,0.0
595.0,RO004L1,Craiova,2020,43,34353,34396,0.12501453657402023
596.0,RO005L1,BrÄila,2020,1207,22322,23529,5.129839772196013
597.0,RO006L1,Oradea,2020,54,20285,20339,0.2654997787501844
598.0,RO007L1,BacÄu,2020,149,21944,22093,0.6744217625492237
599.0,RO008L1,Arad,2020,15,51593,51608,0.029065261199813987
600.0,RO009L1,Sibiu,2020,20,56320,56340,0.03549875754348598
601.0,RO010L1,TÃ¢rgu MureÅ,2020,33,13707,13740,0.24017467248908297
602.0,RO011L1,Piatra NeamÅ£,2020,92,14907,14999,0.6133742249483298
603.0,RO012L1,CÇlÇraÅi,2020,560,23984,24544,2.2816166883963493
604.0,RO013L1,Giurgiu,2020,552,10398,10950,5.0410958904109595
605.0,RO014L1,Alba Iulia,2020,9,25993,26002,0.03461272209830013
606.0,RO015L1,FocÅani,2020,8,27094,27102,0.029518116744151723
607.0,RO016L1,TÃ¢rgu Jiu,2020,6,24516,24522,0.024467824810374357
608.0,RO017L1,Tulcea,2020,1866,39081,40947,4.5571104110191225
609.0,RO018L1,TÃ¢rgoviÅte,2020,2,20255,20257,0.009873130275953991
610.0,RO019L1,Slatina,2020,341,6782,7123,4.787308718236698
611.0,RO020L1,BÃ¢rlad,2020,37,26282,26319,0.14058284889243514
612.0,RO021L1,Roman,2020,1,14389,14390,0.006949270326615705
613.0,RO022L1,BistriÅ£a,2020,7,42624,42631,0.01641997607374915
614.0,RO501L1,Constanta,2020,6469,52882,59351,10.899563613081497
615.0,RO502L1,Iasi,2020,227,79709,79936,0.2839771817453963
616.0,RO503L1,Galati,2020,1307,39925,41232,3.1698680636398913
617.0,RO504L1,Brasov,2020,211,98292,98503,0.2142066739084089
618.0,RO505L1,Ploiesti,2020,30,34307,34337,0.08736931007368146
619.0,RO506L1,Pitesti,2020,50,24834,24884,0.2009323259926057
620.0,RO507L1,Baia Mare,2020,98,52443,52541,0.186521002645553
621.0,RO508L1,Buzau,2020,19,38521,38540,0.049299429164504416
622.0,RO509L1,Satu Mare,2020,9,70835,70844,0.012703969284625374
623.0,RO510L1,Botosani,2020,150,37190,37340,0.4017139796464917
624.0,RO511L1,Ramnicu Valcea,2020,436,28737,29173,1.4945326157748602
625.0,RO512L1,Suceava,2020,50,39628,39678,0.12601441604919603
626.0,RO513L1,Drobeta-Turnu Severin,2020,2273,30661,32934,6.901682152183154
627.0,RS001L1,Beograd,2020,6861,306163,313024,2.191844714782253
628.0,RS002L1,Novi Sad,2020,2793,186650,189443,1.4743220916053905
629.0,RS003L1,NiÅ¡,2020,107,341457,341564,0.031326486397863944
630.0,RS004L1,Kragujevac,2020,513,143562,144075,0.3560645497136908
631.0,RS005L1,Subotica,2020,255,160037,160292,0.1590846704763806
632.0,RS006L1,Novi Pazar,2020,42,140749,140791,0.029831452294535873
633.0,RS008L1,Zrenjanin,2020,1175,183956,185131,0.6346857090384647
634.0,RS009L1,Kraljevo,2020,0,176512,176512,0.0
635.0,RS011L0,ÄaÄak,2020,28,63659,63687,0.04396501640837219
636.0,RS012L1,KruÅ¡evac,2020,2,122647,122649,0.0016306696344854015
637.0,RS013L1,Leskovac,2020,6,166276,166282,0.0036083280210726354
638.0,RS014L1,Valjevo,2020,109,141553,141662,0.07694371108695346
639.0,RS015L1,Vranje,2020,19,195337,195356,0.009725833862282193
640.0,RS016L1,Smederevo,2020,2882,157342,160224,1.7987317755142802
641.0,SE001L1,Stockholm,2020,67884,687842,755726,8.982620685274822
642.0,SE002L1,GÃ¶teborg,2020,16687,418572,435259,3.8338092951552984
643.0,SE003L1,MalmÃ¶,2020,3212,184804,188016,1.7083652455110205
644.0,SE004L1,JÃ¶nkÃ¶ping,2020,50798,296393,347191,14.631139632075715
645.0,SE005L1,UmeÃ¥,2020,18636,969613,988249,1.8857595605965702
646.0,SE006L1,Uppsala,2020,15851,681676,697527,2.2724568367962816
647.0,SE007L1,LinkÃ¶ping,2020,18236,404960,423196,4.309114452877626
648.0,SE008L1,Ãrebro,2020,21870,346727,368597,5.9333092781547325
649.0,SE501L1,VÃ¤sterÃ¥s,2020,19284,271131,290415,6.640152884665048
650.0,SE502L1,NorrkÃ¶ping,2020,15419,296319,311738,4.946140669408285
651.0,SE503L1,Helsingborg,2020,1109,113313,114422,0.9692192060967296
652.0,SE505L1,BorÃ¥s,2020,2784,94578,97362,2.8594318111788994
653.0,SI001L2,Ljubljana,2020,422,232865,233287,0.18089306305109157
654.0,SI002L1,Maribor,2020,272,216713,216985,0.1253542871627071
655.0,SK001L1,Bratislava,2020,1831,203110,204941,0.8934278646049352
656.0,SK002L1,KoÅ¡ice,2020,656,176978,177634,0.36929867029960484
657.0,SK003L1,BanskÃ¡ Bystrica,2020,2,80878,80880,0.002472799208704253
658.0,SK004L1,Nitra,2020,20,87107,87127,0.022954996728912967
659.0,SK005L1,PreÅ¡ov,2020,4,93295,93299,0.0042872913964779906
660.0,SK006L1,Å½ilina,2020,175,81273,81448,0.2148610156173264
661.0,SK007L1,Trnava,2020,111,74109,74220,0.14955537590945836
662.0,SK008L1,TrenÄÃ­n,2020,51,67372,67423,0.07564184328789879
739.0,UK001L3,London,2020,1139,697031,698170,0.16314078233095092
740.0,UK002L3,West Midlands urban area,2020,286,215023,215309,0.13283234792786183
741.0,UK003L2,Leeds,2020,668,511759,512427,0.130360031770379
742.0,UK004L1,Glasgow,2020,2272,335412,337684,0.6728183745750466
743.0,UK006L3,Liverpool,2020,618,99885,100503,0.6149070177009641
744.0,UK007L1,Edinburgh,2020,833,174585,175418,0.47486574923896063
745.0,UK008L3,Greater Manchester,2020,1351,310895,312246,0.4326716755378772
746.0,UK009L1,Cardiff,2020,158,84333,84491,0.18700216591116214
747.0,UK010L3,Sheffield,2020,179,125908,126087,0.14196546828776957
748.0,UK011L2,Bristol,2020,179,98206,98385,0.18193830360319155
749.0,UK012L2,Belfast,2020,22092,173053,195145,11.320812728996387
750.0,UK013L2,Newcastle upon Tyne,2020,1867,544841,546708,0.3414985696203458
751.0,UK014L1,Leicester,2020,36,139745,139781,0.025754573225259512
752.0,UK016L1,Aberdeen,2020,2371,651577,653948,0.36256705426119507
753.0,UK017L2,Cambridge,2020,50,159569,159619,0.0313245916839474
754.0,UK018L3,Exeter,2020,991,246735,247726,0.40003875249267334
755.0,UK019L3,Lincoln,2020,106,211437,211543,0.05010801586438691
756.0,UK023L1,Portsmouth,2020,336,20517,20853,1.6112789526686808
757.0,UK024L1,Worcester,2020,9,61193,61202,0.014705401784255416
758.0,UK025L3,Coventry,2020,55,81392,81447,0.06752857686593736
759.0,UK026L1,Kingston upon Hull,2020,555,251143,251698,0.22050234805203062
760.0,UK027L1,Stoke-on-Trent,2020,27,88149,88176,0.030620577027762656
761.0,UK029L1,Nottingham,2020,42,90247,90289,0.046517294465549516
762.0,UK033L1,Guildford,2020,14,61677,61691,0.022693747872461135
763.0,UK050L1,Burnley,2020,61,27913,27974,0.21805962679631086
764.0,UK056L1,Hastings,2020,82,54668,54750,0.1497716894977169
765.0,UK515L1,Brighton and Hove,2020,276,42131,42407,0.6508359468955597
766.0,UK516L1,Plymouth,2020,659,215116,215775,0.305410728768393
767.0,UK517L1,Swansea,2020,363,83679,84042,0.4319268936960091
768.0,UK518L1,Derby,2020,78,68024,68102,0.11453408123109454
769.0,UK520L2,Southampton,2020,991,152361,153352,0.6462256768741197
770.0,UK528L1,Northampton,2020,136,154409,154545,0.08800025882429066
771.0,UK539L1,Bournemouth,2020,541,93252,93793,0.5768021067670296
772.0,UK546L1,Colchester,2020,634,68861,69495,0.912295848622203
773.0,UK550L0,Dundee City,2020,559,225857,226416,0.24689067910395024
774.0,UK551L1,Falkirk,2020,22,29767,29789,0.07385276444325087
775.0,UK552L0,Reading,2020,6,21915,21921,0.02737101409607226
776.0,UK553L1,Blackpool,2020,74,48881,48955,0.15115922786232253
777.0,UK557L1,Blackburn with Darwen,2020,137,79417,79554,0.17221007114664252
778.0,UK558L1,Newport,2020,55,31645,31700,0.17350157728706625
779.0,UK559L2,Middlesbrough,2020,1062,60707,61769,1.7193090385144654
780.0,UK560L1,Oxford,2020,141,192782,192923,0.07308615354312342
781.0,UK562L2,Preston,2020,61,25701,25762,0.236782858473721
782.0,UK566L1,Norwich,2020,74,150166,150240,0.049254526091586794
783.0,UK568L1,Cheshire West and Chester,2020,378,135767,136145,0.2776451577362371
784.0,UK569L2,Ipswich,2020,1499,154147,155646,0.9630828932320779
785.0,UK571L1,Cheltenham,2020,1,46182,46183,0.002165298919515839
786.0,XK001L1,Pristina,2020,112,255695,255807,0.0437830082835888
787.0,XK002L1,Prizren,2020,4,127629,127633,0.0031339857246950238
788.0,XK003L1,MitrovicÃ«,2020,1,117913,117914,0.0008480757161999422
